id,Label,description,social networks,complex networks,complex systems,network science,tot_count,number_of_tweets
1070010671918665728,NicoloPagan,"PhD Student at ETH Zürich, applied mathematician as training.
Working on mathematical modelling of social networks.
Loving travel, outdoor sports, and chess.",2,0,0,0,2,36
848539500167004160,sebastian_ruf,Control Theory. Complex Networks. Improv. Postdoc @NUnetsi He/Him/His,0,1,2,2,5,159
814015332,dinacmistry,postdoc @IDMOD_ORG. PhD from MOBS Lab @NUnetsci. #NetworkScience | #Physics | #Epidemiology | #SteelPannist | #FirstGen |she/her.,0,1,2,3,6,300
1220359214884904965,SINSA2020,"The 2020 Summer Institute in Network Science and its Applications offers 8 short, intensive network science courses. A joint @NUnetsi & @IUNetSci program.",0,0,0,2,2,25
382393,ciro,Data Science · Digital Epidemiology · Computational Social Science. https://t.co/xoSUF37mVu co-founder. @unito @ISI_Fondazione @FondazioneCRT,1,0,0,0,1,300
574364219,dgarcia_eu,"Group leader at the Complexity Science Hub in Vienna https://t.co/E9IRmTRDX0 and the Medical University of Vienna, working on Computational Social Science",0,0,0,1,1,300
415906140,net_science,"Associate Prof in Network Science Organiser of @databeersldn & https://t.co/jFq71FOJfo @ISI_Fondazione fellow, Economic Graph Researcher @linkedin",3,9,2,1,15,300
1524770221,mmdkhosravi,"Researcher/Doctoral student, Automatic Control Lab, ETH Zürich. Data Science, System Theory and Applied Mathematics (RKHS+SYSID)",0,0,1,0,1,218
934090570930286593,c_stadtfeld,Assistant Professor of Social Networks at @ETH_en. Co-director of the ETH Social Networks Lab (https://t.co/BZynv7gQGY).,4,0,0,2,6,149
382134761,mtizzoni,"Complex networks, infectious diseases, data science || Science is what you understand well enough to explain to a computer [D.Knuth]",1,0,1,0,2,300
934041262608584704,TimonElmer,"Postdoc @ ETH Zürich 
Doing research on social networks and mental health",3,0,0,0,3,19
304928205,GuidoCaldarelli,"Statistical physicist, complex networks scientist, Prof @IMTLucca, CNR-ISC @LDNist, ECLT, @netscisociety founder and fellow, President of @CompSysSoc",0,1,1,1,3,300
17354555,emilio__ferrara,Research Assistant Prof. @USC @USCViterbi @CSatUSC. PI & Research Team Leader @ISI_AI #social #networks #DataScience #MachineLearning,0,1,0,1,2,300
184433314,ancsaaa3,"Assistant Prof at Uni. Zurich, Researching Fairness of Big Data Algorithms, Gender Disparities in Online Platforms",0,1,1,0,2,110
935785016155570177,networkspapers,Semi-automatically curated list of new publications in Network Science. Managed by @all_are. Get in touch for comments or suggestions.,10,25,1,0,36,300
529438517,aaronclauset,"Associate Professor of Computer Science @ University of Colorado, Boulder and External Faculty @ Santa Fe Institute",0,1,2,0,3,300
1149777903284031488,NetworCSS,News & updates about #CSS #Networks #Polarization #NegativeTies #SignedNetworks & related research topics. Tweets by @saminrf and guest admins. Mention for RT.,4,0,0,1,5,192
57571700,TahaYasseri,"Computational Social Scientist at @oiioxford, University of Oxford. Alan Turing Fellow at @turinginst. PhD in Physics of Complex Systems. Interested in Data.",3,0,0,0,3,300
4690350990,DynamicsSIAM,The dynamical systems channel for the Society for Industrial and Applied Mathematics. Let chaos reign.  We also publish DSWeb: https://t.co/lZg3Ky8Ac0,0,1,1,0,2,300
243161145,iniguezg,"networks, complexity, data | assistant prof @dnds_ceu @ceuhungary | visiting researcher @CSAalto & 
@IIMAS_UNAM | co-founder @PredifyAnalytic | github: iniguezg",4,4,7,5,20,300
2797948887,BehavEcolPapers,#BehavioralEcology #Ethology #HumanBehavior #AnimalBehavior #LifeHistory #AnimalPhysiology papers from #PubMed & journal rss-feeds | curated by @MihalyFoldvari,2,0,0,0,2,300
617118982,fede7j,"Assistant professor at the Department of Network and Data Science @dnds_ceu @ceu Into ultimate, basketball, ski... Pasta & fish like #YOLO",2,1,1,1,5,300
1944845792,ChSteglich,sociological mathematician. network researcher.,1,0,0,1,2,45
993480307,Raabe_Isabel,"Postdoc @sociology_uzh Uni Zürich, working on social inequality & social networks. PhD @SociologyOxford; Alumna and associate member of @NuffieldCollege.",4,0,0,0,4,131
973636307774828551,netsci2020,"The 2020 Conference @netscisociety. Rome, Italy September 2020 https://t.co/7b6uSvevZ8 Netsci2020@gmail.com",0,0,1,2,3,89
752598499817062400,mv_tomasello,Senior Consultant at @EY_Switzerland - #ForensicDataAnalytics. PhD @ETH in #NetworkAnalysis. Passionate about #Sustainability #Environment #GenderEquality,0,1,0,0,1,300
582161546,alexvespi,"Network & Data Science, Computational Epidemiology, Complex Systems",1,2,1,3,7,300
706800925394997249,NatureHumBehav,"Nature Human Behaviour is a @springernature journal bringing you research, commentary and news on all aspects of human behaviour. Retweets not endorsements",2,0,0,0,2,300
56341402,barabasi,"Network Scientist. Author. The Formula, Linked, Bursts. @Northeastern @Harvard @CEUhungary.",1,1,1,10,13,300
579299426,stevenstrogatz,"Mathematician, writer, Cornell professor. All cards on the table, face up, all the time. For speaking requests, please contact Jodi Solomon Speakers Bureau.",0,3,0,0,3,300
12819112,PLOS,"Breaking boundaries.
Empowering researchers.
Opening Science.",1,0,0,0,1,300
258847118,PNASNews,"Cutting edge news and reports from PNAS, one of the world's most-cited multidisciplinary scientific journals.",2,0,0,0,2,300
2901252195,fdlevi,Senior Editor @nature. All views my own.,1,3,3,4,11,300
216098950,SocNetAnalysts,INSNA is the professional association for researchers interested in social network analysis.,4,0,0,1,5,300
1047808609210589184,sn_ethz,Research group at @ETH Zürich led by Ulrik Brandes and Christoph Stadtfeld,1,0,0,0,1,7
1105508110213545984,netscisociety,"Official account of the Network Science Society.
""To serve and represent the rapidly growing research community on network science"".",1,1,2,9,13,185
973642770521915394,2019NetSci,Official account of the 2019 International School and Conference on Network Science. Official hashtag: #NetSci2019,2,1,0,5,8,300
700746896680161280,netsci2017,"Host of NetSci 2017 June 19-23, 2017, held at the JW Marriott Indianapolis",4,0,0,8,12,300
426509606,cosnet_bifi,Prof. Yamir Moreno. Physicist. Networks & Complexity. Director of BIFI & Head of Cosnet Lab. President of the @netscisociety. See also https://t.co/RvXChXFvoL,0,3,0,1,4,300
4856786657,complex_nets,The official feed for Complex Networks - The 8th International Conference on Complex Networks and Their Applications #complexnetworks,1,2,0,1,4,220
191553947,hihickster,"service designer, system thinker and hybrid space explorer. @oblotips, @coonsfromspace, @nevicata14",0,0,1,0,1,300
885237745198747648,stiso_jennifer,"Neuroscience PhD candidate at UPenn, my days consist of writing code, and watching dogs from coffee shops. She/hers.",0,0,0,1,1,183
848913193867124742,SarahWest382,"Neuroscience PhD candidate at the University of Minnesota. Motor neuroscience, network science. Former MD/PhD. Also a dog sport and animal enthusiast. She/her.",0,0,0,1,1,300
82503888,neuroperson,Neuroscientist interested in brain dynamics and spontaneous cognition,0,0,0,1,1,300
86523055,mdiberna,"Professor of Nonlinear Systems and Control at @Bristoluni and @UninaIT tweeting about #Control, #Chaos and #Complexity. Fellow @IEEEorg",0,5,2,2,9,300
321783625,olivercliff,"Postdoc @Sydney_Uni studying the complexity of nature, from brain dynamics and epidemics to multi-robot planning. Views my own, I think.",0,0,1,0,1,97
814274646,artistjaneadams,Data Visualization Artist-in-Residence at the University of Vermont @uvmcomplexity @compstorylab 🌿 @VT_WiMLDS Organizer 🌱 Emergent Media Artist,1,0,0,0,1,300
60458714,jlizier,"Assoc./Prof. in Complex Systems @Sydney_Uni. I research information processing in nature, networks, neuro, etc. Author of @infodynamicstkt. Views my own/RTs",0,1,4,1,6,300
46152530,narnolddd,"Networks ∩ Time
CS PhD student at QMUL
Email n.a.arnold [at] https://t.co/ByeuzWAjb4 She/Her",0,0,0,2,2,300
1167145117452570626,Networks2021,"Networks 2021
July 6-11, 2021 | Washington D.C.
The joint annual meeting of Sunbelt (@SocNetAnalysts) and NetSci (@netscisociety)
Host: @IUNetSci",0,0,0,1,1,15
857326581701849088,sattertt,"Assistant Professor at the University of Pennsylvania | Neuroimaging, neuroinformatics, brain development, psychiatry, network science, machine learning.",1,0,0,1,2,300
952270171124719616,systmedicine,"Modeling Infectious Diseases
l Dad🚼 l Group Leader l Viruses and more Viruses.
#Infection l #Immunity l #Mathematics l #ControlTheory l #COVID19",0,1,1,1,3,300
847127276,caioseguin,"PhD candidate at @MNC_Psychiatry and @unimelb. Interested in connectomics, network science and the interface between life and computational sciences.",0,1,0,3,4,300
2160138829,neuro_dz,Neuroscience PhD candidate @Penn,0,0,0,1,1,300
285380882,joshfasky,"grad student; aiming to find intersection of brains, networks, and free food on campus; @IUBloomington hoosier and @USC trojan; #COYS @SpursOfficial",0,0,0,1,1,300
954335153723183104,LdaFCosta,"Connected to complex systems, networks, image/shape analysis, pattern recognition, neuroinformatics, music, and electronics.  Full prof of physics at USP.",1,9,7,3,20,300
3837804028,RodrigoMigueles,"Scientist, biochemist. Interested in protein-protein interaction networks and complex systems.",0,0,1,0,1,57
1072324469593563138,HassanDehghaniA,PhD student in control engineering at the University of Newcastle. Trying to understand opinion dynamics in social networks. Interested in networked systems.,1,0,0,0,1,19
564089684,LuisMateusRocha,"Complex systems, networks, biomedicine, AI, evolution. Music, politics, post-national identity. DJ as E-Trash. E se mais mundo houvera, lá chegara.",0,1,1,0,2,300
19714395,rionbr,"Complexity scientist, lover of nature and systems. PostDoctoral Researcher at @IGCiencia",1,2,5,1,9,300
16458709,dbemerydt,"scientist, test subject, boricua, he, him, his",0,0,1,1,2,300
450742208,BabakRavandi,Passionate about understanding and modeling #ComplexSystems. Postdoc @Northeastern in CCNR Barabási lab. @PurdueCIT & @IllinoisTech alumni.,0,2,0,0,2,87
770687821535449090,Enri_amico,"Physicist, brain networks enthusiast and Ambizione research leader at EPFL",0,1,0,1,2,256
1058470939,BenChiem,PhD Student at Université catholique de Louvain. I am interested in complex networks methods applied to the analysis of the human brain.,0,1,0,0,1,84
877976768061243392,ArianAshourvan,Postdoctoral fellow at University of Pennsylvania,0,0,0,1,1,22
487705992,CarolinaMttssn,PhD candidate at NetSI at NEU. I study how money moves and the data breadcrumbs we leave behind as we go about our lives. Give me music and I'll dance.,1,0,1,1,3,300
827658288040861696,NicoleEikmeier,higher-order network models,1,0,0,1,2,231
816321694319181824,societyoftrees,"Data research, communication networks, ethical technology. Formerly obsessed with the forests in our brains. Postdoctoral research at the University of Chicago",0,0,0,1,1,300
1557533940,AlicePatania,Assistant research scientist @IUNetSci. Topological Data Analysis scholar and network scientist. Infographic enthusiasts trying to understand the brain. she/her,0,2,1,2,5,300
958887670477975552,PedroM_Z,"Ph.D. student @GeorgiaTech, awed at the emergence & evolution of living systems 🧬. Philosophy apprentice 🕮. A native of the Purépecha region of México 🇲🇽.",0,0,1,0,1,300
1069045039,dan_marinazzo,"Brain, models, complexity @ugent.
Deputy editor @PLOSCompBiol, EiC @nbdt_journal, AE @PLOSONE, @netneurosci, @NeuroImage_EiC, Brain Topography, @PLOSChannels.",1,1,0,0,2,300
1120789424118407168,towlsonek,Associate Research Scientist CCNR NEU | Research Affiliate MIT | Homeward Bound TeamHB4 | network (neuro)scientist | runner | cat guardian | human being,0,0,1,0,1,135
18247347,tiagopeixoto,"Physics & Networks.

Also on Mastodon ➡️ https://t.co/wgkda2aka8",0,0,1,1,2,300
2290819595,conorheins,"Active inference, free energy minimization, and complex systems. PhD student at @CollectiveBehav",0,2,3,0,5,300
1111238619002531840,winter_complex,The Winter Workshop on Complex Systems is a workshop for early career researchers to gather together and engage in interdisciplinary research on complex systems,0,0,2,0,2,49
834514130035957775,sam_rosenbott,Noisy data and network influence | Humans and bees | @uvmcomplexity and @UVMCompSci | Outreach Officer of @official_SYNS :network-heart: | HUGE podcast fan,0,0,0,2,2,300
212640939,syedarehaq,,2,0,0,4,6,276
43712315,josemarfdc,👨🏽‍🔬👨🏽‍💻🗄📊📈📉,1,0,0,0,1,300
801932087850835968,LaNet_2019,"2nd Latin American Conference on Complex Networks, Cartagena (Colombia) 5-9 August 2019",2,7,3,1,13,300
772310749,AmarDhand,Director of the Dhand Lab. 🇨🇦🇺🇸Neurologist and network scientist aiming to better understand and harness social networks in medicine.,17,0,1,2,20,300
824241575706427392,official_SYNS,"Official account of the Society of Young Network Scientists #SYNS ! If you're a young network scientist, whether by age or experience, you belong here. Join us!",1,4,5,4,14,300
160925047,mccabe_s,PhD student @NUnetsi. @CSS_GMU alum.,0,0,1,4,5,160
318262821,george_berry,"Sociologist at Civis working to elect Dems. Interests: experiments, social influence, social networks, Bayesian stats (😱), train memes. he/him.",1,0,0,1,2,300
1045763448670486529,ChrisWLynn,Physics PhD student working on networks and information thoery with Dani Bassett at the University of Pennsylvania #InfoTheory #Networks #StatMech,1,4,0,0,5,118
3352671022,aliceschwarze,"Postdoc @UWBiology // research in Math Bio, Comp Neuro, Network Science, Complex Systems // likes maths, science, books, birds, and more!",1,4,1,1,7,300
890863214690480129,manuel_pita_,AI and Complex Networks. I study collective information processing in bio and social systems. Retweets ≠ endorsement. I’m also known as @sejkko 👨🏻‍💻☄️👨🏻‍🎨,0,0,3,0,3,300
21719973,Shugars,"Computational political scientist. PhD Candidate @NUNetSI (Next: Faculty Fellow @NYUDataScience). Political behavior, civics, NLP, networks. She/they. #FirstGen",0,0,0,1,1,300
1046598080,jkbren,"thinking, thinking about thinking, thinking about thinking about thinking. surprise.",0,1,1,1,3,300
833629111,chiahungyang,"PhD Candidate - Network Science Institute, Northeastern University",0,0,1,2,3,69
479672092,ConstantineDovr,"I am a professor at Georgia Tech working in the overlap of network science, machine learning and neuroscience",1,0,1,3,5,300
365059891,_leotrs,"Networks, Math, Computation, Complexity, Philosophy, Bicycling, Running, Swimming. PhD candidate @NUnetsi.",0,0,0,1,1,300
1962699368,_AlexArenas,"Physicist. Full Professor in Computer Science and Mathematics URV. 
APS fellow.",0,1,0,0,1,300
3386954115,daniel_goldsmth,"Working on something new. Building better tools to analyze #networks and complex systems. Adjunct Prof @yunews. Formerly:  @chainalysis, @2Uinc.",0,0,3,2,5,300
879170334578139140,SoodiMilanlouei,Data Scientist | Former PhD at Barabasi Lab | Center for Complex Networks Research | Northeastern University,0,0,0,1,1,300
4099956119,SoheilEshghi,"Postdoc @YaleSPH @YINSedge - On the market! *****
Control theorist working on epidemic control, social influence, and network effects | he/him",1,0,0,3,4,300
33315710,austinbenson,Assistant Professor of CS @CornellCIS; previously PhD @ICMEStanford & BS EECS/BA Applied Math @UCBerkeley. I develop computational frameworks.,0,0,1,5,6,300
2902126231,DzGuilbeault,"Computational Social Science. Network Dynamics Group @ Annenberg School for Communication, Upenn. Future Assistant Prof. @ Berkeley, Haas 2020.",1,0,0,0,1,300
4179767308,spcornelius,"Assistant professor @RyersonU. Complex systems, networks, and nonlinear dynamics.",0,0,2,7,9,300
62621489,joshua_a_becker,computational social scientist studying #collectiveintelligence // fascinated by #crowds // retweets reflect a complex interplay of structure and agency,1,0,0,0,1,300
77436536,onurvarol,"Postdoc at @NUnetsi, PhD in Informatics at Indiana University. Developed @Botometer -- Microsoft Research Intern (2014,2015)
#networkscience, #machinelearning",1,1,1,1,4,300
3729520335,NUnetsi,Network Science Institute at Northeastern University,4,2,0,7,13,300
2584784815,ryanjgallag,"Network science ∩ Communication. PhD student @NUnetsi @CoMMLabNU. Amplification, polarization, NLP, platform ecologies. Aspiring one-man band. He/him/they/them",1,0,1,2,4,300
257111136,s_cresci,"Researcher, IIT-CNR, Italy. I work on #socialmedia analysis, social #bot detection and crisis informatics. I love travels 🛫, food 🍝, and data 📊. Tw: 🇬🇧🇮🇹",2,0,0,0,2,170
16504257,Nnedi,"The Naijamerican PhD-holding, World Fantasy, Hugo & Nebula Award-winning rudimentary cyborg author of scifi, Africanfuturism, Africanjujuism & Marvel's Shuri.",1,0,0,0,1,300
24150239,aminrahimian,Postdoc @mitidss,3,0,1,0,4,47
838413744,Mark_A_Thornton,I study how people predict other people. Social neuro postdoc @Princeton. Studies @OurSocialBrain. Asst prof @Dartmouth & Director @SCRAP_Lab starting July 2020,1,0,0,0,1,300
331632691,DianaTamir,Assistant professor @PsychPrinceton studying how brains think about people.,2,0,0,0,2,300
227062815,_kenny_joseph,"Asst. Prof in CS @UBuffalo. Studying people with computers. I believe there is a difference between ""dressy"" and ""casual"" sweatpants",0,0,1,0,1,300
2871161111,ariSPeshkin,Research Group Leader at University of Konstanz & Max Planck Institute of Animal Behavior studying communication and collective behavior in animal groups,1,0,1,0,2,300
1057806421750960130,ericneumannpsyc,"Incoming PhD Student & Graduate Fellow @Stanford, formerly @Harvard, @UChicago. Interests: Moral, Social, Political Psychology. Founder of @BridgeUSA_ Chicago.",1,0,0,0,1,278
1560513588,branmorrighan,"Postdoctoral Researcher, Indiana University
Complex Systems / Network Science",1,1,3,2,7,300
1611332490,NetworkFact,"Daily tweets about networks, graph theory, and related topics from @JohnDCook",2,1,0,0,3,300
20131383,cward1e,"Leading strategy at @firstdraftnews, a non-profit dedicated to tackling misinformation globally.",1,0,0,0,1,300
1104234200,oritpeleg,"Physics of Living Systems Researcher. Assistant Professor, Department of Computer Science & @BioFrontiers, @CUBoulder, External Faculty @sfiscience",2,1,0,0,3,300
4035976895,louisecam93,"PhD candidate in the Ries & Grabowski labs 
Studying the effects of ocean acidification on commercial fisheries #fisheries #womeninSTEM #oceanacidfiication",0,0,0,1,1,177
217015882,ajmoralesguzman,Complexity | Society | Systems | Data | Networks | AI | Stoicism | Poetry | Self-actualization | TR35 | Venezuela Libre | Alter ego @redcompleja,0,0,2,0,2,300
1147170718494445569,css_usne,Local chapter of the Complex Systems Society providing services to the community of complex systems researchers and students in the US Northeast region,0,0,3,0,3,50
22979111,martikagv,"Associate Professor at UC Berkeley, Civil and Environmental Engineering, and City and Regional Planning. LBNL, Faculty Research Scientist, Physics.",0,0,2,5,7,300
277216230,DLydonStaley,Substance use/curiosity/networks. 🏳️‍🌈 He/Him. Open lab positions: https://t.co/DbvoRZSYLr,0,0,0,4,4,300
1139160970721406976,tinaL___,Sociology PhD Candidate @NorthwesternU studying urban change and inequality with computational methods. First-gen paying it forward. https://t.co/OeMzsRM6he,0,0,0,1,1,80
3216966611,hyejin_youn,"Assistant Professor at Kellogg, Northwestern University: innovation, urban scaling, cross cultural linguistic semantic space",0,1,1,1,3,300
1540384460,martijnheuv,Dutch Connectome Lab |Neurowetenschapper | Neuroscientist | human brain | neural systems | connectomics | wegenkaart van de hersenen,0,0,1,0,1,233
2335431,yy,Studies (social|biological|flavor|.+) networks. Associate Professor at Indiana University Bloomington. Views are my own.,0,0,0,3,3,300
4844847993,BovetAlexandre,"Researcher in #NetworkScience, #ComplexSystems, #DataScience",0,0,4,0,4,298
1512280484,phihoevel,,1,0,2,5,8,168
97564868,arcos_oliveira,"crime dynamics, swarm intelligence, complex systems, city/network/data science, and Sport Club do Recife!",0,1,5,2,8,300
2872512304,Eliz_Hobson,"Assistant Professor at the University of Cincinnati, working on animal behavior, social structure, networks, conflict, & hierarchies.",2,0,0,0,2,300
2316561068,ML_Ouellet,Assistant Professor | Department of Criminal Justice and Criminology @GeorgiaStateU,0,0,0,1,1,59
37535954,o16granados,Computational Social Scientist & Global Complexity Researcher | Financial Computing Entrepreneur | Trail Runner & Adventurer,1,0,1,1,3,300
2218303021,RERobertson,"Network Science PhD Student @NUnetsi;              
former intern @MSFTResearch; he/him",0,0,0,2,2,185
77712285,a_baronca,Faculty @CityUniLondon and Economic Data Science theme lead @turinginst. Opinions expressed are solely my own and don’t express the views of my employers.,0,0,0,1,1,300
111402243,manishsaggar,Assistant Professor,1,0,0,1,2,150
1085657139635515392,sathayas42,Number cruncher by training. Data scientist @KNIME. Linux enthusiast. たまに日本語でのRT.,0,0,0,1,1,80
13731562,DGaff,"Internaut, flyboy, former schoolboy (@AtBennington, @oiioxford, @nunetsi, @BKCHarvard), dog dad and grower of poorly shaped produce. Thoughts own, bad",0,0,0,1,1,300
2540514931,ConnectomeLab,"Dynamic Connectome Lab. Connectomics, brain network development, computational modelling to inform diagnosis and treatment of neurological disorders",0,1,0,2,3,300
468499498,mrfrank5790,"MIT IDSS researching complex systems, AI, and the Future of Work. Trying to get outside in the meantime!",0,1,2,0,3,300
1120621201376854017,nerdsitu,"NEtwoRks, Data and Society (NERDS) group at IT University of Copenhagen @robysinatra @mszll @LR @mikk_c",0,0,1,1,2,38
24499773,dgleich,Matrix and network computations,0,0,1,0,1,300
3154718333,JmBuldu,(Professor & Researcher & Soldier of Fortune) @ (URJC & CTB & GISC),0,0,0,1,1,300
748226902930919424,biorxiv_neursci,,0,0,1,0,1,300
950844713657094145,mjdramstead,"Postdoctoral Fellow, Jewish General Hospital in Montreal. Philosophy of psychiatry, cognitive science, multiscale active inference.",0,0,1,0,1,300
914787406250987520,bayrameda_ee,"PhD Student @EPFL_en, research on #GraphSignalProcessing #NetworkScience, yogi, mezzo soprano",0,0,0,1,1,30
116297274,coronges,"Northeastern University, Network Science Institute, Social (networks, behaviors, cognition)",1,0,1,3,5,193
3728141775,mripapers,"Links to new articles from MRM, NMR in Biomedicine, Neuroimage, JCBFM and HBM. Now available on the web via Tumblr!",1,0,0,0,1,300
724293313,neurogeneticus,PhD Genetics. Also #Aging #Epigenetics #Neuroscience #Politics #Sports - Science_does_work … ∞,1,0,0,0,1,300
4120580026,siobhan_grayson,PhD candidate #Networks #Δ #MachineLearning @Insight_Centre @UcdCompSci ⌁ #Fulbright Scholar @Fulbright_Eire ⌁ @BKCHarvard Affiliate ⌁ Runs @PyDataDublin,2,1,0,3,6,300
1080753187,NatureNeuro,"News, commentary and research coverage from the international monthly journal publishing the highest quality of work in all areas of neuroscience.",0,0,0,1,1,300
4549648582,ari_e_kahn,,0,0,0,1,1,6
1002535749546336256,perryzurn,"political philosopher @AmericanU, DC; writer; curiosity enthusiast 🏳️‍🌈 he/him/his",0,0,0,1,1,74
3325105445,BenFMaier,Postdoc at Robert Koch Institute (with @DirkBrockmann) // physics // complex systems // he/him/they/them // expressed views are my own,0,0,2,0,2,300
1467127267,drmichaellevin,Scientist working at Tufts University; my lab studies patterning and computation in a range of biological systems.,0,1,0,0,1,300
1329752491,_jgyou,Networks and inference. @JSMF fellow at @UMichCS. Ex at @albatrosqc.,0,3,2,3,8,300
3301163090,compTimeSeries,A comparison engine for time-series analysis. Code package is here: https://t.co/JSyV3dWN1b Tweets by @bendfulcher about time-series analysis,0,1,1,0,2,297
77990334,JariSaramaki,"professor, network scientist, bassist.",1,0,1,0,2,300
381746423,bansallab,"Disease ecology and network science research group based in @GUBiology @GeorgetownColl. Contact networks, spatial epi, math biology, big data, open science.",1,0,0,1,2,300
155636227,gleesonj,"Applying mathematics to model contagion and cascades (of memes, disease, info, behaviour,...) on networks. Co-director of MACSI (@MACSIMaths).",0,1,1,0,2,300
754273366207496192,gershbrain,"Associate Professor, Department of Psychology and Center for Brain Science, Harvard University",0,0,1,0,1,300
2427351685,richardfbetzel,asst prof at indiana university | @networks_lab PI | views my own,0,1,1,3,5,300
758039646454636548,netneurosci,"MIT Press Journal devoted to brain networks at all scales - molecular, neuronal, circuit, systems",0,0,0,2,2,300
2648408096,jgonicor,Assistant Professor. Head of the CONNplexity Lab.,0,3,1,0,4,300
398398588,baruchbarzel,Cracking network dynamics,0,16,2,5,23,300
14543336,mexicolindo,"Bilingual, Bicultural, Latina, Mom, Scientist. Complex systems, care delivery disparities, cancer and aging, population HSR | GIS #SchiaffinoLab",2,0,0,0,2,300
1642585022,PhilChodrow,"Applied math and data science @MIT, @UCLA starting July 2020. Ally of @qsideinstitute. Playing in everybody's back yard. (he/him/his)",0,0,2,4,6,300
2264082385,HarrisonHartle,complex systems/network science & nonlinear dynamics/fluid turbulence,0,2,2,1,5,198
628967454,brucedesmarais,"political scientist/computational social  scientist @penn_state. networks, methodology, institutions, public policy, open government. views are my own.",0,1,0,1,2,300
1091012993285005312,netsci4sg,We intends to foster the discussion of network science’s role in addressing societal challenges. Showcasing work that can be applied for the benefit of humanity,2,0,0,1,3,67
2424151074,spornslab,"computational neuroscience, brain networks, complex systems, connectomics",0,1,3,3,7,300
2338824692,YINSedge,"Yale Institute for Network Science. Events. News. Cool stuff about network science, data science, science in general. And related matters.",3,0,0,1,4,300
365002580,nvchawla,"Professor, Director of Notre Dame Center for Network and Data Science (CNDS), Founder @Aunalytics.",0,0,0,1,1,300
816646064493170688,neurodynamicsFR,"We explore multiscale brain dynamics mainly in epilepsy, coma & BCI, ... #CNRS #INSERM #UPMC",0,2,2,0,4,300
323439357,aivoAALTO,"aka Riitta Hari. Academician of Science, Aalto University ARTS & SCI. Own views on brains, minds, science, culture, ...",1,0,0,0,1,300
579143740,az_jacobs,"assistant professor @umsi and @UMICHCS | computational social science, data science, governance + AI, social networks + machine learning, the Internet ¯\_(ツ)_/¯",1,0,0,0,1,273
347886653,samfway,Research Scientist at Spotify,1,0,0,0,1,236
15160540,noshir,"Noshir is investigating factors that lead to the formation, maintenance, and dissolution of dynamically linked social and knowledge networks in communities.",3,0,0,0,3,300
34249543,jsradford,Co-founder @VolunteerSci. Sociologist. Researcher @davidlazer's lab @northeastern. @uchicago @appstate and @ncssm alum. He/his.,0,0,1,0,1,300
582233920,all_are,"Assistant professor @universitelaval and @DynamicaLab. He/him. Network theory, nonlinear dynamics and statistical physics.",1,4,1,2,8,300
839011723,TammyKolda,"Reseach interests: tensor decompositions, network science, data mining, numerical optimization, parallel computing, design of scientific software",0,0,0,1,1,300
301579658,ChrisDanforth,"Applied mathematician & science enthusiast @uvmvermont 
Co-creator of https://t.co/jnVjnjXLxd & @compstorylab
Distracted by burpees & new data
Proud dad",0,0,1,0,1,300
26419626,bagrow,"Assistant Professor, Math & Stats, University of Vermont. Always trying to do awesome science stuff.",1,1,0,1,3,300
782795711989420033,epj_ds,A @SpringerOpen journal covering all aspects of #DataScience with a strong focus on computational social and economic sciences. Part of the @EPJscience family.,2,0,0,2,4,300
4515151,p_barbera,"Computational Political Scientist, @facebook @USCpoir @MethodologyLSE. Social Media and Politics. #rstats. Opinions my own. 🏳️‍🌈",1,0,0,0,1,300
11778512,masonporter,Professor of Mathematics at @UCLA. Formerly: Professor @OxUniMaths & Tutorial Fellow of Applied Mathematics @SomervilleOx. Schooled at @Caltech & @Cornell.,0,0,3,1,4,300
793717106256773120,lucasfindslinks,"PhD student in Black Magic (AKA: Network Science). Brazilian. Liberal.  Blacksmith. Escrimador. Science , Politics, Bears and Food. Opinions are my own.",0,1,1,2,4,293
712963903,SophieDBsjr,"Science / Feminism / Music // Studying sea ice in Nunavik Hudson Strait // Radio host on CHYZ 94,3 and CKIA 88,3 FM.",0,0,0,1,1,300
103973912,CompleNet,"11th Conference on Complex Networks. Date: TBD. 
Exeter, England, UK.",0,3,2,1,6,300
103370610,juniperlov,"Martha Stewart of science. The brewer of brainstorms. Data ethics nerd by night, complexity science evangelist by day.",0,0,2,1,3,300
490512649,LHDnets,"Assistant Professor at the Vermont Complex Systems Center. Likes networks, contagions, complex systems, public health, hockey, horror, cats, and black metal.",0,1,1,2,4,300
800351666,giosifid,Trinity College Dublin,1,0,0,0,1,300
352013269,beenwrekt,optimization. machine learning. uc berkeley. i don't know why twitter thinks you want to see my likes.,0,0,1,0,1,300
322347431,AFornito,"Doing cognitive neuroscience at @BMH_Hub & @turnerinstitute. We play with brains, networks, genes, models, cognition & disorders.",0,0,1,0,1,300
1886566261,claragranell,Complex Networks researcher. Juan de la Cierva Postdoc @ Universidad de Zaragoza. 90's kid. Tarragona m'esborrona. I mostly use Twitter to complain,0,1,1,1,3,300
48417486,ronaldomenezes,"Professor of Data and Network Science at University of Exeter. Director of the BioComplex Lab. Works on human dynamics, network science, and swarm intelligence.",0,1,1,2,4,300
712016577567264769,kcore_analytics,"PhD Physics, co-founder https://t.co/wj2M92uYpn. Predicting behavior and elections with AI.",1,1,3,0,5,300
1522281432,hutchkelley5,Reads a lot. Writes a lot. She/her/hers,1,0,0,0,1,300
434383401,jelenagrr,"Physicist and Data Scientist, co-founder of @DataBeersBru",0,3,0,0,3,300
2727517511,CantlonLab,"Associate Prof of Psychology studying origins of human concepts; TIME 2017 among The Silence Breakers, opposing sexual harassment; she",0,0,0,1,1,300
109533154,criedl,"Associate Professor for Information Systems, Northeastern University; Fellow at IQSS at Harvard University; Interested in data analytics and crowdsourcing",5,2,0,4,11,300
35467792,vcolizza,scientist,0,1,2,1,4,300
879070005844992001,gin_bianconi,,0,3,2,0,5,134
2770143649,jffmendes,"Professor of @physics, @networks, @complex systems, statistical physics",0,3,1,1,5,240
82566863,lordgrilo,"Topology, complex networks, neuroscience; Research Leader @ISI_Fondazione by trade; Angoleiro and wine-drinker by passion.",1,3,1,3,8,300
34721078,cerenbudak,"Assistant Professor @ University of Michigan, School of Information",2,0,0,0,2,200
473353790,compstorylab,Awesome Research Group run by @peterdodds and @chrisdanforth: The Computational Story Lab.,0,0,1,0,1,300
487381183,PiratePeel,"Data Mining, Pillaging and Plundering.
Postdoctoral research fellow  @UCLouvain_be #Networks #Data #ComplexSystems 
(co-founder of @databeersbru)",1,0,3,0,4,300
19819769,eegilbert,"Evans chair, associate professor @umsi + @EECSatMI. Formerly @GeorgiaTech. I'm a social computing & sociotechnical researcher. (photo: https://t.co/e8ddgDHvle)",0,0,1,0,1,300
317422543,ricard_sole,Scientist & skeptic. Dad. Pathologically curious. Studying  evolution of complexity with maths and synthetic biology. ICREA & SFI professor. Secular humanist.,0,0,0,1,1,300
27047369,cesifoti,"'19-Today: @Univ_Toulouse, @OfficialUofM, & @Harvard 
'13-Today: Founder & CEO @Datawheel
'10-'19: Faculty @MIT
'08-'10: PDoc @Harvard
'04-'08: PhD @NotreDame",0,0,1,0,1,300
373682248,HirokiSayama,"What I do not understand, I can still create. -- unknown アメリカで大学教員やっています．いつもヘンなことばかり考えています．意識低い系．",0,1,3,1,5,300
1979287862,DanLarremore,"Asst. Prof, CU Boulder Computer Science and @BioFrontiers.
Math, malaria, genomic epi, networks, and computational social science.",0,1,1,1,3,300
1019337134120062983,QuantBiology,NSF-Simons Center for Quantitative Biology is transforming our understanding of organismal growth and development through quantitative approaches.,0,0,1,0,1,219
90258002,sfiscience,"""A Justice League for renegade geeks."" - Rolling Stone
Indie research center pioneering #complexsystems #science.
@complexexplorer @sfipress #ComplexityPodcast",0,0,3,0,3,300
1149541562,ComplexExplorer,"Learn complexity science with our acclaimed online courses and other educational tools, produced by @sfiscience!
#complexsystems",2,0,5,1,8,300
751734284092792832,arxiv_org,"Unofficial bot posting recent scientific paper e-prints every hour, run by @yddt",0,1,0,0,1,300
416374176,bdanubius,Harvard Biophysics PhD Student || ND Physics ‘17 |||| *BD tweets in a personal capacity*,0,0,0,2,2,300
3096625956,LetsWorkHappy,"The #complexity & #systemsthinking #podcast. Sharing #interviews, stories & casual conversations about the #systems that shape our world & our work.",1,0,8,0,9,300
902498275,NUlabTMN,"The NULab for Texts, Maps, and Networks. A center for Digital Humanities & Computational Social Science at @Northeastern University.",1,0,0,0,1,300
835953569668939776,CompSysSoc,"The Complex Systems Society (CSS) live feed: all the information on conferences, schools, jobs openings, yrCSS news... and much more.",0,0,1,0,1,226
255048621,robysinatra,"Assistant Professor, IT University of Copenhagen. Favorite quote: The most dangerous phrase in the language is ``we've always done it this way'' (Grace Hopper)",0,1,0,5,6,300
15008596,bgoncalves,#DataScience #MachineLearning #SocialNetworks #Finance #HumanBehavior https://t.co/MJEZEaQwrY,0,2,0,0,2,300
445315503,mkitsak,"Assistant Professor at TU Delft, Consultant in Network and Data Sciences",0,1,0,3,4,103
880369521843986432,F_DeVicoFallani,"Inria research scientist - Signal processing, Network theory, Neuroscience",0,3,2,1,6,260
372689892,MartonKarsai,,5,0,1,2,8,148
972756485066371072,funwithnetworks,"News & Updates about Network Science (and/or Complex Networks, Social Network Analysis & Computational Social Science)",1,0,0,4,5,83
920343626907115520,WarrenCntrPenn,"A research center @PennEngineers, working to foster research and innovation in interconnected social, economic and technological systems.",1,0,0,3,4,300
74956332,mattk7,,1,1,2,2,6,300
229910053,cxdig,Networking the complexity community since 1999. Official news channel of the Complex Systems Society @CompSysSoc. Edited by @cgershen,2,2,1,0,5,300
1704085728,YR_CSS,Young Researchers of the Complex Systems Society,1,0,13,2,16,300
217771939,mszll,"Exploring 🧐 online+urban networks, mobility, data viz. Created: Pardus, HubCab, What the Street!?, @nerdsitu",2,1,4,5,12,300
46477409,Northeastern,"Northeastern is a global, experiential, research university built on a tradition of engagement with the world. #NUexperience",1,0,0,0,1,300
18810779,Karhe,"physicist, easily amused.",0,0,0,2,2,300
299603744,msantolini,"team leader @criparis, visiting @NUNetSI • co-founder @JustOneGiantLab • prev. @ENS_ULM @Princeton @harvardmed • #NetworkScience #CollaborativeSolving",2,0,1,2,5,300
1546977270,DirkBrockmann,Physicist - Research on Complex Systems - Institute for Theoretical Biology - Humboldt University of Berlin & Robert Koch Institute. https://t.co/4wOeuJFRZj,0,0,1,1,2,300
486530534,Scott_E_Page,Scott Page is John Seely Brown Distinguished University Professor at the University of Michigan and an external faculty member of the Santa Fe Institute.,0,0,1,0,1,300
368379922,uvmcomplexity,"The Vermont Complex Systems Center. Describe, Explain, Create, Share. Also: Roboctopus.",0,0,1,2,3,300
187521608,OSoMe_IU,The Observatory on Social Media (awe•some) is a research center at Indiana University to study the spread of misinformation. Tweets by Fil Menczer & OSoMe Team,0,1,0,3,4,300
19402238,ScienceNews,"Covering the latest news in all fields of science. Tweets by @wwrfd, @ThatMikeDenison and @Kate_Travis. Publisher @society4science. See also @SNStudents.",2,0,0,0,2,300
593041510,Sys_innovation,We are building a global platform for #Systems #Innovation. Research + Education + Community. Come join https://t.co/tzvhNij38z,0,0,3,0,3,300
931179613178515459,adilson_motter,Dynamics of complex systems and networks. Professor of Physics. Northwestern University. Married to Alyssa E. Motter (https://t.co/bsutcAoZb2).,0,0,2,0,2,273
377491711,badnetworker,"Computational social scientist. Personal-capacity tweets about complex social systems (real and simulated). Also NatSec, Python, sci fi, and cats.",1,0,0,0,1,300
831578365886885888,NDGannenberg,"Network Dynamics Group - Annenberg School for Communication, U Penn",4,0,0,0,4,109
490363356,santo_fortunato,"Director of @IUNetSci. Professor of Complex Systems @IUBloomington. Interested in networks, computational social science, science of science, climate change",0,2,3,5,10,255
1954278132,NICOatNU,The Northwestern Institute on Complex Systems (NICO) is a hub for research in complexity and data science that transcends established disciplines.,3,1,0,1,5,300
925988665,DaniSBassett,"Professor, Depts of Bioengineering, Physics & Astronomy, Electrical & Systems Eng., Neurology, & Psychiatry, University of Pennsylvania, & Santa Fe Institute",1,0,0,1,2,300
15045590,clauwa,"JProf in Computer Science at Univ. Koblenz & head of Data Science team at GESIS. Interested in  computational social science, networks and data science.",10,0,1,0,11,300
8143682,jure,Professor of #computerscience @Stanford; Chief Scientist @Pinterest; Investigator @czbiohub. #datamining #machinelearning #networks.,1,1,0,1,3,300
788363167,NAChristakis,Sterling Professor of Social & Natural Science at Yale. Physician. Author of Blueprint: The Evolutionary Origins of a Good Society. Luckily wed @ErikaChristakis,1,0,0,0,1,300
2329921,ladamic,Computational social scientist at Facebook.,1,0,0,0,1,300
30706856,pholme,Scandinasian networkologist,4,3,3,7,17,300
833373624,foucaultwelles,"Associate Professor at Northeastern University, network scientist, feminist, teacher, and mom. Appreciates novelty  socks and cat memes.",0,0,0,2,2,300
16191522,dashunwang,"Associate Professor at Kellogg, Founding director, Center for Science of Science and Innovation, Northwestern University",0,0,1,0,1,300
37213193,davidlazer,Computational social scientist at Northeastern and Harvard Universities.,1,0,0,0,1,300
1423906682,TheRealShankar,"Core Data Scientist at Facebook / Former Staff Data Scientist at Quora / Ph.D. in Condensed Matter Physics from Caltech, 2013",0,0,0,1,1,300
222050461,err45,"Complex networks & systems + Computational science + data analysis Lecturer in Computer Science 
Vidyasagar College, University of Calcutta, Kolkata, India",0,6,1,1,8,300
2837414492,sriniv_venkat,"Research Scientist, Biocomplexity Institute, University of Virginia. Interested in Network Science, Stochastic modeling, ABMs, Epidemiology, Data viz.",0,0,1,0,1,300
899009494507761665,toastferry,Earth systems. Mathematics. regenerative agriculture.,0,0,1,1,2,300
17270684,fusaroli,"Social interactions and cognition, stats, computational modeling and machine learning, complex systems, language, and mental disorders. He/Him",1,0,1,0,2,300
3970895777,SDuranNebreda,"Postdoc working on cultural evolution at the ETL w @svalver, previously plant complexity, multicellularity and Turing patterns. Co-Founder of @MoiraiBioDesign.",0,0,2,0,2,300
16330659,sgonzalezbailon,Fellow 2019-20 @CASBSStanford | Associate Professor @AnnenbergPenn | World Citizen | Research: https://t.co/fyPLL5neFd | Unpredictable stuff: stay tuned,0,0,0,2,2,300
1235961957515022338,aa_soc,"Sociology Ph.D. student @UofT. Researching social networks, the body, professions & organizations, qual methods, East Asia. Views my own. RTs not endorsements.",1,0,0,1,2,97
942672186032164864,sorianopanos,PhD student at University of Zaragoza. Fascinated by all related to complex networks and their application to real phenomena. Proud of my family.,1,5,0,1,7,196
15261050,leoguti85,"Loving science, technology and good music. Ph.D. guy doing applied research in data science. Bogotano adicto a las hamburguesas el Corral.",0,0,1,1,2,279
15658907,MLuczak,AProf @VicUniWgtn curious about maths of #emergence & #complexity @PunahaMatatini https://t.co/uMzqdWXOcW #hauptstadtneuseelaender 🇩🇪/🇳🇿,0,0,1,0,1,300
983259737314574337,YijunRan,"Link prediction, information diffusion doing a Networks PhD candidate at Southwest University.",1,0,0,1,2,62
18026546,ggeneraux,PhD student in Systems Science @BUSSIEDept.  Perpetual beginner. en/es,1,0,2,0,3,92
1091688538586992640,CHens19756161,"DST-INSPIRE Faculty
Physics and Applied Mathematics Unit
Indian Statistical Institute
Kolkata",0,1,0,0,1,3
3001907483,SrAleta,,0,2,0,0,2,35
801042537238695936,dnds_ceu,We carry out research in network science with a special focus on the foundations and applications of network science to practical data-driven problems.,4,0,1,5,10,300
1216150760079200257,sumofangles,Mathematician | 2020 PhD in Systems Science student at Binghamton University | Complex Systems and Networks,0,0,1,1,2,49
960138019843002369,martinrypdal,"Professor and department head at the Dept. of Mathematics and Statistics, UiT – The Arctic University of Norway. Climate science, epidemiology, complex systems",0,0,1,0,1,119
76084600,goranmuric,"#networks #simulation #complexity Postdoc, Research Associate, USC Information Sciences Institute",1,0,0,0,1,300
1307569508,sarayshai,Assistant Professor at Wesleyan University. Interested in #Networks and #Science.,0,2,4,6,12,300
277532657,rohan_iitj,"Assistant Professor in CS @bennettuniv | Postdoc @iitkgp | PhD(IIT Jodhpur) | Theory of Complex Networks, Network Modelling, Machine Learning | Views are my own",2,4,1,0,7,300
3486259881,dougsrferreira,,0,0,1,1,2,300
740343523,nirajkkushwaha,"Science,music,writing...that's pretty much me.  My objective- Contribute in unravelling the secrets of the cosmos and enjoy this one life i have,to the fullest!",0,0,1,0,1,300
499054463,diliara_valeeva,"Elites, corporations, inequality, computational social science, social networks. PhD at @UvACORPNET. Also author of @AsocialNets",1,0,1,1,3,162
870003531335565313,drandrewrowe,"PhD, UoN Researcher Training (tweets are my own), Social Network Analyst, Protest & Social Media Research, PGR Support enthusiast, co-creator of @LboroPhDSN",1,0,0,0,1,300
1179713956623114240,albe_bracci,"Phd Student @CityUniLondon - Computational Social Science, Complex Networks, Blockchain based ecosystems, Pizza",1,0,1,1,3,83
2488227390,_fduron,"Civil engineer. PhD student in management sciences.
Instituto Politécnico Nacional - México. @IPN_MX
Costs engineer in construction projects.",0,0,1,1,2,300
110446125,pratha_sah,Data Science | Epidemiology | Public health. Currently at Yale Center for Infectious Disease Modeling and Analysis,7,0,0,3,10,300
869067365157306369,rcardenasheredi,Rio de Janeiro/BRA - Santiago de Cali/COL. Theoretical biology / Biological networks and complex systems. Digital citizen. Internet culture enthusiast.,0,1,1,0,2,300
2895802438,FrontMathsStats,The official Twitter Feed for the open access journal Frontiers in Applied Mathematics and Statistics.,0,1,0,0,1,300
1157733977605603328,_NJ_Roberts,Grad student trying to make a useful contribution in disease modeling (yes it is my field). he/his,0,1,2,2,5,261
210328371,uarayon,Soy un astrocito pero la neta quería quedarme como CNS-progenitora. Chairo y moreno. Le hago a la complejidad y biología de sistemas. Outbound Analyst @platzi,1,1,0,0,2,300
1083383932819771392,MFGevry,Atypical biologist.,0,0,1,0,1,146
792012547301994497,JoshuaSStinson,,0,0,1,0,1,300
297736294,andres_salaza,Estudiante de PhD.,0,0,1,1,2,300
790241310024228864,RachithAiyappa,Curious speck of dust | incoming grad student (Ph.D. track),0,0,1,1,2,208
1057741124104847363,UVMCompSci,CS Department at the University of Vermont.,0,3,0,1,4,222
2810956798,Antropocaos,"Antropología, Complejidad y Caos. // Anthropology, Complexity, and Chaos.",1,1,0,1,3,105
2507260668,tarunkumarsnu,PhD scholar @iitmadras | Machine Learning | Data Science | Complex Network Analysis,1,0,0,0,1,31
2896712975,ddiannae,"Software Engineer | PhD Student in Biomedical Sciences.   
Computational Biology.
🧬👩🏻‍💻🎹🎼🎈💫
Team PyladiesCDMX",0,0,1,0,1,164
846697411099668481,FabBento,"Associate Professor @OsloMet Oslo Metropolitan University
- Complexity, learning and change in social systems",2,0,5,0,7,300
3163055411,Abdullahrhmoun,PhD Candidate in Network Science at CEU,0,0,1,2,3,300
768884790292541440,HistPhilSci,PhD Student in Sociology.              Centre Emile Durkheim.,4,0,0,0,4,300
140753054,vishoza,"PhD. I have interests in network analysis, omics, computational and systems biology.",0,1,0,0,1,300
780429268866052096,alexpghayes,"#rstats 🎉 & social networks. stats phd student @ uw-madison. prev @RiceStatistics, @rstudio. he/him",2,0,0,0,2,300
138222192,ricardoI_,"Plant Pathology at #UF, plant-virus interaction, viral ecology, metagenomics, and networks. @Garrett_Lab Fl | 🇲🇽 DerechosDelMigrante HRC/MSF",0,0,0,1,1,300
754031378950451200,manuelmoreno454,,0,0,1,0,1,104
2911645708,ejdansu,"PhD Student, Mathematical Biology/Sociology @TohokuUniPR. Maths Salon Leader @TEDxTohokuU. Social Manager @_TUFSA. Secretary @afam_org.",1,0,0,0,1,300
123842287,laeflu,Managing Director at Psycon Corp.  PhD Candidate at University of Turku,1,0,0,0,1,177
1004142841008754688,brookemariebell,PhD student in Preventive Medicine @USC | #publichealth #obesityprevention #mhealth #WearableTech #networks #sna #foodpolicy #nutrition #sustainability,1,1,1,1,4,171
15464243,choux,"Learning analytics, digital networks, peer effects, complexity science.",2,0,0,0,2,300
1953104810,KayseMaass,"@Northeastern Industrial Eng Asst. Professor using #ORMS to address #healthcare, #socialjustice & #humantrafficking | Previously @UMIOE & @MayoClinic | she/hers",0,0,0,1,1,300
1440886406,ZoltanElekes,"Senior research assistant at Umeå University; Lecturer at University of Szeged; Junior research fellow at ANET Lab, Hungarian Academy of Sciences",1,0,0,0,1,247
2742636202,balazsvedres,Oxford sociologist and network scientist,1,0,0,1,2,144
54531975,ennnvvy,"Researcher. Interests - Multi-Agent Control, Networks, Consensus, Opinion Dynamics, Community Detection.",2,0,0,0,2,300
166008261,jponnela,Associate Professor of Biostatistics at Harvard University. Director of Health Data Science Program. Digital phenotyping and statistical network science.,3,0,0,5,8,237
1216521482,lgaalves,"Postdoc at Northwestern University - Statistical Physics, Complex Systems, Complex Networks, and Data Science",1,4,1,2,8,300
112333725,n_kahmed,"Computer Scientist @Intel Labs. Purdue PhD Alumni @PurdueCS , IEEE Senior Member. Working in #machinelearning #algorithms for massive #graphs #data",0,1,0,1,2,300
2164757344,santosvtito,PhD Student in PolSci @ufmg | computational social science| bureaucracy and politics| network science| former visiting student @UBARectorado & @unb_oficial,8,5,3,5,21,300
778659791753220098,chakresh_iitgn,"Complex Networks, Dynamical Systems, Non Linear Physics, Sports Enthusiast, Physics and Society",2,2,0,1,5,291
1134960976695091212,CNWWs,"Complex Networks Winter Workshop
#CNWW20, #CNWW19, #CNWW18",0,1,1,3,5,170
24016742,droneale,"Talks to the animals. Network science & complex systems researcher w/ an interest in the messy, human aspects. Incompatible enthusiasms for running & craft beer",0,0,1,0,1,300
240789781,MartLStein,"Senior Onderzoeker, Coördinator Onderzoek LCI, RIVM. Infectious disease epidemiologist. Social Networks. Respondent-driven methods.",1,0,0,0,1,300
1834931742,qian_yifan,"PhD student @QMUL, working on Complex Networks, Science of Science and Machine Learning. MSc, BSc @Beihang1952 Diplôme d'Ingénieur @CentraleNantes",1,1,0,2,4,46
962911429052518400,gdeandajauregui,"Network Biomedicine. Systems Pharmacology. Complexity. Buzzword Overflow. 
Researcher, INMEGEN/CONACYT.
English, Español & #rstats",0,0,0,1,1,300
224814031,cyr_em,PhD student | Quantitative Social Psychology | @UWaterloo,0,0,1,2,3,101
1011880954279981056,Herman_MSH,Almost Nothing! Enthusiastic about #DATA ! & #Complex_Networks |.| https://t.co/TRFPL9TdEz in #Complex_systems & #Networks🤓,0,0,1,0,1,300
1428700644,uclfincomp,University College London is a world centre of excellence for research and teaching in Financial Computing & Analytics .,0,0,2,0,2,198
386025050,ryanqiwang,"Father of two daughters, professor, researcher. Research area: urban and social resilience, neighborhood effects.",1,0,0,0,1,175
1093681836327198720,NetSciX2020,"International School and Conference on Network Science, January 20-23, 2020 #NetSciX2020",0,3,2,4,9,241
3246553077,YifangMa,"Postdoctoral Fellow at the Northwestern Institute on Complex Systems (NICO), working on Computational Social Science, Data Science and Network Science",0,0,0,1,1,103
1006295526722203652,Madea_Zabi,"PhD candidate of computer science, working at @wrightstate on data analytics for complex cyber-security and Socio-technological systems",0,1,0,1,2,119
813725467756863488,randomGraphs,"initialize Mersenne twister *beep beep boop beep* drawing random graph *krkrr krr ping*
waiting for your request",0,0,0,1,1,300
444854831,saeedosat,"Ph.D. student,
Complex Networks",0,2,0,0,2,40
7559192,mr_sunshine,"Fascinated by Psychology, Neuroscience and all kinds of networks. Globalize friendliness!",0,0,1,0,1,300
197886036,sapiezynski,"Research Scientist @ Northeastern. Privacy, transparency, fairness, computational social science.
he/him/his",2,0,0,0,2,185
89509276,Vivfiona,"Computational Sociologist. Tech, (Counter)Terrorism & Society. Data & Network Sci Algorithmic Bias AI ML NLP WVU PhD student. Data Science Fellow #GHC19 scholar",0,0,0,1,1,300
984782025344409600,MencheLab,,0,1,1,3,5,193
52602820,Sebespejo,Life researcher. Analyst of biological and social data.,0,0,0,1,1,300
1010308067827896321,EvoplexOrg,A powerful platform for agent-based modeling on networks #OpenSource #OpenScience #NetworkScience #ComplexSystems #AgentBasedModeling #MultiAgentSystems,0,0,1,0,1,24
159565864,adarshmathew92,"Wannabe Computational Social Scientist @UChicago's MACSS, curious about knowledge in networks. Serial RTer, esp Football. Writes fleetingly. He/him.",0,0,0,1,1,300
16696406,nj_goncalves,,0,1,0,0,1,176
850892377627742209,tylersnetwork,"PhD Candidate @dse_msu. Intern @HRLLaboratories. #SocialNetworkAnalysis with negative links, #DeepLearning on graphs, and #DataScience for social good.♻️",0,0,0,1,1,300
1006231814107750401,LabNode,Nonlinear Dynamics and Evolution (NoDE) Lab • lead by @JosepSardanyes • The NoDE Lab is part of the Computational & Mathematical Biology Group @CRMatematica,0,1,2,0,3,300
2669156418,ian_hoffecker,Scientist at Karolinska Institute. Engineering DNA nanotechnology to perform information processing tasks for understanding cancer and improving diagnosis.,0,2,0,0,2,300
887242609,AnisabelBento,Quantitative Epi & Infectious Disease Ecology | Pathogen evolution | Assistant Prof @IUSPH @Prepared4Change @IUBloomington | @bento_lab,0,0,0,1,1,300
621489211,kayladelahaye,"scientist and advocate of public health, food, social networks, & complex systems |  assistant professor @USC",7,1,1,4,13,300
2519410236,SomnathTagore,"Post-Doc Research Scientist @ Califano Group, Columbia University.",0,2,0,2,4,300
1038442496,chapakiti,"Geomatic Engineer turned Health Researcher. Interests in Demography, Epidemiology and Computational Social Science. Full time Rotarian.",2,0,0,0,2,300
780345816561033216,cnnjojo,,4,3,0,1,8,300
54100811,danjbecker,"ecology & evolution of infectious disease, zoonoses in bats & birds | postdoc @ IU | assistant professor at University of Oklahoma starting Fall 2021 | he/him",1,0,0,0,1,300
221354550,diestra77,"Father of Darelle and Luis David. Love science, reading, music; addicted to passionate people. For those who love what they do, will always do what they love :)",0,0,0,3,3,300
40383352,evoluchico,"Researcher @oiioxford | @BlaBlaLogia | @SVBRoficial | @huffpostbrasil | Computational social science, complex systems, cultural evolution, data science and art.",0,0,1,0,1,300
64595550,Nietzchrodinger,"Souththeborderian-LatAm.  ❤️💚💜 #JuliaLang FTW. 
PhD student at @uvmcomplexity (Neurobotics Lab).  Pocho feed. I draw maps with stats.",0,1,0,0,1,300
3185442680,jrncarlock,"Investigador: Desapariciones, Corrupción e Impunidad @OCIUNAM @IIJUNAM | Physics & Complexity Science | Co-founder: @redcompleja",0,0,3,1,4,300
974711500551147521,stonge_g,,0,0,1,0,1,34
53763883,crcandiav,"Postdoctoral Scholar @KelloggSchool & @NICOatNU & Asst Professor @CICS_UDD
Social Complexity Scientist (PhD & MSc), Physicist (BSc, MSc, Eng). Research2Impact",1,0,0,1,2,300
834030478042738689,nikhil07prakash,"Visiting Student Researcher @kixlab_kaist | Former Intern Samsung R&D, @iitrpr & @HasuraHQ | Interested in #HCI #SocialComputing #MachineLearning...",1,0,0,1,2,300
843499634517594113,plzbeemyfriend,"co-organizer of @DataVizDC, 
@Satrdays_DC, and @R_LGBTQ",0,0,2,2,4,300
815673126818299904,alliecmorgan,"CS PhD candidate @CUBoulder, @NSFGRFP. Former intern @nytimes, physics undergrad @Reed_College_. Computational social science, ML, networks. she/her",1,0,1,1,3,274
175782460,oneofyen,"CS grad student @CUBoulder; loves stories, networks, and science.",0,1,0,3,4,300
870742957380558848,PhysicsNEU,Northeastern University Physics Department,0,1,1,0,2,245
1344397614,BMAlthouse,"Principal Scientist, Co-chair Epidemiology, Institute for Disease Modeling",0,2,0,0,2,172
223521568,TehRaio,"😊Research Scientist😜 @ Boston Fusion, Msc in @statsuct Complexity, Networks, ABM in econ/finance, also ✌🏿A I ✌🏿... 🙄 | 🇨🇮🇿🇦🇺🇸🇸🇳🇫🇷",0,0,1,1,2,300
575376342,kaltenburger,Research Scientist at Facebook. Tweets are my own.,0,0,0,1,1,183
200865067,Arjitkapoor,"I guess things are complex....

Interested in Complex systems and Generative Systems. I code too!",0,0,1,0,1,300
148052204,DanajaT,"PhD candidate at @UMSI |Research Fellow at @LIRNEasia | Data Science, Networks, Cities",4,0,3,0,7,300
1017873282,teo_criscione,PhD Candidate in Network & Data Science at Central European University #economicnetworks #communitycurrency #complementarycurrency #ecovillages,2,2,0,0,4,300
4723010406,anshulheaven,"Researcher -- Dynamical systems, Networks, Scientific Computation, Machine Learning. // Postdoc at NC State University.   
🇮🇳🇩🇪🇺🇸",1,0,0,1,2,300
2261831748,lista_redes,Análisis de redes sociales en español. A cargo de @isidromj,8,0,0,1,9,300
1246421,danbri,"I run https://t.co/J6I7PykOEt, work at Google.

Semantic Web, RDF, FOAF, Linked Data; ex- W3C. Immigrant, lapsed Bristolian, European.

he/him",0,1,0,0,1,300
1585948734,jessecshore,"Assistant Professor of Information Systems at BU: social networks, network science, collective intelligence",6,0,0,2,8,300
572949103,p_serodio,"PhD in Pol Sci. Networks enthusiast. Researcher at @ubeconomics. Former @NU_Business, @SociologyOxford and @BNC_Members.",0,0,0,1,1,300
27700085,natera,Network scientist. PhD candidate at @dnds_ceu Former @singa_lab @ITESO // Visiting student @medialab @civicMIT 2015 // Views are my own,0,0,1,1,2,300
2695374271,simply_jaehyuk,"PhD candidate in Informatics, Indiana Univ., Future of Labor & Labor Market, Economic Sociology, Network Sci, Now P/T Working @ Core Data Science team, Facebook",0,1,0,1,2,300
2184712454,tozCSS,Dad. Husband. Computational social scientist at @Humanyze. PhD candidate at @CSS_GMU.,1,0,0,0,1,300
178525062,apastorepiontti,"physicist, network scientist, epi-modeler,Northeastern University, MOBS Lab",0,0,0,2,2,300
3001054244,pandeypradumn16,Assistant Professor @ IIT Roorkee,2,2,0,0,4,300
13879522,GiulioRossetti,Researcher @ ISTI-CNR | #DataScience | #NetworkScience | #ComplexSystems | #PythonInside |,4,4,1,4,13,300
624806128,HocineCherifi,,0,1,1,1,3,300
131264897,iacopoiacopini,Complex Networks · Data Science · Urban Mobility · Guitar Playing  // @QMULMaths & @CASAUCL,1,2,0,3,6,300
1296859046,LeonieMueck,"VP Product @RiverLane_io. Recovering editor (@nature, @PLOSONE). Quantum Computing, Open Science, D&I and *some* politics. She/Her. Views my own.",0,0,0,1,1,300
118402066,nitishk_Phd,Former Postdoctoral Researcher @lcs2iiitd. Ph.D Mathematics from University of Delhi. Nonlinear Dynamics. Complex Networks. #MTBoS #ITeachMath,0,0,0,1,1,59
864586231853830144,_giuliacencetti,"Physicist, PhD on dynamical systems on complex networks. Postdoc on computational social science at @FBKcom.
Habituée at @dnds_ceu.",0,4,0,0,4,58
96989025,anduviera,Network scientist,0,0,2,2,4,300
122724789,sees_lab,Roger Guimerà & Marta Sales-Pardo - Science and Engineering of Emergent Systems at Universitat Rovira i Virgili & ICREA,0,3,3,4,10,300
860561435117719553,sentinelle_nord,"Recherche, formation et partenariat nordique transdisciplinaire | Développement technologique | Optique-photonique | Microbiote | Santé | @universitelaval",0,0,0,1,1,300
543881355,dcalacci,"student, artist, technologist -- cities, social science, AI + ethics, weird queer boy. doctoral researcher @medialab, he/they, tweets are just me.",0,0,2,0,2,300
186484265,rayohauno,"Researching complex networks and systems at IFEG-CONICET, FaMAF, UNC.",0,2,0,0,2,300
414979077,Mire1a,"Interested in networks/graphs, cognition, ABM, AI, (FL)OSS, linux, security, cryptography, piano, bikes, ... |
 @ cbs[.]nl/Statistics Netherlands (personal ~)",0,0,1,1,2,300
564948043,tacomanbearpig,"Food, music, and fantasy novels are great. That's where my authority ends.",1,0,1,1,3,300
213083607,gomezgardenes,Physicist. Prof at University of Zaragoza & Head of GOTHAM Lab. Research on Networks and Complex Systems Science.,1,6,1,5,13,300
220633309,Ank_iitR,Assistant Professor at IIT-Roorkee,0,0,0,1,1,300
1307251459,claudia_mihai,"Complex Systems Scientist, Physicist",2,3,0,0,5,300
72912621,pwillburn,People Analytics and Insights at Workday and part time Network Scientist,4,3,1,2,10,300
911193721936457728,PolNet2018,"The 11th annual Political Networks workshops & conference will be June 6-9, 2018 in Arlington, VA at GMU",2,0,0,4,6,300
91975097,jmblanch,"Physicist interested in complex systems, R&D+i and programming. Environmental Sciences PhD student.",0,1,3,1,5,246
348029933,beautiful_data,"A blend of machine learning, data and art. Data Visualization, Math Research and commercial bespoke projects by Beautiful Data.",1,0,0,0,1,300
1315396027,andreasantor0,"Complex Networks · Optimization - Data Science  - 
PhD student  at @QMULMaths",3,5,1,5,14,300
4120890970,NoemiDerzsy,Senior Inventive Scientist at @ATT Labs - Data Science & AI Research; PhD Physics; organizer of @DataUmbrella and @WiMLDS_NYC; #NASADatanaut,1,0,1,0,2,300
830442736402653185,MainulSabbir003,"Doing MS in Physics at @miamiuniversity 
In love with Complex Networks, Percolation Theory, Complex Systems, Biophysics & Neuroscience.
Doing Research @osim_lab",2,7,3,2,14,251
300589072,CNicolaides,Faculty @UCYOfficial & Digital Fellow @MITSloan. PhD from @MIT_CEE. #bigdata #socialnetworks #contagion,1,0,1,1,3,300
2375509748,IUNetSci,Indiana University Network Science Institute,2,3,1,5,11,300
144087818,zhangqian_rach,"A pseudo computer scientist working on data science and computational health with computational physics, complex network, machine learning approach.",1,0,0,1,2,190
1169143062,evepanag,"Applied Developmental and Educational Psychology, Lynch School of Education, Boston College",0,0,1,0,1,69
1965433188,NetworkLeaderTA,"Network Leadership Training Academy is a 3-day workshop to learn how to address the challenges of building, managing, & evaluating effective inter-org networks.",3,2,1,3,9,299
305504617,VNetworkLabs,"Using our lens as network scientists, we help networks, coalitions, alliances & other partnerships collaborate more strategically for social impact.",0,0,0,3,3,300
22615177,melegaro,"Associate Professor, Demography, Social Statistics, population studies, modelling infections, vaccinations, @unibocconi, @DondenaCentre",4,0,0,0,4,300
33826996,juemos,"Anthropologist, Biodemographer, Disease Ecologist, Stanford Professor, Castaño House RF",0,0,1,0,1,300
3196161958,KevinZollman,"Philosopher and Game Theorist at Carnegie Mellon ⏳Aspiring parasitic wasp ⏳ Author of The Game Theorist's Guide to Parenting (FSG, 2017)",1,0,0,0,1,300
822240036280111105,misinfocon,"MisinfoCon is a community of people focused on the challenge of #misinformation. MIT (2017), London (2017, 2018), Kyiv (2018) and DC (2018). #misinfocon",1,0,0,0,1,300
567627175,hxnx_sam,I am a computational biologist and research the evolution and spread of pathogens over networks and between species.,1,0,0,0,1,300
1128158782263947264,NoaPinter,"Behavioral ecologist. Studies how individual differences in behavior, social networks, and the built environment affect collective outcomes. UCLA.",2,0,0,0,2,128
727455850521059328,GBerlu,"Lecturer in Criminology @SurreySociology | Co-offending networks, social network analysis, illicit markets | Views are my own | RT != endorsements",3,0,0,1,4,250
27048570,c_lemp,"Interested in complex systems, processes, and patterns in business, art, and life. List maker. Views are my own.",0,0,5,2,7,300
258069365,eleanorapower,"anthropologist, human behavioral ecologist, phillumenist, assistant prof at the LSE. (she/her)",2,0,1,0,3,300
2749655899,ulfaslak,Postdoc at DTU Compute in @suneman's group. Currently working on mapping mobility during COVID-19 lockdowns.,0,0,1,1,2,300
795717775989833729,glitch,The friendly community where everyone can discover & create the best stuff on the web! 🙋💖🎉 For service updates: https://t.co/vXG9wObBYS,1,0,0,0,1,300
532247558,IFISC_mallorca,Institute for Cross-Disciplinary Physics and Complex Systems (UIB-CSIC).,1,2,1,0,4,300
854413000350072836,chingjin120,"Complex Network, Computational Social Science, Complex Substitutive System, Science of Science",0,0,0,1,1,36
2459490150,netmob2019,"8-10 July 2019, Mathematical Institute of Oxford University",2,0,0,1,3,248
1140731021517869063,NetworkCanvas,A free open-source set of tools for the collection of social network data.,1,0,0,0,1,60
88499773,Spiralizing,"Scientist. Postdoc @jplotkin Lab. #JuliaLang FTW.  Statistical Physics & Complex Systems. Music, Coffee, Videogames & Football ⚽.",1,2,1,1,5,300
1420409148,paulhinesuvm,"Co-founder, CEO @PacketizedE. Prof. of Electrical Eng. @uvm_ee @uvmvermont. Solving clean energy problems. Fascinated with how things work. Proud dad.",0,0,1,0,1,300
2919229315,TPMWhanau,"Te Pūnaha Matatini Whānau - the network for Te Pūnaha Matatini's postgraduate students, postdocs and early career researchers in complex systems and networks.",0,1,5,2,8,300
326721354,KONECTproject,"Network science project by @kunegis and colleagues, University of Namur, Belgium. We collect and analyse everything that can be modelled as nodes and edges.",1,1,0,1,3,278
35031140,BasHofstra,"Postdoctoral Fellow, Stanford University: computational social science || (online) networks || science of science || text analysis || (big) data ||",0,0,0,1,1,300
37658556,galen_jw,"PhD student interested in Statistical Physics, Learning, and living far beyond climate change.",0,2,1,0,3,300
19590257,frankolken,"DBMS, semantic web,  data science, SIGMOD, ontology, healthIT, EHR, FIBO, ruleML, OWL,  KR, network sci,  functional prog., fintech,  BPM. See also @frankolken2",2,1,1,1,5,300
14065835,mstrohm,"Professor for Computational Social Sciences and Humanities @RWTH Aachen University, Germany & Scientific Coordinator @gesis_org. Editor-in-Chief @epj_ds",4,0,1,0,5,300
41860681,dianarycai,PhD student @princetonCS. Machine learning and statistics research. @WiMLworkshop Board of Directors. she/her,0,0,0,1,1,300
90410110,ranzHer,"Chief Scientist at UNICEF Office of Innovation, NY - Social Networks Analysis - Data Science - https://t.co/RNUaHhT6DR",0,1,3,1,5,300
1040219371665272834,networks_lab,"Betzel lab at Indiana University.

We study the structure and function of biological neural networks.

Tweeting all things networks and all things neuroscience.",0,0,1,0,1,16
17842485,tanisjones,"Computer Science professor at URV. Data Science & Network Science researcher. CoFounder of ChimuSolutions. Also interested in games, technology & education.",1,3,2,3,9,300
162605310,mZargham,"Founder https://t.co/eOAuvARBHL
Inventor https://t.co/KSprSwozlg
R&D @crypto3conomics
PhD @Penn AI & Optimization
Complex Systems, Epistemology, Ethics, Math, Engineering and Society.",1,0,1,1,3,300
2228815292,lewis_math,"Applied mathematician at @UniOfAdelaide, working with data and models on #complexsystems problems. I like #datascience, #socialnetworks, #networks, #socialmedia",0,1,1,1,3,300
611941887,hedonometer,"Real-time, online measurement of happiness and more | created by @compstorylab and MITRE. Consulting: https://t.co/18MQa9ErmN",2,0,1,0,3,300
477776093,desi_hristova,"[urban,geo,social] data scientist",3,0,0,0,3,300
36434049,robreich,"Professor of Political Science, Stanford University. Center for Ethics in Society, Center on Philanthropy & Civil Society, Human-Centered AI",1,0,0,0,1,300
138523049,SFILive,"Santa Fe Institute's space to livetweet community events. 
Find webcasts at https://t.co/4lIFDg3WJ3
For research news, follow our main account @sfiscience.",1,0,0,0,1,300
14923954,sfilibrary,Archived account: please follow @sfiscience for all new research and publication announcements!,3,1,3,0,7,300
4824029985,DataScienceUDD,"Data Science Institute, @ingenierosUDD, @UDD_cl",0,0,0,1,1,300
778954431438159872,SophieMeakin,Consultant at @WHO based in Goma 🇨🇩 Math modeller focussed on outbreak response 🦠 she/her,0,0,0,2,2,218
18928144,Living_Cities,"A collaborative of 19 foundations & financial institutions working to close racial gaps, so people in U.S. cities are economically secure & building wealth.",1,0,0,0,1,300
3242942145,theandrewsfox,"Post-doctoral research associate. University of Oklahoma. Interested in the intersection of politics, society, and emerging technology.",1,0,0,0,1,20
2911074730,B_W_Campbell,"ML; Data, Network, and Computational Social Scientist. Data Scientist, @CoverMyMeds.  Visiting Scholar, @osupolisci.  RTs != endorsements, content is my own.",1,0,0,0,1,300
705339936514428928,thinking_22,"Researcher. Complex systems, complex networks, and collective behaviors",4,4,3,10,21,300
2381150314,Faqeeh_ali_,"Postdoctoral Fellow; research areas:
computational social science,  complex networks, stochastic dynamics, and mathematical modelling",3,2,1,3,9,300
1187259026,fennell_p,Networks | Statistics | Machine Learning. Data Scientist @talamobile,1,0,0,0,1,300
250831420,SonicNU,"The Science of Networks in Communities (SONIC) research group advances social network theories, methods, and tools.",1,0,0,6,7,300
355774354,lynnwu02,"Professor @upenn,@wharton, @nberpubs studying the economics of big data, AI, social networks",1,0,0,0,1,134
2330499302,thesickish,"Child wrangling and data rearing. Researching online behavior, social networks, and political communication @uarizona. Retweets ≈ endorsements.",1,0,0,0,1,300
2165165029,ISI_AI,ISI is home to one of the world’s leading artificial intelligence research labs that explores diverse topics across basic & applied research continuum.,3,0,0,0,3,167
32807399,KristinaLerman,Social media and social computing researcher at USC Information Sciences Institute.,1,0,0,0,1,300
437797632,Vesteur,"CNRS researcher at Institut Pasteur, Paris; data-driven modeling in computational neuroscience and complex networks, developing inference and numerical methods.",1,3,1,4,9,300
1689700388,networksvox,"Complex Networks/CocoNuTs, CSYS/MATH 303, U of Vermont, Prof. Peter Sheridan Dodds. Companion course for @pocsvox.",4,5,1,1,11,300
383895664,JordiPinero,Theoretical Physicist @CSLab_UPF. Science & Complexity. Travel enthusiast.,0,0,4,0,4,300
950788068096831489,GrandataLabs,Research lab of @GrandataCorp. Using #BigData #AI and #DataScience to understand #SocialNetworks and #HumanBehavior,1,0,0,0,1,300
52188980,necsi,The leading research institute in #ComplexSystems science theory and applications. President @YaneerBarYam,0,0,12,0,12,300
1964709944,MscxNetworks,"Mediterranean School of Complex Networks, since 2014 the International Summer School on Network Science",0,6,1,3,10,218
256652655,giaruffo,"Professor of Computer Science; Research in Complex Networks, Data Science, Web and Data Mining, Computational Social Science, Network Analysis",2,2,0,5,9,240
1502671567,lau_retti,"Postdoc at the SODAS Centre for Social Data Science. Computational Social Science, Networks, Behaviour, Human Mobility.",2,1,0,1,4,300
995412536,TAledavood,James S. McDonnell Postdoctoral Fellow @GeorgiaTech @gtcomputing #DigitalPsychiatry #ComputationalSocialScience #DataScience #ComplexSystems #Networks #mHealth,0,0,2,1,3,300
423847851,UrbanDemog,"Rafa Pereira. Researcher @ipeaonline, @TSUOxford PhD. Structured procrastination on Cities, Spatial Analysis, R, Transport, Equity, Accessibility, Demography",0,0,1,0,1,300
878191890755190784,ArshamGhavasieh,"I do physics , make coffee and sleep too much .",0,1,1,1,3,300
905481181910761478,csqsiew,Psycholinguist who uses network science to study language networks.,0,0,2,9,11,300
234017215,gdfm7,"Gianmarco De Francisci Morales, Senior Researcher @ISI_Fondazione. Formerly @QatarComputing @AaltoUniversity @YahooLabs @HPCLab @IMTLucca. Scalable data mining.",1,0,0,1,2,300
472562889,timalthoff,Assistant Professor @UWCSE developing data science methods that leverage large-scale behavioral data to improve human well-being. Recruiting PhD students :-),1,0,0,0,1,300
3569432363,m_rosvall,"Professor of physics with focus on computational science in Integrated Science Lab, Icelab, Umeå University.",0,1,1,5,7,110
1689492204,pocsvox,"Principles of Complex Systems/PoCS,
CSYS/MATH 300, U of Vermont, Prof. Peter Sheridan Dodds. 
Leads to next course @networksvox.",0,0,1,0,1,300
2329657867,JurgenPfeffer,"Prof of Computational Social Science @TU_Muenchen / Bavarian School of Public Policy. Adjunct Prof @CarnegieMellon. Social Network Analysis, Social Media, #CSS.",1,0,0,1,2,300
804105624,sdwfrost,"Computational biologist, data scientist, interested in all things infectious. Principal Data Scientist at Microsoft, Professor of Pathogen Dynamics @LSHTM",0,0,0,1,1,300
19330436,marcobardoscia,"Financial stability, complexity, applications of statistical physics. Music lover and serial concert-goer. The views expressed are mine only.",0,1,1,1,3,300
2548304936,eugeValdano,"post-doc researcher at University of California Los Angeles. Epidemiologist, physicist, network scientist.",0,2,0,0,2,203
423024537,alerizzo_,"Complex networks and systems, epidemic modeling, robotics. Music is my soul food. Always busy preparing my next big thing. @PoliTOnews and @NYUTandon",0,2,0,0,2,300
916842583,NKouvaris,Data Scientist @Dribiacom and Complex Systems&Networks researcher,0,6,0,1,7,300
107138253,grinbergnir,"Assistant prof. @BenGurionU, dad^3, train+bike, tired/aspiring barista. Studying how information systems can better serve us using ML, NLP, Stats, CSS, HCI.",0,0,1,0,1,277
9949272,hukuzatuna,Complex systems | astronomer | hacker | coder | security dude | AI/ML/Stats  | shooter (cameras) | shooter (weapons) | sailor | dad,0,0,2,0,2,300
2353960442,brain_stim,Deputy Director @brainpark | developing neuroscience-based lifestyle and technology interventions for mental health,0,0,1,0,1,300
820346467546177537,NetContagions,NetSci 2018 satellite on contagions spreading on networks.,1,0,0,0,1,64
27403471,cecim,"Mother of teenager and Professor of Mobile Systems, University of Cambridge. Co-Director of Centre for Mobile, Wearable Systems and Augmented Intelligence.",1,0,0,0,1,300
709642077315923968,AramisLabParis,"Research laboratory @CNRS @Inria @Inserm @upmc @icm_institute - Data science, statistical learning, complex networks, neuroimaging, neurodegenerative diseases",0,1,0,0,1,234
2603978460,misicbata,Assistant Professor @TheNeuro_MNI | McGill University,0,0,0,1,1,300
1961016907,FreebornGroup,We explore brain connectivity and complex networks ... with some colleagues in France #CNRS #INSERM #INRIA,1,8,1,1,11,300
567698748,wetuad,Complex Systems | Faculty @ Queen Mary University of London,1,1,0,1,3,300
2210857693,VeraPancaldi,"Cancer Research Center of Toulouse  and Barcelona Supercomputing Center. Interested in networks, heterogeneity and genome architecture",0,0,0,1,1,300
505744768,NinoNaf,Rsearcher at ETH. Working at the interface of Complexity & Data Science​,0,2,1,0,3,174
1672632270,WorldPopProject,Open spatial demographic data,2,0,0,0,2,300
914061558254329856,ccs18gr,Conference on Complex Systems 2018       #CCS18    #CCS18GR   Chaired by Panos Argyrakis,1,2,7,0,10,300
167693954,dhillon_p,@umich @umsi professor | computational social science & machine learning researcher | previously @mit @penn | @celtics @ledzeppelin lifer,1,0,0,0,1,300
114288615,arutherfordium,"Senior Research scientist Center for Humans & Machines 
@Max_Planck_CHM. Ex @medialab @unicefinnovate @unglobalpulse @necsi @ucl",0,1,0,0,1,300
320922867,JSMF,"Established to improve the quality of life, JSMF does so by contributing to the generation of new knowledge through its support of research and scholarship.",0,0,1,0,1,160
1406622804,BettencourtLuis,Fascinated by people and the amazing things we do together in cities.,0,0,1,0,1,170
1376401838,iyadrahwan,"Director, Center for Humans & Machines @Max_Planck_CHM @mpib_berlin | Associate Professor @MIT @medialab |",0,0,0,1,1,300
2924669003,Max_Planck_CHM,Center for Humans & Machines (CHM) at the Max-Planck Institute for Human Development @mpib_berlin led by @iyadrahwan,2,0,0,0,2,300
1855503205,AmaralLab,"We are the Amaral Lab at @NorthwesternU. We Study Complex Systems, Science of Science, and Systems Biology.",0,2,0,3,5,300
93476253,dfreelon,"Associate prof @UNCHussman // Principal researcher @unc_citap // Politics, #rstats, #python, #opensource // Make sure they remember you.",1,0,0,0,1,300
2538040298,Sarah_Morgan_UK,Theoretical physicist working on brain networks for schizophrenia @ Cambridge Brain Mapping Unit (postdoc). Also excited about diversity in STEM. She/her,0,0,0,1,1,300
4053731357,Ghoshal_G,"Associate Professor of Physics, University of Rochester; Complex Systems | Network Science | Human Dynamics | City Science",0,4,4,2,10,300
376412811,FoxandtheFlu,Research Associate at UT Austin working on statistical epidemiology. General outdoors and hiphop enthusiast. These are my personal thoughts and opinions.,0,0,0,1,1,300
274712575,BinghamtonCoCo,"The Center for Collective Dynamics of Complex Systems at Binghamton University, State University of New York",0,0,3,1,4,300
720389270335135745,TheWebConf,"Taipei is the host city of the 2020 edition, celebrating the 30th anniversary of the Web on April 20-24, 2020. #TheWebConf #TAIPEI",0,0,0,3,3,300
965340488692838401,a_cardillo,"Complex system scientist -- remote husband -- amateur photographer & keen traveller.

""... I scream my barbaric YAWP over the roofs of the world ""
(W. Whitman)",3,7,1,0,11,300
1061622836,MangioniG,,3,4,7,3,17,300
263702718,catera_roma,"MD epidemiologist, emerging infectious diseases. Innovation and vaccine expert.",0,0,0,1,1,300
398927965,sanmelons,"Staff Scientist @IFISC_mallorca. Research Scientist in Complex Systems. Networks, Pizza and Snowboarding.  From Rome, Italy.",0,5,8,7,20,300
36119322,chpoletto,"Researcher @INSERM - network epidemiology, network physics, disease ecology, outbreak analysis",0,1,1,6,8,300
272065025,lajello,"Computational social science research @BellLabs Cambridge, UK. Formerly @YahooResearch and fellow of @ISI_Fondazione. Co-organizer of @databeersldn.",1,0,0,4,5,300
923196260630368256,ICCS2018,Official Twitter Account for ICCS 2020 hosted by @NECSI,0,0,14,1,15,300
1360175358,m_starnini,"Researcher at ISI Foundation on digital epidemiology, computational social science, network science. Former J.S. McDonnell fellow at Universitat de Barcelona.",1,1,0,1,3,300
874075994,BioFrontiers,BioFrontiers Institute - undaunted exploration of the greatest challenges in human health and welfare.,0,2,0,1,3,300
3526601,derekgreene,"Assistant Professor @UcdCompSci 
@Insight_Centre + @vistamilk +  @Connected_Pol + UCD Centre for Cultural Analytics",2,0,0,1,3,300
937358015904337920,ComuneLab,"Research Unit for Multilayer Modeling and Analysis of Complex Systems, led by @manlius84 at @FBKcom",0,2,5,5,12,246
993739562,GrandataCorp,Understanding people with data,1,0,0,0,1,300
156031097,apanisson,Data Science. Machine Learning. Complex networks. Social media. Researcher Leader at @ISI_Fondazione.,3,0,1,0,4,300
2431801963,laetitiagvn,Researcher at ISI Foundation,1,1,0,1,3,105
44217911,rschifan,"Interdisciplinary scientist @unito and @ISI_Fondazione. #DataScience, #Networks, #MachineLearning, #Social Media, #Urban and #Maps enthusiast.",3,1,1,3,8,300
1479301693,_alephsys_,"Research group: Algorithms embedded in physical systems.
Coordinator: ALEX ARENAS.",2,8,0,0,10,254
226571318,jblumenstock,Assistant professor at UC Berkeley,1,0,0,0,1,79
1523174335,KoljaKleineberg,Lead Data Scientist @Glovo. Sailor. PhD in Physics.,0,1,1,2,4,300
3230611617,ComplexAndBio,Center for Complexity & Biosystems,0,0,1,0,1,300
126046965,fariba_k,"Scientist 👩‍🔬 - Data Science, Network analysis and Computational Social Science, Germany",12,2,0,4,18,300
807365647,C4COMPUTATION,"Professor, Santa Fe Institute | Director, Collective Computation Group @ SFI |  Chair, SFI Public Events | https://t.co/WHgs01mARZ",0,0,3,1,4,300
897866837333037058,CNS_NRT,Interdisciplinary Training in Complex Networks and Systems @ Indiana University,0,2,2,1,5,142
1960705284,ISI_Fondazione,Istituto per l'Interscambio Scientifico,1,2,0,1,4,300
255051048,fblamanna,Transportation Networks • Urban Mobility • Data Analysis & Divertissement @databeersVCE 🍺 and @pydataVenice 📊🐍,0,0,0,2,2,300
562790169,eflegara,Physicist 👩🏼‍🎓 Complex Systems Scientist 👩🏼‍💻 Aboitiz Chair in Data Science 👩🏼‍🏫,0,0,2,0,2,300
24669093,jlmateos,"Doctor en Física. Depto. de Sistemas Complejos, Instituto de Física, UNAM: Caos, Complejidad, Redes. Resercher: Complex Systems, Chaos, Networks",0,0,1,0,1,300
260415455,graphcommons,"Platform for mapping, analyzing, publishing data-networks. Email/PGP public key: https://t.co/qtdg6rCCF5",0,5,0,2,7,300
500364862,dorogovtsev,I am playing with networks,0,13,1,0,14,300
1467737210,elisa_omodei,Predictive Analytics Lead @mobileVAM @WFP. Vice-President Secretary @CompSysSoc. Tweets are my own.,5,1,5,2,13,300
1632913393,CSLab_UPF,Research group in complex systems at Universitat Pompeu Fabra (Barcelona),0,0,7,1,8,300
2912834655,clabbarcelona,,2,5,3,0,10,204
25805235,robinberjon,"Data Governance & Privacy at @nytimes (views own) — Former @w3c, @w3ctag — Web, Science, Politics, Philosophy. (he/him/Ishmael)",0,1,0,0,1,300
1028855810,ChristosEllina1,"Co-founder and CTO @ Nodes & Links, a VC-backed start-up; Past: EPSRC Fellow @BristolUni, Vis Prof @FollowStevens; Plays with #Networks and #ComplexSystems",1,5,4,4,14,300
3000719200,CIDIDteam,"The Center for Inference and Dynamics of Infectious Diseases | Understanding the  spread and evolution of infectious diseases, one model at a time",0,0,0,1,1,300
194399316,cgershen,I'm a part of the self-organization of the universe... and research professor @UNAM_MX //alterego hispanotuiteante: @cgg_mx,0,0,1,1,2,300
1937243048,zoltantoroczkai,"complexity physicist, math, network science, foundations of computing, woodworking, outdoors",0,2,0,2,4,300
829734980351844353,HacklScience,Assistant Professor @LivUni | complex urban systems | risk & resilience | network science | computational modelling | visualisation | infrastructure systems,0,0,0,2,2,48
577195836,gagliol,"Computer scientist, gone social.  Teaching: math, logic, informatics. Research: social networks, social media, migrants, collective action.
OT: slacktivism.",1,0,0,0,1,300
16174436,suneman,Your friendly neighborhood suneman,0,0,0,4,4,300
821654937851613186,netsci2018,Twitter account of the 2018 NetSci conference.,2,1,2,7,12,300
85125367,filrad,,0,3,0,0,3,79
2785720331,ccs17mx,Conference on Complex Systems 2017 #CCS17. Co-chaired by @cgershen & @jlmateos,3,1,2,1,7,300
14112036,dankessler,"{Neuro,Data} Scientist &
PhD Student @UMichStatistics",1,0,0,0,1,300
149806281,alainbarrat,,1,0,1,1,3,300
235957352,mikk_c,,0,1,1,2,4,245
367297219,MelMitchell1,"Davis Professor at the Santa Fe Institute.  New book, ""Artificial Intelligence:  A Guide for Thinking Humans"": https://t.co/g4VrG7tcrw",0,0,3,0,3,300
531122860,ComplexityInst,Recognize the present to explore the future,0,0,0,1,1,300
1923380198,YKhorramzadeh,Computational physicist. PhD. Interested in joint application of complex network and data analysis.,1,0,0,2,3,300
79911730,BenJamesBush,,1,0,1,1,3,242
632724692,RenaudLambiotte,"Associate Professor at the Mathematical Institute, Oxford University",0,5,4,2,11,300
14093970,estebanmoro,"Researcher, scientist, curious. Associate professor @uc3m & visiting professor @medialab & Connection Science (MIT)",1,0,0,0,1,300
94596289,schichmax,"Maximilian Schich is currently an Associate Professor at UT Dallas, working to understand the nature of art and culture.",0,1,2,1,4,300
849359202871070720,macfang17,"Mapping Complexity: Foundations and Applications of Network Geometry. Barcelona, November 2017.",0,1,0,0,1,5
3505171469,appliednetsci,"Open-access, strictly peer-reviewed journal publishing in all established and emerging fields benefiting from quantitative network-based modeling",8,7,1,10,26,275
104124584,marfcg,"Pesquisador em Saúde Pública
Research areas: epidemiological models, population dynamics, and epi. surveillance.
Gaúcho, Colorado e Físico!",0,0,0,1,1,215
56805505,ingo_S,"Professor for Data Analytics at University of Wuppertal, DE / SNSF Professor at University of Zurich, CH / Editor @epj_ds / Hiking, Canoe, Sailing & Photography",4,2,1,6,13,300
75641981,Ognyanova,"Research: tech, politics & media, networks & computational social science | Asst. Prof. @RutgersU | Past: PhD @USC, Lazer Lab postdoc @Northeastern & @Harvard",2,1,0,2,5,300
2252674884,SFI_Chaos_MOOC,The Santa Fe Institute's Introduction to Chaos and Dynamical Systems MOOC offered through the Complexity Explorer,0,0,2,1,3,275
78589126,matteomoci,Software engineer,1,0,0,0,1,300
2284174986,Fede_Botta,Lecturer in data science at @exetercompsci (previously at @WarwickBSchool @thedatascilab). Founder of @DataBeersWrik. Works on computational social science.,2,0,3,1,6,300
78719897,didiervega,"Postdoc at CNetS in School of Informatics, Computing and Engineering -- Indiana University",0,2,2,1,5,300
1047749410686455808,GysiDeisy,"Network Scientist, Bioinformatics, stats & biotech. R Developer. Intense. Bittersweet. 
#rstats #netsci #bioinf",0,0,0,1,1,274
578430883,ErisSeiren,PhD Candidate + Advanced Tech Master + Telematics Eng + Data Scientist + IT Solutions Architect + NetSci + Data Eng,0,2,0,1,3,300
291991124,MoisesGualapuro,,0,1,1,1,3,299
931948904,cleonrin,PhD | Research @ Banco de la República (Central Bank of Col.) | Extramural Fellow @ Tilburg Univ. | Part-time prof. @ Univ. del Rosario | (PERSONAL OPINIONS!),0,0,1,0,1,300
388651749,alientometal,"PhD Candidate
Trumpet player",0,1,0,0,1,300
302735772,rkcpanigrahi,Looking for PhD positions in Bioinformatics. I want to grow my career in Bioinformatics algorithm development. If any positions are available please inform me.,0,0,0,1,1,300
3912267406,soojongkim_1,"PhD candidate @AnnenbergPenn @Penn | computational social science, networks, and information",2,0,1,0,3,300
4761196712,ArochaJG,Especialista #SistemasComplejos | MPA 2018 @harvard | @securefree fellow | Teniente Coronel (R) | Primer #PresoPolítico en #LaTumba | Soldado de Conciencia 🇻🇪,0,0,2,0,2,300
835323448675164162,complexbrains,"Işıl Bilgin, Mathematician, Cybernetics PhD Res. @UniRdg_BEL, @UniofReading. Res Assoc. @UWEBristol, UK. Complex/Brain Networks, EEG/fMRI, Semantics",0,1,0,0,1,300
1214957186121687041,ProfMilenkovic,Professor of #ComputerScience. Researcher in #NetworkScience & #ComputationalBiology. Huge #CocaColaFan. Even bigger #DogPerson. We need more #WomenInComputing!,0,0,0,1,1,164
1088293715834216448,ChienshihHuang1,"PhD Candidate at the Askew school. Method: SNA, Experiment. Study interlocal collaboration, executive turnover, policy support",1,0,0,0,1,41
1159182391455490049,Jo_Youngheun,"phd student @networks_lab IU | mother of cat, cook, traveler, brain network enthusiast 🧠 likes, follows != endorsements",0,0,0,1,1,26
1154392441346240513,mundocomplexus,Cómo podemos aplicar el #pensamientocomplejo y #sistémico en nuestra vida diaria #mundocomplexus #complejidad #EdgarMorin #complexity #complexus #complexsystems,0,0,1,0,1,50
4571541142,garridinh0,Drinking coffee. One deadline at a time #procrastigraphing,0,0,0,1,1,259
7685632,frankmoshe,"PhD Candidate in Applied Computing with focus in Complex {Systems|Networks}. Entrepreneur, Painter, Internet lover. Seventh-day Adventist.",1,0,1,0,2,300
425533559,guillermo_id,Life & Social Sciences │ Researcher @datapopalliance │ #GIS #DataScience │ #CubanSalsa,0,0,0,1,1,107
40457334,jlarrosa,"Economist, PhD Universidad Nacional del Sur  Associate Professor. Social Network Analysis, Webscraping data, IPC Online. Mountaineering",1,1,0,0,2,300
1664996929,LL_Portes,"Physicist, Pythophilo. Research Fellow at UWA Maths",0,1,1,0,2,300
1124685928608555008,granpooli,Granpool Innovative Investments acquires significant minority stakes in innovative companies.,0,0,0,1,1,58
57171233,dques2766,"Theoretical and Computational Physicist; Interests: Complexity, Biometeorology, Applied Data Science, Modeling and Nano-sciences/coffee/outdoor/brainstorm",2,0,1,1,4,300
2151613198,tatianadragutan,"Curious human being, interested in making the world just a little bit better. PhD candidate @beta_economics, twitting on innovation, data science and politics",1,0,0,1,2,185
83485959,SergioAlcala_,"I'm Physicist interested in #ComplexSystems and Theoretical Biology.
Postdoctoral scholar at https://t.co/WJV6jzysUA in @UChicago.
Sobre otras cosas: @SerONoSerch",0,4,1,2,7,300
145754389,eddywongch,"Technologist, startups, graphs/p13n/data science, uwphoto, travel, foodie| Former CTP, Allaire, CTO @GoWanderu, @Redphare| Architect @DataStax 🇵🇪🇨🇳🇺🇸",1,0,0,0,1,300
742475738977308674,ragarwa2,"PhD
Affiliation: @inria_Paris, @IITKanpur, @C3iCenter 
Research in: Human Mobility, Network/Data Science, Self-Organization, Nature Inspired, IoT, Semantics",1,2,0,4,7,164
1517372827,selcanmutgan,"PhD Candidate studying micro-macro dynamics of segregation in Sweden using #registerdata @IAS_LiU      (R)Tweets in EN, TR, SE",5,0,0,0,5,300
1345735165,alexcmichels,"Spatial Informatics @ UIUC.
CyberGIS Center | CIGI Lab.
Informatics | Networks | Topology",0,1,0,3,4,300
496163705,m_cnakhaee,"Iran, Kerman (Tehran)
PhD student,  
Data Science group 
University of Twente
https://t.co/OFjjm4PIhc",1,0,0,0,1,220
1201660004928897024,BenFerrum,"BioHacker, Graph Analyst and wants to measure consciousness",0,0,0,1,1,242
2659003274,meichen_yu,"Postdoc fellow at University of Pennsylvania. Brain network analysis using fMRI, MEG and EEG in Alzheimer’s disease, FTD and major depressive disorder",2,1,0,0,3,300
137349966,leoferres,"Professor of Computer Science, @DataScienceUDD, @IngenierosUDD & Fellow, Telefónica I+D, @tidchile, & ISI Fellow, @ISI_Fondazione",0,0,2,0,2,300
1388112362,brsepulvado,"Computational social scientist with interests in bioethics, science, cognition, and inequality | he/him/his",1,0,0,3,4,300
327836613,MGuevaraA,"Full time professor at @upla_comunica @upla_ingenieria, part time faculty @informaticaUSM, former collaborator @CollectiveMIT.",0,0,0,1,1,300
434091746,pranavathiyani,"PhD Student | DBT-BINC JRF at Centre for #Bioinformatics, Pondicherry University. #Learner #RStats #DataScience #Python #ML #Perl #SysBio #AMR #NetworkScience",0,0,1,0,1,300
986017875407327232,v_valerioh,"Ag & Bio Engineering PhD Candidate at @UF modeling ag trade networks and value chains. CrossFit, chihuahuas, data science, public health & R.
🇺🇸 🇩🇴",0,1,1,1,3,300
203574192,zuxfoucault,,0,1,1,0,2,300
832218151291125761,NasutoSlawek,"Professor of Cybernetics, #BrainComputerInterface, #neuroengineering, #animats, Biomedical Engineering",0,0,3,1,4,300
912372680438964224,ChengLin829,"Master's student in Computational Social Science. Interested in social mobility, political soc, ML&Stats, and social networks. Gamer",1,0,0,0,1,44
2489960958,MassimoSt,,1,2,1,1,5,300
1033815615017037825,JocksanVille,"Sometimes chaos, sometimes ordered, sometimes critical  || Undergraduate Program on Genomic Sciences. UNAM",0,0,1,0,1,35
1917923376,rishabhk_,"Assistant Professor at #igdtuw and Research Scholar @precog_iiitd in Online Social Media, Views / Opinions are personal",1,0,1,1,3,300
2417892751,arvidmartin,Ph.D. Student @IAS_LiU // Studies social influence- and aggregation dynamics in social systems (eg cultural & labor markets) using PML+Causal inference+ABMs,0,0,0,2,2,77
777027480901263360,jlmquiroz,"#Física #CxSc #NetworksScience  #Humor #Ateismo  
(no necesariamente en ese orden)",0,0,0,1,1,300
2417494752,osirisrankin,Amateur father. Graduate student. Self destructive behaviors researcher. Clinician in training. Ford fellow. Late bloomer. Comics fan. Other stuff.,1,0,0,0,1,215
202124719,aminulacj,"Faculty at the Department of Media Studies and Journalism, University of Liberal Arts, Bangladesh. 

Alumnus of @ACJIndia",1,1,0,0,2,300
1929084218,NgiguaOax,"Researcher- IPN-Mexico, Complex Systems. Interested in science, regional food, mezcal and wine...",1,1,1,0,3,300
932895309826609152,mblukac,"PhD @KU_Leuven, Associate at @INETOxford | computational social scientist: #rstats, social networks, agent-based computational modelling. Father of a 👸!",2,0,1,0,3,300
1158176849224187909,istudymemes,Physics+Philosophy Undergrad; Network Science/Communications Researcher trying to understand the mysteries of the cosmos but also the internet (he/him),0,0,0,2,2,99
1157333126378639365,alex_nafnlaus,"Undergrad student at UWaterloo.
Network science, complex systems, volleyball, climbing.",0,0,2,0,2,201
1161824396094296064,HengChienLiou,"#Taiwanese Undergrad Researcher. 
Networks, Compu Soc. & Alg Game Theory.
I do tweet about politics, because science is tangled w/ politics. 
NTU. Taiwan.",0,0,0,1,1,77
274888804,anshuman2111,"PhD student in Ecology and Evolution;
Paleobiology enthusiast",0,0,0,1,1,122
2791157881,hyunuk_kim07,"Postdoctoral Associate, Questrom School of Business & Institute for Health System Innovation and Policy, Boston University",1,1,3,0,5,300
1604482998,polbalen,Profesor en  DF - Exactas - UBA. Investigador CONICET               Biofísica y Sistemas Complejos,1,0,0,1,2,300
1158039446559895552,FarahmandHaamed,PhD Student - Civil Eng (Construction Eng & Mgmt) | Urban Resilience Lab | Texas A&M University | Urban Resilience & Resilient Infrastructure Researcher,1,0,0,0,1,4
244481174,Fire_and_Skill,Geography / Network Analysis / Consumption / @ManMetUni / University of Edinburgh @UoEacademysport / @FB_Collective / @ASD_SportDir,1,0,0,0,1,300
795983437660241920,MohieddinJafari,"Senior Researcher, Computational Systems Biologist, Interested in Network Science, Text Mining and Traditional Medicine.",0,0,0,2,2,300
20760700,silviafierascu,"I translate complex problems into solutions for organisational development, political communication, better governance and citizen mobilization. @uvtromania",1,0,1,3,5,300
972083542187565056,shelbysturrock,"PhD Epi student (UofT) interested in behavioural 💪🏻, spatial 🗺 and infectious disease 🦠 epidemiology using mobile health data ⌚️📱",0,0,0,1,1,187
15176649,lespin,"PhD. Candidate at @GESIS_org & @unikold. CTO @neoBOXec. Interests: #NetworkScience #DataScience, #ComputationalSocialScience, #OSN https://t.co/SAJtYr8EJu",1,1,0,1,3,300
1075735051252293635,asrayagiriraj,"PhD Scholar, IIT Delhi. Data Science, Neuroscience, Systems Biology. A hopeless book lover.",1,1,0,3,5,300
1224215975354040320,webbdanielk,"Data consultant. Likes network science and being upside down. 
He/Him/His",0,0,0,1,1,1
1067828599699451911,EFSForum,,1,0,0,0,1,44
1920201936,AlinaLungeanu,Research Assistant Professor @NorthwesternU,0,0,0,1,1,34
2742114133,randnetworkwalk,"I take random walks on Twitter and analyze social networks to study social movements and hunt down disinformation, bots. Avid reader aspiring to be a scholar.",1,0,0,0,1,300
1057191776119795712,takayukihir,"Postdoc at Aalto University in Finland, interested in complex systems.",0,0,1,0,1,20
100184465,brunofmr,"Assistant Professor of Computer Science Purdue University; Deep 
Learning, Relational Learning, Markov Chains, and Sampling.",2,0,1,5,8,246
1411308931,_stalaga_,"Social structure, social networks and stuff.",1,0,0,0,1,38
441778701,_marameo_,"Complex Systems, Complex Networks @ENSdeLyon | e-Government @unikold | Agent-Based Models, Econometrics @unito",1,2,6,2,11,300
29825518,kenaiello,"Arizona State University
ASU-SFI Center for Biosocial Complex Systems
ASU Global Biosocial Complexity Initiative",0,2,2,0,4,300
1133069780917850112,yang3kc,Kaicheng Yang | Informatics Ph.D@Indiana University Bloomington,0,1,0,1,2,209
41152850,josephshaheen,"Intel. Community Postdoc Fellow. Computational Social Science. Quantifying the Human Element w/ Networks, Simulation, Math. Views=Mine. 私は古い方法で新しいものと戦う戦士です。",0,1,1,0,2,300
443619917,Orsi_Vasarhelyi,network & data science,1,0,0,0,1,289
991997831065079808,vandanaravindrn,"post-doc researcher working on viral host interactions, network science , computational biology @robertson_lab",0,0,0,2,2,67
79778135,italodovalle,Computational Biologist. Brazilian,1,1,0,0,2,149
1024738329080684544,draykol,AI for materials discovery,0,0,0,1,1,82
3261620311,KavehKadkhoda,"Complex Networks researcher.

Journey before Destination.",5,2,4,13,24,278
125939065,abhijitchak,Post Doctoral Fellow @CSHVienna @IIASAVienna,0,2,1,1,4,300
2218087722,Sang_MACT,"Enterprise Architect - Data Science & Analytics (TCS)
social network researcher
poetry
diversity and inclusion",1,0,0,1,2,46
11535642,mqpasta,PhD - struggling entrepreneur - Father of a cute daughter and a son https://t.co/hrVQ6ehRWz,0,0,1,0,1,300
4740322372,IHowenstine,,0,0,0,2,2,193
16621479,TheShubhanshu,PhD Student at @iSchool @UIUC. Information extraction using machine learning. All tweets under CC - By NC SA. I created ReadLater https://t.co/rDKLiPfswZ,0,0,1,1,2,300
115677576,souzatharsis,"i like building awesome things with awesome people 
-- products, ML, data @twosigma 
-- CS PhD @UCL

**opinions are my own**",0,1,0,1,2,300
13256982,thannigan,"Assistant Professor of Organization Theory & Entrepreneurship, U of Alberta. Strategy, Innovation,Tech, Economic Sociology #MgmtTwitter",1,0,0,0,1,300
730791459545210881,ShekatkarSnehal,"Asst. Professor at SP Pune University.
Mathematical modeling, complex networks.",1,1,2,1,5,300
985771476,gcyalcin,"Complexity science, network theory, nonlinear dynamics, statistical physics of complex systems, interdisciplinary applications https://t.co/EPeWTueZqN",0,1,1,0,2,300
1905068233,AaronSchecter,"Assistant Professor of MIS @ University of Georgia. Networks, analytics, and innovation",1,0,0,0,1,252
743078311245406212,hougogh,Surrender to my life？？？？？？？？？NO！！！！！！！！！！！！！,0,1,0,1,2,99
1115668382601191424,d_rshk,"Learner: interested in Synthetic Biology, Tumor Immunotherapy, photography, Economics and network regulations.",0,0,0,1,1,285
61722243,AnshuB,"CRI Fellow, Paris, Senior Scientist, CSIR-Institute of Microbial Technology (@CSIR_IMTECH), Assistant Prof.  ACSIR, India",0,0,0,1,1,300
594492962,pramodsshinde,"Postdoc at @ljiresearch | Computational biologist | ""Curiouser and curiouser"" about data | Former DST INSPIRE fellow at @IITIOfficial",0,0,1,1,2,300
393482901,dasmiq,"Associate professor of Computer Science at Northeastern University, adjunct at UMass Amherst, researching NLP, ML, IR, and digital humanities.",0,1,0,1,2,300
817123152,FPVantaggiato,"Lecturer in Public Policy @Kingspol_econ. 
Public policy, governance, infrastructure, networks, #rstats.",0,1,1,1,3,300
863802878611390464,pie_try_ka,"FSU political scientist studying social influence and political behavior.
Tweets about #networks, #rstats, #dataviz, #gazebos",0,0,0,1,1,300
922181130429726720,wilkenphd,Research Psychologist @realAIBRT. @UWMadison and @UCRiverside alumna,2,0,0,3,5,300
2447130548,MontesdeOcaMA,"Principal Data Scientist at clypd - Xandr, Lecturer at Northeastern U.   

Prior: 
-Postdoc, U. of Delaware. 
-PhD, U. libre de Bruxelles. 
-MSc, Tec de Mty.",0,0,1,1,2,300
100067469,chrix2,Exgoogler. Engineer. Astronomer. Software tester.Python and math lover.Regular speaker at international events of software testing.Machine learning practitioner,1,0,0,1,2,300
252158413,ilyesboumahdi,"Chef de Service des Activités Tertiaires et de l'Economie du Savoir @DEPF4 @financesmaroc
Enseignant vacataire INSEA.",0,0,0,1,1,300
293983295,vtraag,"Researcher @CWTSLeiden. Computational social sciences, networks and modelling. Background in math & sociology. https://t.co/phx9slUJTf",2,0,0,3,5,300
724980445281181696,annie_waldherr,"Assistant professor for digitized public spheres at @ifkms. Translocal networks @SFB1265. Public dynamics, complexity, computational methods.",1,1,1,2,5,300
172003643,ilunapla,"Investigadora en derecho a la información, transparencia y corrupción Instituto de Investigaciones Jurídicas, UNAM",0,0,0,1,1,300
21537777,robymuhamad,"Social network, digital media, health behavior || Columbia University (PhD Sociology) , ITB (MSc theoretical physics).",2,0,0,1,3,300
47616056,bendfulcher,Trying to understand physical principles of brain organization and dynamics using statistical analysis and complex systems modeling @sydney_physics,0,0,1,0,1,300
5815392,mhough,"[In thick Austrian accent] Just some guy, you know.",0,0,1,1,2,300
987484325749895168,lucmsanchez,Psychiatrist and Neuroimaging Researcher at University of São Paulo. Working with pyschosis and fmri. Also interested in phenomenological psychopathology,2,0,0,0,2,300
1198709368734265344,DanKaiser37,A PhD student in Complex Networks and Systems at Indiana University,0,0,0,1,1,47
4823510037,Sina_Mansour_L,"PhD student at Unimelb, Network Science enthusiast, in pursuit of PhD in computational neuroscience",0,1,0,1,2,197
903178068348604417,Yuriantonacci89,PhD student in Bioengineering,0,0,0,1,1,106
1015367604364566528,DuyDuongTran1,Combinatorics Graph Theory Network Neuroscience Probabilistic Combinatorics,0,0,1,0,1,80
17105921,orduek,"Clinical Psychologist,
Postdoc Associate",0,0,1,1,2,300
226713274,complexitatcat,,0,2,2,1,5,300
907683663428636674,yoed_kenett,I study the structure of semantic memory and how it constrains cognitive processes operating over it in typical and clinical populations.,0,2,1,6,9,300
2670678517,AlGoulas,Networks and neuroanatomy. Behaves nicely if approached with a choco-bar.,0,0,1,0,1,300
42812541,marls_canyon,"girt with a ceint of silk, with barres smale / graph theory and applications",0,1,1,0,2,300
300303342,angelo_mele,Associate Professor of Economics at @JhuCarey. Research on econometrics of social networks and social interactions.,2,0,0,0,2,300
101978854,sarikajalan9,"scientist Prof. Physics #complexnet #multilayer networks, #graphspectra, #chimera. worked at @mpipks @mpimis @nus. Phd from @prl",1,1,5,2,9,192
2813514115,ESAdisease,Disease Ecology Section of the Ecological Society of America #disecol Follow us on Instagram: ESAdisease,0,0,0,1,1,300
107516884,IULuddy,"Official news, events, and announcements from the Indiana University Luddy School of Informatics, Computing, and Engineering.",1,3,0,1,5,300
164190842,miki7s,"Research data scientist @BellLabs, former @Iceyefi, @ISUnet, PhD from @AaltoUniversity. Passionate about art, #socialcomputing, #math, #space",2,1,1,0,4,300
724717520,quantum_goat,"Theoretical Physicist. Fluctuations in complex systems, classical chaos and quantum chaos are my areas of interest. I don't want be Dean.",0,0,1,0,1,300
2301856730,AlfonsoLangle,"#Posdoc #SNA #NetworkAnalysis #ecosystemservices #migratorybirds #GlobalAssesment @IPBES @RedSocioecoS Opiniones personales, retweets no son endosos.",0,0,1,0,1,300
156804540,FranciscoICMC,"Scientist. Associate Prof. at the Univ. of São Paulo. Science, Physics, Complex Networks, Data Science. Visiting Professor at the University of Warwick.",2,10,1,4,17,300
3089452732,silviojrufv,"Professor of Physics, working on complexity and a
enthusiastic of Thermodynamics.",0,2,0,1,3,165
1858779979,MeysamAIizadeh,"Postdoc @Princeton @WilsonSchool | Computational Social Science, Social Media and Politics.",3,0,0,3,6,300
1184531975870115840,HNet_Initiative,Interdisciplinary research and solutions to heal patients and communities. Located at Brigham & Women's Hospital / Harvard Medical School.,1,0,0,0,1,55
926506527216865281,aymeric_vie,"Simulation and Evolutionary algorithms to understand economics, networks, game theory and history • External Fellow at @NECSI and student at @PSEinfo",1,0,2,2,5,300
156259271,ilireh,"PhD in computer science @tugraz. Interested in #complexnetworks, #computationalsocialscience, #agentbasedmodelling, #datascience, #openscience",0,0,0,1,1,114
1205961550361747462,ZahraMoradimnsh,"Computational Neuroscience, Brain Networks, Neurodevelopmental Disorders. #InstituteForCognitiveAndBrainSciences, Iran.",0,0,0,1,1,54
823615160006967297,petra_vertes,,1,1,0,3,5,300
30619250,pasdup,Head of Internal Audit - My retweets are not necessarily endorsements.,0,0,1,0,1,300
219262963,phantomread_,Worries about correctness (comp. sci). Living and designing systems with an acute awareness of tail risks. @ubcVSE '18. Currently @cowriepayments,0,0,1,0,1,300
5470342,jeanjacques,,2,0,0,0,2,300
778200301,VinkoZlatic,"Complex systems scientist, head of Condensed Matter and Statistical Physics group @institutrb, fishing, music, traveling, all opinions are my own...",0,3,1,0,4,279
281909635,SamuelHeroy,human simpleton studying complex systems. applied math(s) postdoc @oxunimaths/@CASAUCL,0,0,1,0,1,300
2464715803,ace_ebert,🇦🇺 Statistics postdoc @USI_university🇨🇭 Interested in networks 🕸 and Bayesian inference. Author of R package 📦 queuecomputer.,0,0,0,1,1,300
55997459,iPif,,0,1,1,1,3,123
21133252,chibold,"Researcher at CNR, working on computational social science, OSN analysis, urban computing, delay tolerant networks.",2,0,0,1,3,300
953317748,hasterly,"human, geographer, PhD student | #migration | #communication | #ICT4D | @TransReProject @UniVienna |",0,0,0,1,1,300
1404517633,And_Scalco,Computational Social Scientist @rowett_abdn. Working on #AgentBasedModels and #ConsumerPsychology for #Sustainable #Diets. Perpetual guitar beginner. MOV,1,0,1,1,3,274
49413866,randal_olson,"Chief Data Scientist, @FoxoBioscience. #MachineLearning, #AI, and #DataViz. Community leader for @DataIsBeautiful. #OpenScience advocate. Opinions are my own.",0,0,1,0,1,300
2437359170,geosimafrica,"Faculty-Data Science @williamandmary, PD @TUBerlin, PhD @UniBonn, MS @GeorgiaTech, AICP. Tweetn abt spatial stat models, human dev processes & R. husband/father",0,0,1,0,1,62
2435499030,SMyers1983,"Evolutionary anthropologist by day, bookseller by night. Maternal investment, postnatal depression, life history, evolutionary demography, behavioural ecology.",1,0,0,0,1,300
158678965,vtunali,"Assistant Professor. Complex Network Analysis, Text Mining, and Machine Learning Researcher. Software Engineer with 15+ years of industry experience.",0,1,0,1,2,300
58265438,vincentgauthier,,4,10,4,0,18,300
1227753529248485378,AvrumGillespie,I am a nephrologist interested in ESRD patient social networks and living donor kidney transplantation. Please excuse the #dyslexia.,1,0,0,0,1,64
1217607688621678592,huihui59359856,"data science, network science, epidemic",0,0,0,1,1,0
399544729,KatolaZ,I play with complex systems and networks. Software at https://t.co/etuPJTs60l network data sets and code at https://t.co/1Tozqz91cV,0,1,2,1,4,300
254554813,carlo_fisicaro,"Physicist of Complex Systems.  Physical-Mathematical modeling, Data Science, Quantum Computing and Complexity are my areas of expertise.",0,1,0,0,1,24
1090634060383350786,SINeLabDTU,Social Interaction and Neuroscience Lab at DTU Compute. We study behavioural and brain mechanisms underlying social interaction.,1,0,0,0,1,241
410072997,Marco_Tizzoni,,1,0,0,0,1,300
16084329,pieranna_calvi,,1,0,0,0,1,300
40428645,Oskarryden,"PhD student in political science, University of Gothenburg.",1,0,0,0,1,300
921672902,SipkaSays,"Datababy. Centrist. Firm but fair. Data science for social good programme manager @warwickuni. Views always my own, but change occasionally.",1,0,0,0,1,300
53333835,fsyloslab,"Physicist, writer, editor of Roars, interested in astrophysics, complex systems,  science policy, science evaluation, economics.",0,0,1,0,1,300
3445125555,CJBanks84,"Computer Scientist, Research Fellow (Core Scientist) at The University of Edinburgh, Mountaineer, Cyclist, Geek.",1,0,0,0,1,300
1174740308,alexbarclay_,"Advisor, digital policy & innovation at State of Geneva // Lecturer @SciencesPo // Research associate @mcminstitute // PhD candidate @HSGStGallen",1,0,0,0,1,300
2654227392,rorygreig1,"Software Engineer @improbableio   Simulation, Economics, Finance",0,0,1,0,1,300
3196174300,PhilippeWal,data scientist trying to overcome his unhealthy addiction to hyperparameter tuning.,1,0,0,0,1,300
125453933,edoardobianco,italiano in brasile,0,0,1,0,1,300
737362108397060096,KulikovUNIATF,"External Relations Officer @WHO, @UN Task Force on #NCDs. Support countries achieve #UHC and #health related #SDGs. PhD MPH MD. All tweets are my own.",1,0,0,0,1,300
309507135,complejidadyec,"Seminario en la UNAM.
Busca divulgar el enfoque de la Complejidad a Economistas y Científicos Sociales interesados en estudiar sistemas socioeconómicos",0,1,3,1,5,300
702028721251868672,svcmls,,0,2,0,0,2,78
1137000237611069442,DavideMottin,"Assistant professor at Aarhus University, interested in graph analytics, graph mining, data management, and machine learning. Hobbies: hiking, running, swimming",0,0,0,1,1,61
532074653,DirkHelbing,http://t.co/fVR2AyT09b,0,0,1,0,1,300
887665294570815488,CommsPhys,"An open access @nresearchnews journal publishing high quality primary research, reviews and commentary in all areas of physics.",0,1,1,0,2,300
257553582,benradwenidriss,,2,2,1,0,5,128
1223932829492547585,ArihBoh,"Physics editor at @CommsPhys, recovering postdoc. Most likely art, science, tango, kittens. Random otherwise. All views my own.",0,0,1,1,2,79
1181472815540822016,sustyplexia,Predicting Earth-relevant social and economic futures. Next generation interdisciplinary global change research: complex systems modelling and data science.,0,3,11,0,14,196
566542654,MathbookIT,"""The most beautiful thing we can experience is the mysterious. It is the source of all true art and #science"" (A. Einstein)",1,0,0,0,1,250
168140435,raffaelevacca,"Sociologist and data scientist at @UF • International migration, health disparities, social networks, science and collaboration 🇮🇹🇪🇺🇺🇸",8,0,0,0,8,292
54740139,JisunAn,"Scientist at QCRI, Doha. AI for Social Good. Social media analysis. Computational Journalism and Comp. Social Science. NLP and ML.",0,0,0,1,1,300
112452573,words_life,Postdoc at @UCLA Communication. Recent interest in tackling online (mis-)information using computational methods. Former @QatarComputing Ph.D@SoC KAIST,1,0,0,2,3,300
1186202201078878208,nodds_lab,Network-Oriented Dynamics and Data Science Research Group,0,1,3,0,4,45
3417939718,CxAalto,Complex Systems Research Area @ Aalto University,0,1,3,1,5,43
142654552,thilogross,"Makes complexity simple using nonlinear dynamics, statistical physics, complex networks and data science.",0,1,1,1,3,300
1195173232632041472,EvertronEthan,,0,0,1,0,1,97
292550340,AdvancingPhysio,NHS Physio. PhD complex adaptive systems in rural health and social care. On a mission to revolutionise rehab & transform community services,0,0,1,0,1,300
1361980022,GiovanniIacobs,PhD candidate: #turbulence #complex #networks #nonlinear #timeseries,0,1,0,0,1,180
316533898,galeanojav,"researcher, teacher, scientific traveler",0,1,1,1,3,300
801817963,RolandFeng,"Ph.D. Candidate in Mathematics, Beihang University
Visiting Student in City, University of London
Working on Data Science
Looking for Postdoc Position now",0,2,0,1,3,163
1068486102930112514,BIGSSS_summer,"Research incubator on data-driven modeling of conflicts, migration & social cohesion hosting three CSS summer schools by @BIGSSS_Bremen. Tweets by @jalorenz",0,1,0,0,1,68
522524224,orlayesno,"Better Business Builder | Business Model Design, Innovation, Internationalization | Strategy | 6 Languages | Italy |
Brazil | China | Cultures | Photo",0,0,1,0,1,300
25042736,i_RoBo_,"Political scientist (leading DIPART, digital party research), mother of two, wife, yoga teacher & therapist. @nrw_sog. views=own.",0,0,0,1,1,300
177173603,dpastoresc,"Data, Social and Life Sciences. Collective Intelligence. SDGs, resilience and humanitarian action. Musician. Philosopher. Founder @LifeDLab / @itdupm @EITHealth",1,0,0,0,1,300
108700310,murseltasgin,"Ph.D. , Computer Scientist, @Bogazici_Cmpe, artificial intelligence & machine learning lead, Busy with graphs, algorithms, complex systems.",1,3,4,0,8,292
1008640329891934208,matteo_tiziana,,0,0,2,0,2,34
2814961270,tommasogili,,0,1,0,0,1,108
243174632,tomo_onaga,Tohoku Univ./Assistant professor🎓/FRIS/Ireland🇮🇪/Limerick/Kyoto🌸/rugby🏉/applied mathematician🏝,0,1,0,0,1,300
1179646258769584128,Po_CSS,Welcome to the official account of the President of @CompSysSoc. This page is devoted to dissemination of Complexity Science.,0,0,0,3,3,88
248393312,RushiBhavsar,Renaissance Adolescent. Data and stuff. ex- @wpp fellow,0,0,0,1,1,300
1143983682006523904,laura_didom,mathematician | PhD student in Public Health | infectious disease modeling & complex networks,0,1,0,0,1,10
1007360951170027521,MarekTempe,"Mundus vult decipi, ergo decipiatur.",4,2,0,1,7,300
778694570661949441,ana16_jaramillo,"Complex systems and social network young researcher. Interested in health, education, social disparities and culture. Researcher- Universidad de los Andes",2,2,5,2,11,280
4851173447,hfarruda,Ph.D. in Computer Science and Computational Mathematics at ICMC - University of São Paulo (USP).,0,8,1,2,11,65
845839117338456068,eky102,"Randomness is very difficult to achieve, organization always merges back if you don't pay attention.",0,0,1,0,1,24
2880029134,mrcpangallo,"Economics, complex systems, networks, data science. @JSMF Postdoctoral Fellow @SantAnnaPisa, Institute of Economics & @EMbeDS_SantAnna",0,0,5,1,6,300
311396644,LucaLuceri,"PhD Researcher in Computational Social Science, Data Mining, Deep Learning",2,0,0,0,2,62
821374031693774848,aminkaveh17,"@uuinfolab, Uppsala University

#NetworkScienceFlashcards 
#correctMe 
#uncertainGraphs 
#dataMining",0,0,0,1,1,27
3197753533,DanielJ_Case,"Complex Systems | Physics | Econ | AI, Ph.D. from @NorthwesternU, Marketing Strategy @carsdotcom #cooking #food",0,0,1,0,1,26
2542515740,vkreso,time myopic,0,0,0,2,2,248
111204600,mansumansu,Do the right thing 똑바로 해라,1,0,0,1,2,300
221980399,PabMedi,,1,4,2,3,10,90
796901845608304640,TaharMouloud1,Student,2,1,0,0,3,300
947834276959215618,irinimalliaraki,"Born half beast half goddess & will die as a machine/ new AI projects @turinginst / complexity, natureculture, sustainability, HCI 🇪🇺",0,0,1,0,1,300
2786173214,SannaOjanpera,Researching #futureofwork #digitaleconomy #gigeconomy #globaldev #ICT4D at @oiioxford @UniofOxford and @turinginst. Views and musings are my own.,0,0,1,1,2,300
3254426133,murilo_loureiro,,0,0,0,1,1,300
2242851314,MichaelUftring,"Software Engineer + Data Scientist, with research interests In Network Science & Complex Systems",0,0,0,1,1,300
3077144869,PreethiLahoti,"PhD candidate @ Max Planck Institute |
@AaltoUniversity Alumni |
Ex-intern @GoogleAI
Ex-@Microsoft",1,0,0,0,1,261
1210441254,rmarculescu,,2,0,0,0,2,300
856593179419828230,femquant,"Network of researchers interested in feminist, quantitative social science. Run by @Rose_E_Cook, @JenChanf, @HeiniVaisanen & @sararosetaylor #FemQuantSeminar",1,0,0,0,1,300
3406403592,claytonsbingham,Neuromodulation Center @CWRU @CaseEngineer ; formerly @USCViterbi ; @ARCSFoundation scholar ; #engineering #neuroscience #technology,0,0,0,1,1,300
1140266580187734016,irenemalvestio1,,1,1,0,0,2,110
601184431,mikaelseppala,👨‍💼Specialist @Sitrafund #SitraLab https://t.co/AoB4rujqWf | ⚡️@sys_innovation #SystemsChange | 🔥 #SystemsThinking #Complexity #SystemicRisks,0,0,2,0,2,300
81618211,atifadam1,"systems researcher focused on intersection of chronic disease, aging and technology",0,0,1,0,1,300
201176097,freddurao,,1,0,0,0,1,300
18873795,Jelel_Ezzine,"Contributing to the glocal Collective Dynamics, enacting the Butterfly Effect, and seeking to facilitate the emergence of Collective Consciousness!",0,0,1,0,1,300
97776556,amberjudge,"Instructional designer, edtech consultant, yoga instructor, writer, human, geek obsessed with designing for results, wellness & sustainability.",1,0,0,0,1,300
1060400438,wariobrega,Postdoctoral bioinformatician @gtesta72 lab. Molecular Biologist turned network geek. Romanista in Milan. Views are my own.,0,1,0,0,1,300
394771556,ProfYde,Investigadora del uso de las TIC y las Redes Sociales en la educación y la sociedad // Use of ICT and Social Networks in education and society´s researcher,0,0,1,0,1,300
467804590,squazzoni,"Professor of Sociology at the University of Milan, Head of the BEHAVE lab, Editor of JASSS-The Journal of Artificial Societies and Social Simulation",0,0,1,0,1,300
1058554245513797632,vakratundd,2021 💯,1,0,0,0,1,300
19214480,adaboost,,0,3,3,0,6,147
1156794480,JaredKWA,"Uni of Exeter graduate, former RA for @SensoryEcology & now a PhD researcher studying the social transmission of disease in dogs",1,0,0,0,1,119
1975097718,edeutschma,"Sociologist (network analysis, transnational mobility, regional integration, power laws, etc). Senior lecturer @uniGoettingen, formerly Oxford, BIGSSS & EUI",1,0,0,0,1,300
2537862908,babyproudlee,"Ph.D.，Associate Prof. 
Reseaech interests：Multiplex networks, Online public opinion，Complexity  of the stock market，Energy and envirionment economics",1,4,1,3,9,300
246784429,ani_thapa,"Data Innovation, RBM for Development & nature conservation buff with @UNDPNigeria. Previously w/ @UNDP_Sudan. Views are my own. Retweets ≠ endorsements.",0,0,1,0,1,300
43363760,HundredthIdiot,"Interested in software, complex systems, philosophy and interesting people. Handle is an ode to randomness. Actual idiot.",0,0,1,0,1,300
184817460,BioComplexLab,"Bio-Inspired Computing, Complex Networks, and Human Dynamics Laboratory. At the University of Exeter, UK",1,2,0,1,4,181
96154851,weiluo0001,"Research Associate @ Computational Health Informatics Program @Bos_CHIP and Harvard Medical School || GIS, Visual Analytics, Social Network, Epidemiology.",1,0,0,0,1,286
29948932,SanazFA,"Senior Lecturer in Human Computer Interaction, University of Brighton, Author, Co-founder of IWECA, Music.iLuv, Advocate for Women in STEM #HCI #AI #UX #ML Bio:",1,0,0,0,1,300
1073350225199288321,howisthewater,"I study complex systems theory. Build data sets to identify information asymmetries in opaque markets, and try to identify hidden opportunities within them.",0,0,1,0,1,300
3926021301,SrourAli0,"Senior Data Scientist, Technology Strategist, and #AI Consultant.
Co-Founder of #DataAurora 
Focus: #BigData #innovation #IOT #MachineLearning #ddj",1,0,0,0,1,300
864490904979210240,RezaSadeghiWSU,"Research Trainee at Division of Sleep and Circadian Disorders, Brigham and Women's Hospital, Harvard Medical School #TimeSeries #decisionSupport #sleep #AI",1,1,0,0,2,150
1016648067062353920,CampedelliGian,"PhD - Criminology @unicatt - *On the job market* // Terrorism, Organized Crime, Computational Criminology. I believe in Pink Floyd, James Ellroy and FC Inter.",0,4,0,0,4,277
2180630366,Agostin01,"Student @UniTO,
Physics of complex systems",0,0,1,0,1,28
989097257986293760,stinomat,"PhD student, URV",1,3,1,0,5,234
42653015,igeolise,"Making maps searchable by minutes, not miles. Location-based site search & analytics API.",1,0,0,0,1,300
346695250,nickyzachariou,"Mathematician by training. Tweets are ""nicely written and contain many statements that one can hardly disagree with."" Now @MoJGovUK + @databeersldn. Ex @gdsteam",0,0,0,2,2,295
1016365058954276867,WiMLDS_Milan,Women in Machine Learning & Data Science | Milan Chapter @wimlds 🇮🇹🇪🇺@claudiavolpetti,1,0,0,0,1,300
790908517,pklampros,"PhD Researcher @BartlettArchUCL https://t.co/4A3dFJITBC https://t.co/hpczB8t0na
depthmapX contributor @ https://t.co/hRRSDw4fAJ",0,0,0,1,1,300
16597102,dgzara,Ph.D candidate at @NorthwesternU @SonicNU. Adjunct Assistant Professor at @fcomuc,2,0,0,0,2,300
217178340,pareyesv,Researcher at Barcelona Supercomputing Center @BSC_CNS,1,0,0,0,1,134
193755075,abagavat,Assistant Professor at Oklahoma State University... Alumni of UNC Charlotte...,2,0,0,0,2,19
466600034,tamasdb,evolution of social behaviour; network architecture and regulation; matriocracy; institutions regulating inequality; sharing,6,0,0,0,6,300
3929637676,RKalcik,"Economist interested in Machine Learning and Open data | currently at 
@AITtomorrow2day Innovation Systems",1,0,0,0,1,300
709064775918084097,WSSC_UPF,Web Science and Social Computing Research Group @UPFBarcelona  Led by: @ChaToX,1,0,0,0,1,300
1068834048020230146,sofiadokuka,Research in computational social science and network analysis.,5,0,0,1,6,91
718078489627328512,_jimduggan,"Interests: Computer Science, Modelling (System Dynamics) and Informatics. Lecturer & Researcher @csnuigalway @RyanInstitute @DSIatNUIG. All opinions personal.",0,0,0,1,1,300
1057966638748876800,obrienj_,PhD Student in Complex Networks,1,0,0,1,2,44
17403137,yohm13,"A researcher. complex systems, network science, computational social science, game theory. developing OACIS.
洗濯機でインクを塗りたくるアフロタコボーイ",2,0,1,1,4,300
2249735748,TakaakiAokiTwit,,0,3,1,1,5,158
901142962758758400,socph,statistical physics and complex systems; assistant professor at the catholic university of korea,5,1,6,4,16,300
181381724,sof14g1l,"PhD student at DiCoDe Lab, MPIDR | Computational Social Science | MPIDR-PHDS core representative | Computer and Actuarial Scientist",2,1,0,0,3,300
4272310881,saminrf,Data-hungry researcher working on computational social science and networks @MPIDRnews previously @callaghannz @MBIEgovtnz @AucklandUni (Retweet→Endorse)⇔(¬p∧p),1,0,0,1,2,225
1033712059,ASorichetta,"Associate Professor @WorldPopProject, @geogsouthampton. Interested in spatial demography, migration, urbanization, epidemiology, and groundwater.",1,0,0,0,1,300
768708411940757504,grow_andre,"Researcher, Max Planck Institute for Demographic Research. Family Sociology, Social Stratification, Agent-Based Computational Modelling, Digital Demography.",2,0,0,2,4,300
775386526024765441,SarahFMuldoon,"Associate Professor, University at Buffalo, SUNY; Mathematics Department, Computational and Data-Enabled Science and Engineering Program, Neuroscience Program",0,0,1,0,1,33
961593099427426304,ZhengMuhua,"Postdoc researcher at the Universitat de Barcelona, supported by J. S. McDonnell fellowship. Complex Networks, Complex system, Spreading dynamics",1,1,0,0,2,17
826867992893997056,Minoo_ASTY,"Junior bioinformatician, Heidelberg University",0,1,0,0,1,47
1042967001185050624,SummerHosea,"Professor at Dalian University of Technology, China, working on complex social systems. formerly Fulbright Visiting Scholar at MIT, 2018-19",3,4,0,0,7,163
2240131645,gabriel_ramosf,"Animal behavior, complex systems and social network analysis. Tweeting in Spanish and mostly on local matters at @ulaluyo",5,0,7,0,12,300
741052621,__Sarawalk__,,1,0,2,0,3,300
1875700062,antonionialb,Game theorist of complex systems.,0,0,3,0,3,224
22650867,leohalepli,,0,0,1,0,1,98
833533273754136576,nos_supero,"Peripatetic, Bildung docent, and American Stoic. Using multidisciplinary thinking to survive and win in life.",0,0,2,1,3,300
1070199104,sebastianofil,,0,0,1,0,1,300
345288810,LucchiniLorenzo,,0,0,0,1,1,98
2595937920,EGunibo,physicist of complex systems mixing up biostatistics and bioinformatics in python,0,0,1,0,1,0
8517882,srenan,Wrote: https://t.co/NP2owgZqSP. Founded Pacific Film Archive. Writing IN ALL WAYS ENTANGLED.,1,0,0,1,2,300
1027484745620496384,DAFINET_ERC,An ERC funded project developing a network theory of attitudes. Project now live!,0,0,0,1,1,52
381937821,albsantosdel,,0,1,0,2,3,300
1007543629139898370,6real2,Network biologist / Art activist,1,2,1,0,4,300
795023484174745601,AlejTejedor,"Assistant Professor at Sorbonne University Abu Dhabi.  Interested in River Deltas, Landscape Evolution, Networks,...",0,3,1,2,6,249
3300214874,vagelispapalex,"Computer Scientist working on #datascience #machinelearning #tensors Assistant Professor @UCR_CSE, PhD @ScSatCMU,summer internships @MSFTResearch and @Google",0,0,0,1,1,300
787027490984177664,Bottlenecked_Y,"many are called, but few are chosen",1,0,0,0,1,300
17154442,lucaverginer,"Postdoctoral Researcher at ETH Zürich, researching economic networks through temporal network analysis.",1,0,0,0,1,80
53913642,T_Zano,"R&D Engineer, Data Nerd & a hobbyist Maker. Interested in: #AI #DataScience & #SocialSciences",0,0,1,0,1,300
718799493160964096,eestradalab,,1,1,1,3,6,300
46383062,voxmjw,"Search engineer at @cookpad_dev. Applied ML, data eng, & software. Lapsed academic. Previously at @AdargaAI, @CardiffUni, @UniBirmingham, @UCL, & @UniOfExeter.",0,0,0,1,1,300
973171937089347584,OxfordEconNet,,1,0,1,1,3,74
2191957628,SamirSuweis,"Statistical Physicist, Environmental Engineer, Complex Scientist, but above all - curios truth seeker.",3,0,4,1,8,300
17212489,kotzino,,0,0,0,1,1,300
3418589806,NiallGlynn,"economist | politics | research interests in networks & platforms | electronic music | a lot of rambling on.

Views my own r'kid.",1,0,0,0,1,300
1009818953613479936,CssItaly,,0,0,1,0,1,40
320308247,DrYannMoalic,,0,1,2,4,7,300
1008417952742428672,NetworkAutomata,"Theoretical #Engineer and #Computational Innovator in #physics of #complex #systems, #network science and machine #intelligence. Group Leader @BIOTEC_TUD",0,1,2,1,4,236
3021635212,CSHVienna,The objective of the Hub is to link and inspire complex systems scientists & make sense of Big Data in ways that are directly valuable for science and society.,0,0,3,0,3,300
889557107091156993,sarahdr,"PhD student at Aalto university, complex systems, computational social science",1,0,1,1,3,77
271370637,SaharnazDi,"PhD candidate @SnT Luxemburg. :)
Working on Network Science, Machine Learning, Privacy.",0,0,0,2,2,82
878556807253250049,anupamaa12,Data Scientist | PhD Scholar @IIITDelhi | Food Lover | My travel and food photos:  https://t.co/XKWYA8DUnC,1,0,0,0,1,40
1441673010,mad_astronaut,"mad astronaut, vision research scientist, teaching machines to see the invisible @Wikimedia",1,0,0,0,1,300
305960097,shobeirf,"Machine Learning Scientist @Amazon | PhD @UMDCS | Previously @MSFTResearch, @YahooResearch, @USC_ISI, @UCSC | #MachineLearning #GraphMining #DeepLearning #AI",0,0,0,1,1,300
2963878756,AnaM_Triana,"PhD student at @AaltoUniversity #networks+#brain+#humanbehavior. I don't know, but I'll find out. Tweets in Spanish and English",1,1,2,0,4,300
2689718952,vvinciotti,"Statistician @Bruneluni, interested in biostatistics and network science.",0,0,0,3,3,169
2438886458,francisco_upm,"Research Affiliate at MIT. Interested in physics of complex systems, structures and math",1,0,3,0,4,300
92319345,benzevenbergen,"Research scientist @GoogleAI in California - Previously @PrincetonCITP, @OiiOxford, @Europarl_EN",1,0,0,0,1,300
20502835,richfry,"Dr of GIS. Senior Lecturer, environment and health @SwanseaMedicine @HDR_UK & SIP lead @ADR_Wales . Interested in all things Geo and Data. Views are my own etc.",1,0,0,0,1,300
804669595474919424,idsai_uom,"Gateway to the University of Manchester's data science & artificial intelligence activity.
Sign-up to our network: https://t.co/Oi8mctxg9O",1,0,0,0,1,300
114563183,alenyshkaxx,"Data Scientist in Computational Social Science, Science of Science @gesis_org & PHD candidate @ U. of Koblenz-Landau",1,0,0,1,2,202
112397219,Mridul_Seth,,0,0,0,1,1,237
2438508702,CGraciaLazaro,"Flags suck. Interested in applying physics methods to biology and social sciences. Post-Doc at BIFI, University of Zaragoza. Life is outdoors.",0,2,1,0,3,300
101759189,DriesDaems,"Postdoc with Sagalassos Project at KU Leuven)
Interests: Social complexity | Polis formation | ABM | Digital Archaeology | Pottery",1,1,2,1,5,300
88167514,Katie__Bentley,"Cellular Adaptive Behaviour Lab Group Leader - The Francis Crick Institute, KCL & BU - Simulations and experiments in vascular biology and other complex systems",0,0,1,0,1,93
192679212,sjmgarnier,Paid to watch ants & play with robots (https://t.co/TPTC2KgM1x). Love a clean graph (https://t.co/BrUFmgAztl). And photography too (https://t.co/6hG8yDDVDC)!,1,0,0,0,1,300
2932027868,NetworkTremieu,PhD student in Complex networks,1,4,2,1,8,203
978262864078299137,t_radicio,PhD student in Data Science at the @scuolanormale in #Pisa interested in #socialnetworks analysis and computational social science,2,0,0,0,2,95
966413871857598464,evolvingfutures,Our mission is to help change practitioners learn the science of cultural evolution as they improve the health and resilience of their communities.,1,0,1,0,2,300
934449271,PaoloDeLosRios,Professor of Statistical and Biological Physics @ EPFL.  My opinions do not reflect any official EPFL position.,0,0,1,0,1,300
770012574494625792,dorottya_hoor,PhD Candidate in Sociology @PhDSoSS and @MitchellSNA at @OfficialUoM working on the personal networks of skilled Hungarian return migrants using SNA and QCA.,1,0,0,3,4,300
3302454318,saurabhnagrecha,ML Lead at Capital One | PhD from @iCeNSA Lab | Fighting fraud and money laundering with ML and network science,0,0,0,1,1,64
47580492,Yquetzal,"Complex systems, Complex networks, Dynamic Networks and Social Networks, among other things...",2,3,0,1,6,172
38177323,kidzik,"Deep learning, biomechanics, education and time series analysis - Researcher @ Stanford |  Co-founder @ Saliency",0,0,0,1,1,300
890101932798423041,kristamenglish,Using network science to facilitate #KT pathways for #evidence in #healthsystems | MBA PhD | Traveller | Transplanted Nflder,0,0,0,1,1,160
1199200680,GuiFdeArruda,Researcher,0,10,1,1,12,236
875758270895599616,NthIterationLab,Computational Personalization Lab at @jadatascience lead by @mauritskate #health #datascience #bandits #sequential #learning #causalinference,1,0,0,0,1,300
271936990,PaddyCallus,"Ingeniero industrial convertido en developer, estudiando matemática aplicada. Leo y anoto. Levantador de pesas livianitas. ❤️Java❤️Python❤️Linux❤️Vim❤️",0,0,1,0,1,300
2869874233,mowafakallaham,,8,0,0,2,10,300
921747627053584387,digitalbizumzl1,Cuenta del semillero de investigación en Negocios Digitales de la U de Manizales- digitalbiz research group account -,1,0,0,0,1,300
894164731795197957,JFutoma,Postdoc w/ Finale Doshi-Velez working in the intersection of ML & health. Starting with Apple Health AI in May 2020. He/him.,0,0,1,0,1,300
233514057,danieledaler,"Research Assistant // Computer Scientist // Aalto(Finland) & DTU(Denmark) //  Data, Networks, Privacy",1,2,0,0,3,133
41841330,orgnet,#SocialNetworkAnalysis Services/Training for Organizations & their Consultants. #OrganizationalNetworkAnalysis #NetworkScience #TransmissionNetworkAnalysis,0,0,0,1,1,300
753922707939532804,UnMondoCane,,2,0,0,1,3,298
879291704754491392,euro_css,"Our series of three Symposia on Societal Challenges in Computational Social Science is over. Thanks to everyone who contributed, participated, helped!",2,0,0,0,2,213
2740338871,Bos_CHIP,Boston Children's Hospital Computational Health Informatics Program | Harvard Medical School https://t.co/b9gCRfSn29,1,0,0,0,1,300
1436964224,HosseinNoorazar,,1,0,0,0,1,39
253480647,emanuelemassaro,I am trying to understand complex phenomena trough data analysis and numerical simulations @EPFL and @WorldBank,1,0,0,0,1,244
1008442225,DemianBattaglia,"computational neuroscientist, father, european citizen, curious",0,2,1,0,3,300
3131557785,SimonyanLab,Kristina Simonyan | Dystonia | Spasmodic Dysphonia | Speech Production | Central Motor Control | Neuroimaging | Genetics,0,0,0,1,1,300
392695595,kimisperros,"Lead Machine Learning Scientist at HEALTH[at]SCALE; Ph.D.; Formerly: @GeorgiaTech @GTCSE, @MSFTResearchCam",0,0,0,1,1,232
89467037,marianobegue,"Applied mathematician, cyclist, music lover. Research scientist at @spotify.",0,0,1,0,1,300
129155606,Shahroz07,"PhD student at Sungkyunkwan University - Previously @ Stony Brook University - #AnomalyDetection, #DeepFakeDetection, #TimeseriesForecasting",0,0,0,1,1,300
1569650100,NachoToledoR,Electronics Engineer getting a PhD in Social Complexity 🙃. Penquista en el exilio. El humano detrás de @RataScience.,0,0,1,0,1,300
107468161,kleber_a_o,"Ph.D. Student of Applied Mathematics at @MACSImaths University of Limerick.
Social network dynamics and information diffusion.",1,0,2,0,3,300
2595260136,ljnbrent,Social networks and the evolution of social relationships. Senior Lecturer in Animal Behaviour.,5,0,0,0,5,300
1668630349,MontufarEric,"Network Science enthusiast 🕸️
MSc. Student",1,0,0,1,2,215
836406681437286400,verethragna__,#WorkIsWorship,0,1,0,0,1,300
31185845,barbarabulc,Founder GD Impact. SDG CoLab. Art4Action. Co-designing a new collaborative economy to solve urgent social+environmental systems challenges.,0,0,1,0,1,300
309424720,Teo_Correia,Senior Managing Director Global Consumer Industries @Accenture,1,0,0,0,1,300
435868764,ElsaArcaute,"Associate Professor @CASAUCL, scaling, networks and percolation in cities and urban systems",0,0,2,4,6,300
910168235261218816,coletti_pietro,"Postdoctoral researcher at Hasselt University. Working on network epidemiology, contact patterns and behavioral changes.",0,0,2,1,3,125
612382284,Iza_Romanowska,"Senior Postdoctoral Researcher at the @BSC_CNS Complex systems simulation, computational social science and digital humanities (archaeology) #abm #python",0,0,1,0,1,300
1808171,nicolabruno,Journalist @effecinque Co-founder @dataninjait Currently working on @factcheckers_it Former @risj_oxford,1,0,0,0,1,300
106483037,jcorrean,Interdisciplinary Scientist.,0,0,2,1,3,300
905832768009011203,0ttamatt,PhD Player @ SNS,0,0,1,0,1,150
1363657555,AlineCosette,,0,0,1,0,1,300
745468122,GTheraulaz,"collective behavior, collective and swarm intelligence, complex systems, quantitative ethology, computational biology",0,0,1,0,1,300
15255349,themiurgo,"Senior Data Scientist at Vodafone UK. Previously @NESTA_UK, @uobcompsci, @MIT, @Telefonica. Proud Sicilian, ex violinist, music lover, espresso addict.",0,1,0,0,1,300
781605720,djherreram,"Profesor en @uleadcr
""En mi país no hay ley de acceso a la información"". Espero algún día eliminar estas palabras de aquí.
@BDMAMASTER  🇨🇷🇲🇽",1,0,0,0,1,300
895276877350404097,snresearch_org,"Social Networks Research SRL-D is a Romanian startup with a global strategy to help governments, businesses and non-profits leverage social networks for success",1,0,0,0,1,6
4503332541,iuinfograd,"News, events, and announcements from the Informatics Graduate Program at IU's School of Informatics, Computing, and Engineering. 
Contact: infograd@indiana.edu",1,0,1,1,3,300
559633081,Dani_Gambit,"Vedo gente, faccio cose - Giornalista freelance @ilmanifesto @Motherboard_IT @DinamoPress - Editor #Datacrazia (@D_Editore)",0,0,1,0,1,300
799974644803629056,PZgrzebnicki,"Scientist, traveler and photographer. Physicist researching human cultures as complex systems. Working with #DigitalHumanities #DH #AI #Anthropology #Science",0,0,1,0,1,0
295175711,ewancolman,Networks. Infectious disease. Ants. Mathematics. Emergence. Brains. Behaviour. Currently researching cow trade at the @roslininstitute.,2,0,0,3,5,300
706441921405820928,encore_network,ENCORE - ENgineering COmplexity REsilence is the EPSRC funded Network+ aimed at exploring complex engineering systems.,2,1,1,3,7,300
1245487578,BootsLab,"Integrative Biology,  UC Berkeley",1,0,0,0,1,184
66708144,abojchevski,PhD candidate @ TU Munich. Robust / Adversarial Machine Learning on Graphs. He/Him.,0,1,0,0,1,300
11914552,parraguezr,"Co-founder and CEO at Dataverz, where we develop new ways to explore and search data https://t.co/A42xH4DDtS",0,0,0,1,1,300
2872545452,javiergb_com,"PhD candidate at University of Amsterdam. Data juggler. Posts about tax issues, data science and complex systems. Co-organizer of @CSSamsterdam",0,0,2,0,2,300
44954346,xandeca,book hoarder / film lover / recovering astrophysicist / comms manager @mpdl / list maker,0,0,0,1,1,300
94082890,ghirardinicola,Data Products at Unipol Group. Teacher and continuos learner. Volunteering at Coderdojo Parma.,1,0,0,0,1,300
3019638591,gianroccolzz,,1,0,0,1,2,264
2168624918,policyinternet,Policy & Internet journal investigates the relationship between the Internet & public policy. Ed. @oiioxford by @HelenMargetts @jonmbright @ViliLe @VickiNashOII,2,0,0,0,2,300
21773404,MariaPereda_,Complex Systems Researcher. Now working as Prof. Ayt. Doctor at Univ. Politécnica de Madrid. ETSII. #GISC #COMSOTEC #ComplexSystems #Experiments #DataAnalysis,2,1,1,1,5,300
3080110381,haoopeng,PhD student @UMSI | social networks | complex systems | science of science,1,0,1,1,3,104
746152190,agodoylorite,Senior Research Fellow at  @CASAUCL @ucl - Networks and Inference,2,4,2,3,11,300
43299863,tobypeterdavies,"Research: complex systems, networks, crime, riots. Not research: Newcastle United, films, cynicism. I hate it when people put 'all views are my own' here.",0,0,1,0,1,300
1599902202,MarlonMasine,"Research Assistant Professor in Informatics, Nanjing University, China.",0,0,1,0,1,163
972998328,CamNetNet,The Cambridge Networks Network on Twitter - We are a forum for researchers interested in network science at the University of Cambridge.,2,3,6,8,19,155
101561169,ProfJenNeville,"Professor, Computer Science & Statistics, Purdue University, Research interests: machine learning, data mining, network science, artificial intelligence.",1,0,0,2,3,300
803944483742248960,Mohsen_Bahrami_,"Postdoctoral Researcher @ MIT Media Lab Connection Science 
Researcher @ Behavioral Analytics & Visualization Lab #datascience #bigdata #behavioral_analytics",0,0,2,0,2,186
249794996,ruta_io,"Imaginator in the world where everyone co-creates naturally. #biomimicry #coexistence

Training https://t.co/eNG1fF1KPl
Poems https://t.co/yp6pWhPS5r
Internet https://t.co/N9bnTlZIoY https://t.co/F3fqjWHqaL",0,0,1,0,1,300
460489687,JMateosGarcia,"Director of Innovation Mapping @nesta_uk. Interested in economics, innovation, artificial intelligence, complexity, philosophy, research methods, python.",1,0,0,0,1,300
865186468377100289,NetHealthMilan,"Migrants, social networks, and health. A @DondenaCentre research project, supported by @Unibocconi and @FondCariplo. By @emanudelfava @melegaro @marcobonetti67",4,0,0,0,4,168
119506508,frasurano,PhD student at PoliTo on complex networks. That sounds interesting.,0,1,0,0,1,300
861538898979295232,bandigsm,Researcher (network science) at BME. A man having much more questions than answers.,1,1,0,2,4,39
1092867511,IsabellaGollini,"Assistant Professor in Statistics at University College Dublin, Ireland",0,1,1,1,3,300
3804729269,danilo_liuzzi,,0,0,1,0,1,300
63734068,interdonatos,"If you're here for my job: researcher [remote sensing, network analysis and mining]. Also: music and comics critic, amateur chef and polemic, former-rock-dj.",0,2,0,0,2,300
277078157,KristinaCurtis,Specialising in: #BehaviouralScience #ChildhoodObesity #mHealth #PublicHealth #UCD,1,0,1,0,2,300
354510217,AijaLeiponen,"Professor of innovation strategy, digital business models, communication standards, data economy. Ithaca/Helsinki. @Cornell @UniversityAalto.",1,0,0,0,1,300
2314631347,kaidozhang,,1,0,0,0,1,26
2843741836,SimPolProject,"#Complexity for #policy #networks #sustainable #finance #impact #engagement. Lead by @FINEXUSCenter Zurich Uni, funded by @EU_H2020 R&I, 
opinions ours only",0,0,1,0,1,300
227270794,MPCifuentes,"https://t.co/imQ9aCSXfX. Data Science and Network Analysis for Modeling Complex Health Advisor, Health Information Systems PAHO/WHO (tweets not official)",0,5,0,2,7,300
727401204213534721,veclab_KEMRI_WT,Virus Epidemiology and Control Group Based at the KEMRI-Wellcome Trust Research Programme,1,0,0,0,1,211
847699856651042816,nokesdj,"Virus transmission in communities to inform on optimal interventions. RSV, rotavirus. Work with brilliant Kenya team",1,0,0,0,1,291
455895128,ferdaofli,Senior Scientist at Qatar Computing Research Institute,1,0,0,0,1,178
572279177,rijitK,"Data management for emerging problems in large networks.
Assistant Professor @ NTU, Singapore. Big-graphs, Big-data, Graph-systems.",1,1,1,0,3,300
308124021,Shun_Liu_,Ph.D. candidate in Department of ECE at University of Macau. #networkscience #nonlinearity  #timeseries  #machinelearning #bigdata #NetworkNeuroscience,0,1,0,1,2,300
98682862,MeaganCFitz,"Asst professor with @UMCVD / Infectious disease modeler / vaccine economist / look friends, #vaccineswork and I try to help them work better. She/her",0,0,0,1,1,300
211787094,zignoai,Researcher @ UniMI - Department of Computer Science,0,1,1,0,2,117
365364269,milan_rapaic,"Associate Prof. @ Computing and Control Dept., Faculty of Tech. Sci., Novi Sad Univ. Modelling, optimization, adaptation & control.",0,0,1,0,1,300
2438382738,HumanEcosystems,creating smart cities and smart communities in cities worldwide by observing their relational ecosystems in real-time,1,0,0,0,1,300
4098440751,AsocialNets,About networks and data,3,5,0,5,13,300
335206756,zeyneper_ugurlu,"Eğitim Yönetimi,  Ankara Ü. , Sinop Ü.  Liderlik,  Sosyal Ağ Analizi (Education Management / Policy, Leadership,  Social Network Analysis),",1,0,0,0,1,300
516984014,LupoGiuseppe92,"""Pyé-koko di i ka vwé lwen, maché ou ké vwé pli lwen""
""The coconut tree says he sees far away, walk and you will see far beyond""
Creole proverb",2,1,1,1,5,300
2420108113,adambbadawy,"Data Scientist/PhD candidate @USC. I work in the intersection of #MachineLearning, #Networks, #StatisticalModeling & #SocialMedia",6,0,0,0,6,300
1395484944,AjaykumarJM,"PhD Urban science, complex system @SUTD",1,0,0,0,1,300
1938981038,Nik_Anesiadis,"Systems theory, data mining, networks and biology",0,1,0,0,1,300
484805313,TweetNTD,"Genomics & immunity | Postdoc at @UChicago w/ @LB_Barreiro, PhD from @UNC bioinformatics/compbio | via @JohnsHopkinsSPH @Swarthmore | quantgen/virology/vaccines",1,0,0,0,1,300
3070163032,netcrime,"Crime, complex systems, city science, criminal networks, network science, data science, crime modeling.",0,1,4,5,10,105
1550943302,velaiola,Network science and complexity. PhD candidate at Aix-Marseille Université.,0,1,0,1,2,67
142995842,tweeting_cris,"Data, algorithms, and impact. Now: Data Science/Machine Learning @NZZ & Steering Committee @mtc_eth. Past: @ETH, @Cambridge_Uni, @CreditSuisse, @IBMResearch",0,0,0,1,1,186
824812182114164736,www17perth,"Official Twitter account for WWW2017Perth - 26th International World Wide Web Conference, 3-7 April 2017",1,0,0,0,1,281
820088165239320576,susanbourbaki,Data driven analysis of societal issues,0,0,0,1,1,49
4675087285,aelwan4,,1,0,0,0,1,40
49458423,tomasaftalion,All things data in Spaceship Earth.,0,0,1,0,1,300
109253611,blengyelb,"Social networks, economic geography, innovation and learning.",3,0,0,4,7,300
566259442,DanFranksRsrch,"Reader at @UniOfYork. Data science, social networks, collective behaviour, sociality, and life-history evolution in animals. #FirstGen academic.",2,0,0,0,2,300
547871798,ingmarweber,"Research Director for Social Computing @QatarComputing. Dad of https://t.co/VyCbCoOfHv. #DigitalDemography, #D4D, #Migration, #Gender. He/his.",1,0,0,2,3,300
783709007626309638,DataBeersWrik,"Interested in data, love beer, and in Warwick? By  @Fede_Botta, @nadiucc, @EdMHill, @SophieMeakin and @EBucksJeff Inspired by @databeers",3,0,0,0,3,181
94603287,SimonThordal,"Sick of quarantine, but has a nice view. He / him.",0,1,0,0,1,97
4023660472,RobLucc,MSc Computer Science | Data Science | Social Network Analysis,1,2,0,1,4,185
1913890034,DarrenPCroft,Professor of Animal Behaviour @UniofExeter. Interested in the Ecology and Evolution of Social Behaviour and Life History Evolution,1,0,0,0,1,300
14308267,Ymax,"tweets on infectious disease, data analysis, biking, and eating - - life's essentials",2,0,1,0,3,300
776354346728652800,LABSS_CNR,"Laboratory of Agent-Based Social Simulation @cnr_istc, working at the intersection among #cognitive, #social and #computational sciences",1,0,1,1,3,300
28534457,i_realize,,0,0,1,0,1,300
483454569,Amir_Ghasemian,"Postdoctoral Research Fellow, @ Department of Statistics, @ Harvard/Temple University",0,3,0,1,4,199
34342475,gerfranc,"Antropólogo
#SNA #ARS #Antropología #datos  PGP:https://t.co/8GgNoomCSH",6,0,0,1,7,300
786831218075664384,GDato_gb,historian,1,0,0,0,1,300
15392115,dgeaston,"Consultant, Author, Social & Business Entrepreneur,-passionate about introducing & practicing Complexity Thinking everywhere ....the possibilities are infinite.",0,0,3,0,3,300
709491584,ArnautzPgvila,"Apprentice modeler of social systems with Python. Occasional tweets on history, economics and language diversity",0,1,0,2,3,300
770207007517339648,wwcs_2017,"Winter Workshop on Complex Systems 2017, Petnica Science Center, Serbia.",0,0,1,0,1,23
262244908,natalieasis,"Mad [data] scientist, engineer, closet artist, Richard Feynman evangelist, chaos theory witness, information worshipper, USyd researcher & founder of 1001Books.",0,0,1,2,3,300
123834795,satyaki30,Ph.D. student at @ND_CSE working in graph mining & network science. Member of Weninger Lab and @CNDS_ND.,0,0,0,1,1,300
369755821,tek_keller,"Computational biologist into ML & deep learning at USF. Ph.D. in evo. biol. at UT Austin. I like #rockclimbing, #cycling & #photography. #rstats #python ☯️",1,0,0,0,1,300
112440496,sofievalk,👩‍🔬 c n g | | | | || https://t.co/ZrwWVLtSYB,2,0,0,0,2,300
772739813548101632,LauCan88,#networkmedicine #multiomics @Biologie_ENS L'Oréal-UNESCO @4womeninscience 2018 ambassadress,0,1,0,0,1,271
765865951363493888,WarwickComplex,Maths for Real-World Systems CDT in the Centre for Complexity Science.,1,0,0,0,1,300
767531422928207872,RSDSymposium,"Join us from October 17-19 for the 8th Relating #SystemsThinking and #Design Symposium (#RSD8), hosted by Institute of Design, Chicago and SDA. https://t.co/xM36H3fTb2",0,0,1,0,1,300
18163032,wareFLO,"Thursday, April 16, 2020 from 1:00 PM to 2:00 PM (EDT): Is Design Thinking Up to Combating Coronavirus? #HXD2020 #UXH2020 Deets at URL👇",1,0,0,0,1,300
4896916113,RawbLaBlog,,1,0,0,0,1,300
4888612253,EventHistory,"Criminology and demography (CUNY Graduate Center/John Jay, Columbia). CUNY Institute for Demographic Research. Fmr. researcher at Yale's @JCollaboratory.",1,0,0,0,1,43
262929981,eddelac,TemporalAssymetry.,1,0,0,0,1,300
3460853716,dokuka_sofia,,1,5,1,1,8,121
2269684160,gen21ka,Junior @swarthmore interested in Network Neuroscience,0,1,2,1,4,300
709379881,GundogduDidem,"Data Enthusiast, self-challenger",0,0,0,1,1,300
18406335,dogvile,"Tweets about Web Development, UX, Data Visualization, Data Science, Infographics, BI(mainly Qlik), Big Data, Science, Complexity, Networks Science",0,0,2,0,2,300
628610967,dataspirin,Data Scientist @SchibstedGroup. PhD Comp. Sci. #GraphsAreEveryWhere #NetworkScience #ComplexNetworks #ML #Recsys  #TrailRunning,0,7,2,2,11,300
752977549454704640,ComplexityPope,"Network scientist. Passionate about data, food and religion.",3,0,1,1,5,90
3671492717,Valeria__Romano,"PhD in Ecology and Animal Behaviour. I am broadly interested in the evolution of social systems, network analysis, epidemiology, and agent-based modelling.",5,1,1,2,9,300
129550400,gi_ona,,1,1,0,1,3,59
3295991605,mattjsilk,"Early career ecologist @UniExeCornwall.  Animal behaviour, social networks, disease ecology, demography and plenty of Cornish wildlife",12,0,1,0,13,300
18855622,carnby,Investigo Movilidad Urbana en @BSC_CNS. Escribo relatos. Extraño a los zorzales. Colecciono postres y peluches. Amo y soy amado.,0,0,1,0,1,300
747708575208837120,ccsSOP2016,"Self-organized patterns on complex networks. A satellite workshop of the 2016 Conference on Complex Systems, 21 September 2016",0,2,0,0,2,24
710165317507530756,mlgworkshop,"16th International Workshop on Mining and Learning with Graphs, co-located with #KDD2020",2,0,0,0,2,158
355626264,aram_galstyan,"Director of the Artificial Intelligence Division, and Research Associate Professor at USC Information Sciences Institute",3,1,1,0,5,260
267808325,mattemanca,Data Scientist@NTENT,1,0,0,0,1,300
61900484,AntonioPenta,"Phd (CS), Research Scientist, addicted to #data #algorithm #coding and #cityOfNapoli",1,0,0,0,1,300
735099051155312640,ddhbp_2016,"Satellite Workshop of Conference on Complex Systems, 20 September 2016 (afternoon session).",1,0,0,0,1,106
104629239,qualitativa,Toolbox for digital ethnographers / Caixa de ferramentas para etnógrafos digitais.,2,0,0,0,2,122
477568557,simonecent,Data Scientist & researcher in the MobS Lab at @fbkcom,4,0,1,1,6,300
232503127,marija_mitrovic,Physicist.,3,0,3,3,9,300
4888893395,CoSIN3_UOC,Complex Systems research @IN3_UOC | Tweets by @BorgeHolthoefer,4,3,1,0,8,300
34897314,nicola_c_foster,Researcher. Health economist. Math models. All things TB and public institutions.,1,0,0,0,1,300
703302245589381120,geotoponets2016,Workshop on Network Geometry and Topology by @mkitsak and @lordgrilo.,0,1,0,0,1,22
704436290347991040,CICWCat,"A catalytic agent doing curation of Collective {Intelligence, Consciousness, Wisdom} #CollectiveIntelligence #GlobalBrain
Curated by: @Bortseb",1,0,0,0,1,300
3190432737,SimoneRighi_MO,,0,1,2,0,3,144
67398756,flaviovdf,,1,0,0,0,1,300
3308228529,jacob_c_fisher,,0,1,0,0,1,216
29552568,yannsecq,Université de Lille,0,0,0,1,1,300
68376272,mkhm,"Physics Graduated, interested in comp. social science, online social media, data science, machine learning. Looking for PhD position in Computer Science.",3,2,0,3,8,300
44446416,fbenevenuto,Associate Professor at the Computer Science Department of the Federal University of Minas Gerais. Researcher on online social networks.,1,0,0,0,1,300
14156905,jessesoininen,Author. Father of 3 sons. On a mission to give social media jedi powers to fellow citizens.,0,0,1,0,1,300
2584575792,UMICHCS,CSCS is a research center and CSAAW is a biweekly workshop @umich that both provide opportunities to collaborate and share ideas in #complexity/ #complexsystems,1,0,1,0,2,300
21305051,sbr28,"Senior bioinformatics scientist, studying giant genomic networks, @ucsdccbb Center for Computational Biology and Bioinformatics",0,0,2,0,2,300
3472336217,LivingNethos,Social platform for knowledge discovery that integrates online tools and insights creation in a network-oriented and collaborative way.,1,0,0,0,1,298
3900784053,WWCS_2016,"Winter Workshop on Complex Systems 2016, Carlos III University of Madrid.",0,3,3,0,6,256
21279340,PamMktgNut,CEO @MktgNutz Keynote #Speaker #Digital Storyteller Strategist 🧡 God Family Beach & #Tech! #Forbes Top 5 #SocialMedia #Influencer https://t.co/a2PrsAXywL,1,0,0,0,1,300
21774074,haewoon,Computational social science / Lifetime citations 13k+ / https://t.co/gjuaPAdtnW,1,0,1,1,3,300
3610142835,databeersldn,"Interested in data, love beer + in London? By @nickyzachariou @a_baronca @expertpol @net_science @lajello @vicmrh @gmiritello Inspired by @databeers",1,0,0,0,1,300
601687797,hclarosh,"A peruvian sociologist trying to be wiser, not just knowledgeable, step by step. #LooongRoad  Also a grad. student in Applied Statistics. I like #Rstats",1,0,0,1,2,300
351555467,enricopalumbo91,"Research scientist at #AmazonAlexa. Natural Language Understanding, Semantics, Recommender Systems.",0,0,0,1,1,166
83840361,Biomarino,"Researcher at Pamplona University (Colombia), interested in Complex Systems Study. Columnist at Diario La Opinion https://t.co/qptSgWh0kM….",0,0,2,0,2,300
299545863,AndreaPossenti,Theoretical Physicist. PhD candidate @Cambridge_Uni on protein misfolding diseases. Data Science consultant @ Wren Therapeutics & Complex Systems enthusiast,1,0,0,0,1,105
14908972,prabprab,scientist at heart | insatiably curious | working @eu_commission/dg connect | all opinions mine only,1,0,0,0,1,300
11892372,fabreetseo,"Computer Scientist, Search and Big Data Geek.",2,0,0,0,2,300
2492740016,Comsotec,Asociación para el estudio de los sistemas complejos sociotecnológicos COMSOTEC (Sociotechnical Complex Systems Association),1,3,2,0,6,300
19629739,MichaelWunder,"CS grad student interested in building better economic and social models using learning, evolution, complex systems, and levels of reasoning.",0,0,2,0,2,55
2806307411,Jp_Chevrot,,1,0,0,0,1,55
166445385,fmacielcardoso,PhD candidate at  the University of Zaragoza. Complex Systems. Human behavior.,2,1,2,1,6,300
19058451,nakafi,"PhD Candidate, Research area: Knowledge Management in Next Generation Social Networks, enjoy teaching, love reading",1,0,0,0,1,300
82577951,silviabarbero,associate professor #Design at @PoliTonews - scientific coordinator of #Retrace project @interregeurope - chair of Systemic Design Association #systemicdesign,0,0,1,0,1,300
54817041,nicola_barbieri,"Data scientist, “graduated” from Yahoo labs. Designing and developing search&discovery and targeted advertising products at scale.",5,0,1,0,6,300
288389432,patrikja,"Computer scientist, Haskell hacker, catalyst of research ideas, likes to connect the big picture with formal details, software & language technology advocate",0,0,1,0,1,300
1335668024,OPatterson4,Scientist. Math epidemiologist. Healthcare consultant,0,0,1,0,1,188
16795018,twbriggs,I-O Psychologist #SIOP #IOpsych; #ComputationalSocialScience PhD Candidate @CSS_GMU; alum @UMBC @NORCNews @ASTHO #publichealth #healthpolicy #preparedness,1,0,1,0,2,300
3353136183,trovdimi,"PostDoc at @gesis_org - Leibniz Institute for the Social Sciences. Interested in network science, user modeling and machine learning.",2,0,1,2,5,300
461408456,trebsirk,science + making fun of shit,1,0,0,0,1,300
3168092856,nus_sling,"Infectious diseases, epidemiology and social networks at Saw Swee Hock School of Public Health, National University of Singapore",1,0,0,0,1,300
40542861,istvanzkiss,"Professor of Applied Mathematics Researching Networks, Stochastic Process on Networks",0,0,0,1,1,300
98764925,Bortseb,Curious-Cartographer @OpenLearningCC @RSFrame @metamapps ♓#FutureOfWork #P2P #CollectiveIntelligence #Commoning #SpaceshipEarth ❤️ Linklogs: @MetaCAug @CICWcat,1,0,0,0,1,300
582772973,MobiSocCU,"@csicardiff researchers interested in mobile + bio-social computing, human dynamics, places, mobility, meaning, human behaviour interaction and more",4,0,0,0,4,124
256677843,OpenBeacon,,2,0,0,0,2,16
34653414,CT_Coughlin,"Senior Editor at Springer Nature; interests: (continental) philosophy, religious studies, publishing, films, sports; opinions are my own.",0,0,1,0,1,300
3313245897,FinnertyAilbhe,"Currently working as a Research Associate on the @HBCProject. Interested in Behaviour Change, Social Networks, Computational Social Science and Personality.",2,0,0,0,2,300
2337002455,di_stefano_ale,,1,0,0,0,1,27
3222686964,SocialNetNeuro,Social Networks in Neurology Lab @HarvardMed.  Exploring the relationship between networks and stroke recovery.   Retweets and follows do not imply endorsement.,12,0,0,1,13,300
2494238046,jasmineteabreak,"Linguist by training, tea binge drinker and data driven enthusiast. Who's afraid of #TextMining?",0,0,1,0,1,133
203691503,Pedroralofernan,l0,1,0,0,0,1,225
3308159633,m_tambuscio,"PhD Student at University of Turin, Complex Networks and Information Diffusion Processes",0,1,0,0,1,42
1708122348,Ouroboroski,,1,1,3,0,5,300
607311335,socdatalab,@ESRC Data Investment & part of #BigData Network. Studying Social Media & Society. Developer of COSMOS software. Led by @mattlwilliams @pbfeed @drlukesloan,2,0,0,0,2,300
31705889,TjibbeD,Infectious Diseases Modeller at University Hospital Freiburg | Antibiotic resistance | Hospital-acquired pathogens | Patient referral networks,0,0,0,1,1,300
302604042,nudro,Sr. Data Scientist @boozallen #runner #deeplearning PhD student @UMBC | consider contributing https://t.co/wIxec9yXWF | Opinions are my own,2,0,0,0,2,300
72509746,papaanteporta,building a portfolio of network science companies,1,0,0,3,4,127
87105950,SOLENAI,"About GIS, Technology, Epidemiology, Influenza and Geography.",0,1,0,1,2,300
3088807367,CAMLaPorta,,0,0,3,1,4,300
2785880513,BJayles,"Post-doctoral fellow, interested in collective intelligence in its many aspects",1,0,1,0,2,101
1347088410,franzViz,"Statistician. Addicted to data. If it doesn't work, hack it! #rstats #python #tableau @musement",1,0,0,0,1,300
2425558261,alok13sama,"I am intreasted in Complex Network, Spectral Graph Theory",1,4,2,1,8,298
314217400,RobbieAMcDonald,"Wildlife biologist and ecologist. Professor at Environment and Sustainability Institute, University of Exeter Cornwall campus. Trustee of @vincentwildlife",1,1,0,0,2,300
3086535891,DeCIDe_ERC,"Demographic change and infectious diseases in developing countries. A @unibocconi research project funded by @ERC_Research, PI @melegaro",0,0,1,0,1,193
16925097,gvrkiran,Postdoc at MIT. All tweets are my personal opinion,1,0,1,0,2,300
3088703037,SZapperi,"Statistical Materials Modelling, Complex systems. In Germany for Humboldt Research Award.",0,0,1,0,1,300
242362786,vsevolodNS,,0,0,1,0,1,62
2787747192,MassEvac,"Ongoing research to establish evacuation friendliness of world cities using @OpenStreetMap, #OpenData, #ABM & #Python.",0,0,1,0,1,121
3042264274,scamelsML,,0,0,0,1,1,2
29658006,xingustc,"Researcher in Microsoft Research Asia, working on spatial data mining, location based services, ubiquitous computing. Welcome to UbiComp 2011!(www.ubicomp.org)",1,0,0,0,1,94
3031539254,GBCI_ASU,Transdisciplinary science– seeking solutions for a complex world.,0,0,3,2,5,223
982500170,paulMcRacca,"Physicist, PhD in Economics. However, a simple person. RT's are not endorsements.",1,0,0,0,1,300
3030618307,tongtonghappy19,PhD，complex network，big data,0,1,0,0,1,97
2914186151,netscibackstage,"Everything you always wanted to know about network science but were afraid to ask. By @robysinatra @lordgrilo @mszll @gmiritello, Paul Expert & Claudia Sinatra",0,0,2,20,22,256
2374758734,rosalyn_lin,what do you mean pancakes aren't in their own food group,3,0,0,0,3,29
2981463028,PeerJCompSci,The Computer Science Journal from PeerJ,2,0,0,0,2,300
2895240598,innarliiv,"Associate Professor @TallinnTech Research Associate @OxfordCTGA E-Government, Data Science, InfoVis, Organizational Network Science,  Comp. Social Science.",3,0,0,0,3,300
2983871745,ComplejiMad,,1,0,3,0,4,300
2969917924,Anna_Sapienza,,1,0,0,0,1,4
391991603,PolColomer,Physicist. Co-founder & Data scientist at @dribiacom. PhD on complex networks at Universitat de Barcelona. Also involved in @beepath_org educational project,0,2,0,1,3,300
302690611,VasantDhar,"#PredictiveAnalytics, #Prediction,#finance,#digitalmarketing,#TradingStrategies,#socialmedia.#datamining,#machinelearning,#bigdata",0,0,1,0,1,300
529730279,matjazperc,"Professor of #physics, #MTB fanatic, love #hiking, dabbling in #SUP.",0,0,1,0,1,55
1157307985,kfarrahi,"Asst. Prof @ Uni. Southampton,  Interested in machine learning for health and digital epidemics",0,0,1,0,1,300
123572484,marialisascata,"An always running mother, wife and scientist. Coffee and books addicted. Telecommunication Engineer, Ph.D, Postdoc Researcher@UNICT",2,3,0,0,5,300
282414384,KoAwatea_cmdhb,Ko Awatea is the Centre of Health System Improvement and Innovation for the Counties Manukau District Health Board (CMDHB).,0,0,2,0,2,300
536950939,BiztechStrategy,Developer / Analyst,0,0,0,1,1,177
838509024,HywelTPWilliams,Scientist. Social / environmental data analysis and complex systems.,2,1,1,0,4,100
110610138,Ale_xsandra,Head of Analytics Research at NOKIA Bell Labs,0,0,0,1,1,300
2851033972,amandawoodr,Researcher at Stockholm Resilience Centre interested in healthy and sustainable food systems. Working to bridge research and policy action.,0,0,1,0,1,300
1637696580,PremSankarC,"Research Scholar@ DFS , Kerala University,  Computational Social Scientist ,Social Network Analyst on Collective Action , Technologist  Futurist",9,6,1,0,16,300
2359841862,aagakanmu,,0,0,0,1,1,25
377401482,ArnaudDyevre,"PhD student in Econ @LSEEcon. I tweet about innovation, public econ and networks. 
Love @NHSuk and all the heroic health professional around the world 💙",1,0,0,0,1,300
12219882,hekman,"Love reading scifi, making hot sauce and studying /(media|tech|culture)/g",1,0,0,0,1,300
570639833,GISerXi,PhD of Geography and Social Data Analytics; Alumni of Friendly Cities Lab and Penn State.,1,1,0,2,4,272
1362984396,DinoPedreschi,Professor at University of Pisa. Big Data Analytics & Social Mining. Human Mobility & Social Networks. Privacy & Ethical Data Mining. http://t.co/qDeYCce2Zu,1,0,0,0,1,300
471996981,jonmbright,"Senior Research Fellow @oiioxford, interested in digital politics, electronic government and data science. Editor of @policyinternet.",0,1,0,0,1,300
2829695868,Abovecc,We are a team of data scientists working together to make tracking your competiton easy.,2,0,0,0,2,115
2785775039,CeciliaPanigut,,1,0,0,0,1,80
845408275,topdrim,Topology driven methods for complex systems,0,3,4,0,7,240
54855283,pierrep67,"Brings security and complex systems science to the factory of the future. SCRUM and Lean practitioner. Researcher, developper, teacher, trainer. Theremin fan.",0,0,2,0,2,300
493260415,polymathsglobal,Transdisciplinary Science - Accelerating Scientific Discovery,0,1,1,0,2,300
2813974014,pin_lab,"People Information and Networks Laboratory. Network Science, Social Networks.",1,0,2,0,3,51
1362794760,AmyGreerKalisz,"CRC @OntVetCollege, @uofg. Infectious disease epi and mathematical modeler. Mother. Feminist. #STEM #Math #globalhealth",0,0,1,1,2,300
2805421915,IC2S2,"6th International Conference on Computational Social Science, 17-20 July 2020.",2,0,0,1,3,300
17867838,ccatalini,"Co-Creator of @Libra_ ≋, Head Economist @calibra, Professor @MIT (on leave), Founder MIT Cryptoeconomics Lab https://t.co/OUnKKMkzfO, https://t.co/VVWzQeYTVi",1,0,0,0,1,300
2216552429,Beyond20000Days,"Beyond 20,000 Days builds on the work of the 20,000 Days Campaign - giving back well and healthy days to our community",0,0,1,0,1,178
50517429,jonggunLee,Head of Research and Chief Data Scientist @ Pulse Lab Jakarta of UN Global Pulse (An innovation initiative of UN Secretary-General on big data),0,0,1,2,3,300
127233575,lalvan,,0,0,2,0,2,176
389051649,PietroTerna,"Former full professor of Economics in the University of Torino, Italy.
Specialization: agent-based simulation in Economics.
Author of https://t.co/iK81yIZ5bt",1,0,0,2,3,299
26467061,marcogherardi,"Exploring technological and biological systems with statistical mechanics (Research fellow at Milan University, views my own). #complexsystems #statmech",0,1,1,0,2,196
325986531,CE0702,Systems Biologist - Pioneered the concept of balance in the chemokine network and developed a systems biology and bioinformatics infrastructure.,0,0,5,0,5,300
1377379782,DiegoFregolente,Research Scientist at Rensselaer Polytechnic Institute and the U.S. Army Research Lab.,2,0,0,0,2,237
16614440,jdfoote,"Assistant Prof of Communication at #Purdue. Computational social scientist: online organizations, collective decision making. @comdatasci member. Dad.",0,0,0,1,1,300
2583902516,ETHZSystDesign,"Chair of Systems Design at ETH Zurich, lead by Professor Frank Schweitzer.",2,1,0,0,3,97
2341772972,thedatascilab,The Data Science Lab is based in Behavioural Science at @WarwickBSchool. It is directed by @suzymoat and @t_preis.,0,0,0,1,1,300
110135284,nanumyan,Data Science consultant,0,0,0,2,2,152
2613988502,crimenet_ws,"#CRIMENET14, the 1st Workshop on Criminal Network Analysis and Mining, held in Barcelona, Spain, in conjunction with @SocInfo2014",0,0,1,0,1,20
2597727433,SMSEC2014,"SMSEC2014 (4-6 November, 2014, Kobe, Japan) is held as a joint conference of the first `Social Modeling and Simulations' and the 10th `Econophysics Colloquium'.",0,0,2,0,2,123
2411054834,EBucksJeff,"Stats and maths and R, previously used for understanding healthcare data now used to understand road and traffic data.",1,0,1,0,2,300
17877913,andreademarco,CTO of BitBang formerly Prof @ Computer Science Bologna University - Statistician Data&Visualization Scientist Predictive Analytics BigData,0,3,0,1,4,300
22881502,axelstreichen,"Cgnitive data scientist, studying decision making (esp. w.r.t. music) on the Web.",1,0,0,0,1,283
806368231,ICSS_Soton,Institute for Complex Systems Simulation - World-class computational modelling research at Southampton's Doctoral Training Centre in Complex Systems Simulation,4,1,7,1,13,300
99325926,emanudelfava,Research scientist @MPIDRnews at Lab of Digital and Computational Demography. Statistician. Italian immigrant. #MigrationStats,1,0,0,0,1,300
1128343110,alannanoellelaz,"Kellogg collaborator,  machine learning and AI enthusiast, passionate hockey wife/mom, triathlete, globe trotter and coach to entrepreneurs",1,0,0,0,1,300
1740835398,PunahaMatatini,A New Zealand Centre of Research Excellence for Complex Systems and Networks,0,0,0,1,1,300
1493423918,netsci15,"NetSci is the leading conference on Network Science and it aims to bring together leading researchers, practitioners, and teachers in network science.",2,3,3,3,11,300
94579404,jacobienc,"Phd student at RMIT University in complex networks. Loves the Melbourne lifestyle; coffee, gardening, drinking out of jars, bike riding, NLNL and hip bars",0,1,0,0,1,134
154862548,BhagatLD,"Follows 'Lord Chaos the Cat' ....  studies complex systems, network science, epidemiology, ...   RTs are just passing of the twitterial epidemic buck :)",0,0,1,1,2,300
1209052856,EtoilePlatform,This is the Étoile Platform twitter account.,2,0,2,1,5,300
278465124,cheabundo,PhD Physics | Complex Systems Scientist | Data Scientist,0,0,2,1,3,300
18123336,alikamil,Building autonomous dispatch at @goWiseSystems,1,0,0,0,1,300
29186208,convertino_matt,"Matteo Convertino, Scientist, Dad, Immigrant, DrEng PhD, Associate Professor, PI Nexus Group, Biocomplexity & Data Science, IST Hokkaido University, Sapporo, JP",0,0,2,1,3,300
779076895,sLaMMonites,"We are the sLaMMonites, Ph.D. students in the Seger/Adler Lab #uofu uniting biology & mathematics. We've got binders full of (math)models.",1,0,0,0,1,300
2436815372,ricgallotti,"Interdisciplinary physicist.
I tweet about human mobility, decision making, transportation, and data science.",2,1,0,2,5,300
436559810,lijunsun0,Assistant Professor | Civil Engineering | McGill University @mcgillu,1,0,0,0,1,300
2424373254,SEDPAM,"SEDPAM - Socio-Economic Dynamics: Physics-based Agent Models to go beyond the representative agent paradigm. 
Satellite co-located @eccs14 Lucca",1,1,1,0,3,129
26736307,ruchione,"Researcher and Entrepreneur with interests in user-generated content, social computing, crowd sourcing and ICT for development.",2,0,0,0,2,300
77502415,noduslabs,http://t.co/jMHrvJOYPa - Exploring Society and Cognition through the Framework of Network Science,0,1,1,1,3,300
193227076,amantrac,"Research Scientist @ Yahoo Sunnyvale. Working in machine learning, topic modeling, random walks and kernels methods",1,0,0,0,1,148
117553058,ctrattner,"Associate Professor at the University of Bergen, Norway; Doing research in Behavioral Data Science and Recommender Systems.",0,1,0,0,1,300
366709446,Complexsci,"This EPSRC network links 4 research projects at 5 institutions in 4 locations where Science, Social Science and Engineering tackle globally significant issues.",0,0,5,0,5,300
448513421,RexPauper,"Economy, Policy, Environment, Society, Science.  Complexity enthusiast seeking to change the world carefully and effectively. Author of ebook It Comes Undone",0,1,1,0,2,300
2348642744,eccs14,ECCS’14 will be a major international conference and event in the area of complex systems and interdisciplinary science in general | 22-26 of September,0,2,8,0,10,300
1734596533,SmartSocietyFP7,"disruptive R&D&I, FP7-FET project, collective intelligence, social computation",0,0,2,0,2,300
15553081,KamaLeo,,0,0,0,1,1,300
16112288,ogdabaum,"journalist, #datajournalism, videomaker, #radio lover, #science & #tech writer. travel writer and partner @ formicablu.",1,0,0,0,1,300
396815071,magnusforza,"Software Engineer. Interested in complex systems, scalable systems, algorithmic trading, artificial intelligence and security engineering.",0,0,1,0,1,0
2329482067,ComplexQubit,Applied Computer Scientist: ML/Graphs/ Statistics/Distributed Systems,0,0,1,0,1,300
2217406250,I_X_X_I_,IXXI is a research center located at ENS Lyon. From network science to the analysis of the impact of the digital revolution on economy or social organisation.,0,0,1,1,2,300
82908825,ST4CHealth,We believe that #systemsthinking and #complexityscience can be transformational in #globalhealth by increasing local capacity and shared learning,0,0,10,1,11,300
1515441991,aonghuslawlor,,1,3,0,0,4,300
158428310,marcmanzano,Executive Director - Cryptography Research and Development at Technology Innovation Institute. PhD in Computer Networks Security. 9xMarathon.,0,0,0,1,1,300
14283504,DoctorJosh,"Robotics professor at the University of Vermont. Also into crowdsourcing, evolution, machine learning, artificial intelligence, complex systems, and big data.",0,0,2,0,2,300
441974189,JoachimDeBeule,Data Scientist @engagor,1,0,0,0,1,193
12402812,isidromj,"Laboratorio de Redes Personales y Comunidades, Universidad de Sevilla. Sígueme también en @facpsi",1,1,0,0,2,300
2191138944,COOLws2014,"COOL2014: Connecting Online & Offline Life (#cool2014) is a workshop of WWW2014 @www2014_Korea, in beautiful Seoul (Korea), on April 8, 2014",1,0,0,0,1,56
41359037,AnnySml,"PhD researcher studying the society with computational methods. Social Physics, Statistics, Network Science, Languages, Wikipedia. Data Science Team at GESIS",1,1,0,0,2,120
34898082,nneubauer,"data, maps, graphs and stuff. 
I work at HERE Berlin, opinions are mine",0,0,1,0,1,99
109011025,jtmatamalas,Network scientist. Research Associate at Harvard Medical School,1,2,0,1,4,300
109874629,yunhwankim2,"Ph.D of Arts in Communication. Interested in computational social science, complexity, agent-based modeling, data science, and network analysis.",1,0,0,1,2,300
533624245,laurienti,"Wake Forest professor expressing his own opinions. Thinking about complexity, networks, the brain, and emergence.",0,0,3,0,3,300
1244399556,_nommon,Quantitative models for a sustainable future,0,0,1,0,1,300
367636140,Soc_Net_Intel,"Civil servant, homme idéal & dad of 3, #PhD student working on #SCADA for #C4ISTAR in #cyberspace , RT & views are my own. May The Force be with us",1,0,0,0,1,300
153779379,mopingowl,"Math & Physics teacher. Former Bayesian consultant, lazy blogger, loving Warren Zevon, snooker and TV_series.",1,0,0,1,2,300
1948032967,WebSciConf,The ACM Web Science Conference,2,2,1,0,5,300
558153537,pmavrodiev,"data scientist, dancer, engineer",1,0,0,0,1,72
32995679,onursavas,Senior Manager - Analytics and Artificial Intelligence (AI) @ Accenture Federal Services.,3,1,0,0,4,300
29692085,francescfont,"Data scientist at @ComplexDataSRL, postdoc at @ComplexAndBio @UniMi. Torino-Milano-Barcelona.",0,1,6,0,7,300
54546800,onicioneto,"co-founder @epitrack, researcher @uzh_ch",1,0,0,0,1,300
218608897,desimonemari,"President @ComplexityInst
CEO @Texturebenefit
Co-Founder @EnactionM",0,0,2,2,4,300
7622782,gutelius,"CEO @MotivaHQ, Founded the @dataguild. I like startups, data of all sizes, economics, network dynamics, adventure, national insecurities, and improving things.",1,0,0,0,1,300
1423742942,istrate_gabriel,"Dept. of Computer Science, West University of Timișoara",1,0,0,0,1,300
76982240,Lebowskiana,researcher @dclfbk @FBKcom /Fellow @theGovlab project lead OD200It founder Italian node @ODIHQ #civictechschool #openknowledge #opendata Tweets as @okfnitaly,0,0,1,0,1,300
17823114,mnick,Random Hypothesis Generator at Facebook AI Research. All views my own.,0,1,0,0,1,300
1087483224,IvaroEkel,"Interested on complex systems research, among many other things.",0,2,2,0,4,300
1583899302,futuroflotante,CEO @Seaphia_blue. Floating architecture & Maritime Special Economic Zones. PhD Candidate @Warwick; @fundacionceiba Doctoral Fellow.,0,0,1,0,1,300
489946763,Betrium,"Knowledge and Data Engineering and L3S Research Center (Big Data, Data Mining, Knowledge Discovery), previously Capgemini Germany",1,0,1,0,2,300
7656732,Vicsek,"Supporting companies in communication, marketing, organization development using Social Network Analysis. Building powerful online SNA tools for consultants.",0,1,1,4,6,230
1450064316,eccswarmup,"16-18 Sept, CCS Warm-Up  III School on Complex Systems",0,6,1,0,7,186
18448835,riivo,Geek excited about software and data.,1,0,0,0,1,129
1283157283,ScharnhorstA,,0,1,1,0,2,300
890710574,SATYAMMUKHERJE1,ইতিহাসে রাজহাঁস,0,1,0,1,2,300
1454215074,martgerlach,Research Scientist at @Wikimedia Foundation,0,0,2,0,2,139
1417683439,MFondacci,,0,0,0,1,1,81
194046843,atieh62,"Interested in Data analysis, Complex systems, Networks, and Data mining.",1,1,2,1,5,58
44867423,notallyellow,"Head of Research & Insight @Commetric
@AmecOrg Board member",1,0,0,1,2,300
27974512,sairmais,"Physicist, entrepreneur, 20 years doing machine learning. Author of the book ""Business Applications of Deep Learning""",1,0,0,0,1,300
252737143,carmenovella,Titolare dell'agenzia Ex Libris che si occupa di progettazione e comunicazione di eventi culturali.,1,0,0,0,1,300
158398564,caterinascoglio,,0,1,0,2,3,300
986903989,LaurenQuevillon,"human, she/her",0,0,1,0,1,300
1070276568,Social_lST,Social-IST is a FP7 project funded by the EC (DG CONNECT) aiming at catalysing interdisciplinary collaboration on the theme of Social Collective Intelligence,0,0,1,0,1,109
179543022,salathegroup,"Measuring and improving health outcomes with basic research, mobile technology, and social media.",1,0,0,1,2,300
459370488,ale_cere,"Scientist, Photographer, Diver",1,0,0,0,1,300
1231314888,covenant_ws,"Computational Social Science 2015: Collective Behaviors and Networks is a Satellite Event co-located with @CCS_15_USA, in sunny Tempe, AZ (USA), on Oct 1, 2015",3,1,0,0,4,136
1060290318,resonnetwork,Intelligence and Global Defence Institute,0,0,1,0,1,300
139507464,www2013rio,"Official Twitter for WWW2013 event in Rio de Janeiro
http://t.co/azb4Gclp",5,0,0,0,5,300
1316984629,marco_java,"Lecturer in Applied Math @UCL. Research in Statistical Physics/Math. Complex Systems, DeepLearning, Neuroscience, Evolution, Cryptos Love Animals #animal-rights",2,0,5,1,8,300
1286269166,mahmedyakoub,,0,0,1,0,1,34
1159612087,SophoclesEU,"Self-Organised information PrOcessing, CriticaLity and Emergence in multilevel Systems",1,0,1,0,2,27
1009496623,MavenSeven,"#BigData #PredictiveAnalytics We map hidden organizational networks with @OrgMapper, and online communities and influencers with @DiktioLabs.",1,0,0,5,6,300
1259800417,IMTLucca,IMT School for Advanced Studies Lucca is a research university within the Italian public higher education system.,0,1,0,0,1,300
1277127895,annamachens,data science. dynamic networks. complex systems..,0,0,3,0,3,145
1249741729,tdn_2013,"Temporal and Dynamic Networks: From Data to Models

Workshop on temporal and dynamic networks

Co-located with NetSci 2013

Copenhagen, Denmark, 3-7 June.",0,0,0,1,1,50
1006505497,eccs13,,1,3,1,0,5,300
81737577,FelipeMontesJ,Asst Prof & Dir MSc Analytics @uniandes. Passionate by Complexity for Education & Health. Ex-director of QA @mineducacion. My posts reflect my personal opinion.,3,0,1,0,4,300
52059455,akalten_bcn,"Director of Data Analytics at NTENT. Main research interests: user behaviour, social media mining, social network analysis, computational sociology.",2,0,0,0,2,116
15930711,sduretti,"Department Directory in @lepidaspa
Born in Turin, living in Modena, working in Bologna",1,0,0,0,1,300
598702353,GlobalSystemsSc,This is the TWITTER for the Global Systems Science community. See our Blog at http://t.co/vI46kyXsi7,0,0,2,0,2,300
143751299,mpavone,Associate Professor in Computational Intelligence,0,0,1,0,1,300
918593011,BeatrizPatraca,Periodista y antropóloga especialista en Análisis de Redes Sociales y netnografía. Consultora en la UOC. Analista independiente. Miembro de Egolab (UAB) #SNA,1,0,0,0,1,300
1022187452,jana_254,"Research Assistant at the University of St. Gallen, currently writing my dissertation about news value theory and network science",0,0,0,1,1,64
27680215,lammiia,"Data Skeptic, Avid reader, Perpetual learner, and a Doctor - the non-healer kind - Current Focus: Complex Networks, Graph Analytics, AI & #PyData 📷 D.Anikin",1,1,0,1,3,300
861230886,FETFoCAS,Fundamentals of Collective Adaptive Systems. A Future and Emerging Technologies Proactive Initiative funded by the European Commission under FP7.,2,0,2,0,4,300
579407040,AlvarezRobertoC,"Soy físico, ahora intento hacer biología.",0,0,0,1,1,300
113726456,xidira,Senior Researcher in TDM & Big Data Analytics,0,1,0,0,1,300
245554595,lpttwer,Android Lead Developer @Electrolux. PhD in Computer Science from University of Padua.,0,0,0,2,2,175
919599445,silviaggia_,"''If we knew what it was we were doing,
it wouldn't be called 'research', would it?'' (Albert Einstein) Opinions are my own.",1,0,0,0,1,300
187688769,Eschersand,"#Overpopulation_Stupid_Human_Peasants
#EvolveOrDie #PosthumanPhilosophy
#EmpireOfAtheism #GovernmentOfScience
#IntelligenceRule #ScienceImperialism #TyrannyNow",0,1,0,0,1,300
178649929,suzymoat,"Professor of Behavioural Science, investigating whether online data predicts human behaviour. Co-directs @thedatascilab. TEDx: https://t.co/7Ci5HdXQNx",1,0,0,1,2,300
77199037,mbellantone,"cheerleader for #science and its cultural values, honest enquiry and reporting, blissful enlightenment of the intellect through exploration and discovery",0,0,1,0,1,300
344030764,EPJscience,"Research, news and information from the European Physical Journals, covering pure and applied #physics and all related interdisciplinary #sciences",0,0,1,1,2,300
540111905,RodrigoAldecoa,"Graph theory, network analysis, and graph algorithms.


DM me!",0,6,0,2,8,300
164644973,teorionda,"I profess about #datamining, #knowledgediscovery, and #machinelearning at @AmherstCollege. I enjoy #brunch, #oysters, #sailing, and #theorems.",0,0,0,1,1,300
20610029,complexified,Application of complex systems science to leadership and change. Generative Dialogue and Process Improvement services. Green chile & delta blues.,0,0,1,0,1,300
856669430,ComplexWorldEU,The Research Network established to address 'Mastering Complex Systems Safely' - a vital research theme within the Long Term objectives of @SESAR_JU,0,0,1,0,1,38
820092720,avmantzaris,"Assistant Professor, Statistics, UCF.",2,1,0,1,4,300
755293986,networks_,"@mcatanzaro tweeting about networks and about Networks, A Very Short Introduction, Oxford University Press http://t.co/x1n37ihq8a",3,5,1,1,10,300
627474812,_PaulBot_,#Bot PhotoGraphe. bip biiiip bip blop.,1,0,0,0,1,90
14066472,pacoid,"evil mad sci @derwen_ai; he/him; animist; advisor @NYUColeridge, @IBMDataScience, @AmplifyPartners, @recogn_ai, @primer_ai; co-chair #DominoRev #JupyterCon2020",1,0,0,0,1,300
219219825,fvaccarino,Anticribbio,0,0,2,0,2,300
27439013,juanrocha,Postdoc studying critical transitions from regime shifts in ecosystems to collective action in society. Visiting scientist @medialab & @PrincetonPEI,1,1,3,1,6,300
344361113,autreche,Human-centric machine learning at the Max Planck Institute for Software Systems.,1,0,0,0,1,262
434727406,RateABusiness,Novel risk rating system that allows to perform objective business diagnosis and risk rating. The Democratization of ratings.,0,0,1,0,1,300
15533871,plotti,"Datascientist loves working with Scikit, Pytorch, SNA, Python, Ruby. Also likes studying information diffusion in Social Media.",1,0,0,0,1,300
270037518,fabeor,Inquieto coltivo la difficile arte di cacciare animali immaginari. Papà di due cucciole vere.,1,0,0,0,1,300
573815031,dani_agent,"AI, ML, #DataScience, #complexSystems, and some recipes! Now at @openbank_es & distracting myself with @databeers.",1,0,0,0,1,300
414355283,amniekamp,"MD anthropologist, consultant infectious disease control and sexual health, STI, social network analysis, research.",2,0,0,0,2,300
38193965,ph_singer,"Senior Data Scientist | PhD in CS | Kaggle: https://t.co/F23aL7qrlV | data science, machine learning, data mining, and statistics",1,0,0,0,1,300
146129222,maudotman,"Maths, Computer Science, Complex Systems,  Data Science, Network Science, Glocality,  Ecumenical Christianity, Palermo, Sicily, Italy, World",0,1,0,0,1,300
546092234,EllsCubed,"Computational Biologist. Avid Gamer. Developer of https://t.co/RBfm5Nk4Zs, Project Lead for https://t.co/iEvk1Q6KZo. I do not represent Uncle Sam, he just pays me.",1,0,0,0,1,300
507281282,IgnacioMarinL,"Spanish scientist: evolutionary biology, genetics, network science. Científico español:  biologia evolutiva, genética, análisis de redes.",0,4,0,2,6,300
323146214,viLNti,Technology. Bio_Art and Bio_hacking. Singularity University. Torino,0,0,1,0,1,300
113339417,cmordue,"Analytics, distributed systems, backpacking, traveling.",1,0,0,0,1,300
6206062,thetarro,"Sicilian. Husband of @almost_viola. Dad of a little boy. Software engineer in London. And passionate about intense espresso, good food, and world music.",0,1,0,0,1,300
18608658,rmarket,grad student,3,0,0,1,4,300
280994911,ezagheni,Social Scientist | Director of the Max Planck Institute for Demographic Research (@MPIDRnews) | Digital and Computational Demography,1,0,0,0,1,300
24414798,Dottor_T,"Pediatrician, epidemiologist, and vaccine expert. Chief innovation officer at https://t.co/vJSHDBsXfs. Engaged in telemedicine and patient empowerment",1,0,0,0,1,300
295238627,HamrouniGhassen,"Interested in algorithms, geometry, BigData, Comp Sci, OCaml, Haskell, C/C++",1,0,0,0,1,257
65703,cayce,complex systems scientist,0,0,1,0,1,1
18406495,James_Samworth,"Bioenergy and Renewable Energy Investor at Greencoat Capital. Husband, father, former physicist and sports addict.",0,0,1,0,1,300
24543879,virgilioalmeida,Visiting Professor at Harvard SEAS and Faculty Associate with  Berkman Klein Center for Internet & Society at Harvard. Professor of Computer Science at UFMG.,1,0,0,0,1,300
153439378,maksim2042,"AI and machine learning nerd, entrepreneur, jazz musician, triathlete. Author of Social Networks for Startups. Cofounder of @openhealthn",0,1,0,0,1,300
14489299,mumon,"@LUISSSoG and @talentgardenit Innovation School, Statistical Physicist, Data Scientist, CEO @ Linkalab, Data Analyst @ Catchy",0,0,0,2,2,300
15106719,mwinandy,Computer security researcher and system security architect. Trying to make systems behave as intended. Senior cyber security architect @innogy 🇩🇪,1,0,0,0,1,300
16016329,pjlamberson,"@UCLA Associate Professor studying social dynamics, networks, and contagion: https://t.co/ILqEUL14gF",1,2,2,3,8,300
74949430,ZeroSano,"easy going 🐬/ assistant professor at University of Tsukuba.
発言は個人の見解であり、所属組織を代表するものではありません。",1,0,1,0,2,300
73579138,caosoriot,"PhD in E-Business @NCLBusiness. Research director Marketing degree @umanizales. Researching the digital world, specially about user behaviour on Social Networks",3,0,0,0,3,300
205618337,networksfr,"All aspects of real-world networks: internet, random graphs, social network, spreading phenomena, graph algorithms, biological networks.",3,2,0,0,5,126
44380488,gazeti,"Building a better America through technology. Currently: @skylight_hq Previously: @18F, @CFPB",0,0,0,1,1,300
245953647,ayazarka88,"Mathematical Modeling and Control. An Engineer is my personality key. happily fixing broken systems. Applied mathematics, Applied ethics ♥. From Egypt..",0,0,1,0,1,300
97810233,MarcinGruszka,"Director of Risk and Customer Analytics | Retail Bank | Ph.D. Computational Physics | Father, Husband and Traveler",1,0,0,0,1,300
38813037,cuneytgurcan,"Asst Prof of CS and Statistics at @Umanitoba. Data, networks and blockchains. I tend to read everything",1,1,1,0,3,300
209692125,kateaanderson,"Department of Informatics and Networked Systems // Pitt School of Computing and Information// Research in Human Capital, Social Networks, and Collaboration",1,0,0,0,1,300
38176806,closertag,"We create clear, useful and fluid interactive experiences. We love crafting services & products on mobile, web and tablets.",1,0,0,0,1,180
70235770,przemyslslaw,"Researcher @UMassCS: computational social science, social media, data mining, fairness in machine learning, open science.",3,0,0,0,3,300
359838444,Akbaritabar,#ComputationalSocialScientist ?! Post-doc of #SocialAspectOfScience @ #DZHW Berlin (https://t.co/RajU2MlEwZ…)  Passionate of #Rstats #Python Into #Networks #SNA,4,0,0,2,6,300
38640273,davidecellai,"Senior data scientist @centralbank_ie. Science, maths, networks, data. Co-founder of @DatabeersDub. Views my own, RT not endorsements, etc.",3,1,0,0,4,300
195495310,myvinnie,"MIT EECS, co-founder @wellframe,
 
networks, data, health",0,1,1,0,2,113
238436945,Liberationtech,Tech for social good. @Autom8. Previously a @Stanford account.,1,0,0,0,1,300
14305066,mahir_nyc,Co-founder @topos_ai Adjunct @Penn Constantly thinking about #data and #AI. Previously @RGA @The_O_C_R Seed Scientific @ArsElectronica,1,0,0,0,1,300
318879230,everyAware,Enhancing environmental awareness through social information technologies,1,0,0,0,1,177
110391215,SNAnalyst,"Prof. of Networks in Organizations @Tilburg University.
Topics: Social Networks, Social Network Analysis (SNA), Teams, Creativity, Innovation. Tweets in NL&US.",0,1,0,0,1,300
16687314,gionis,,1,0,0,0,1,186
166304741,WINWorkshop,"Workshop on Information in Networks at @NYUStern. WIN#6 was held October 2-3, 2015.",2,1,0,2,5,246
156776019,MugsyMeg,Hmmmmmm,0,0,1,0,1,300
275450011,socioaware,The SocioAware workshop explores how the recent popularity of social utilities and services retroacts on networking infrastructures by which they are mediated.,2,0,0,0,2,60
254497239,anxosan,"Physicist, Applied Math professor, @gisc_group, @uc3m, Spain. Research on complex systems & applications of phys & math to social science. Opinions are my own",0,0,1,0,1,300
194617383,FriendFuel,"Strengthen your trusted, real-life network of family, friends, colleagues and brands that fuel your life",5,0,0,0,5,300
269719859,complexdynamics,Official twitter account of the ECCS'11 satellite meeting on Complex dynamics of Human Interactions,1,0,0,0,1,47
20023987,egaltmann,Dynamics & complex systems. A/Prof @Sydney_Uni,1,1,8,1,11,300
21297338,dirkbollen_,,2,0,0,0,2,300
12160482,marc_smith,"Sociologist of computer-mediated collective action @ Connected Action http://t.co/5dRFa89a
Director: Social Media Research Foundation http://t.co/KPxyHajJ",3,0,0,0,3,300
246351506,guillemgm,"Chief Scientific Officer at Insikt Intelligence  (Data Science, NLP, Machine Learning)",11,5,0,1,17,300
22213177,aheineike,Bring on the algorithms!  VP Tech @ Primer AI,1,0,0,0,1,300
101824202,gmiritello,Researcher and data scientist. Now at @vodafone. Cofounder of @databeers and organizer of @databeersldn,1,0,0,3,4,300
8560212,Dumpita,"Th1nker, Co-Founder at bogohack. Poet. Educator, Futurist, anarchist, life-player, crypto-enthusiast.",1,0,0,0,1,300
219610388,FOCproject,FOC (Forecasting Financial Crises) is a European scientific project aimed at understanding and forecasting systemic risk and global financial instabilities.,0,19,0,0,19,146
129448583,t_takaguchi,"Data Scientist at Data Science team, Data Labs, LINE Corp",0,0,1,3,4,300
176334649,scifr0g,"Majored in statistical physics. My interests : Complex Systems, Social Network Analysis, Information Visualization, Econophysics. | mainly links and RT's",7,7,2,0,16,300
57821848,jzy3d,,1,0,0,0,1,282
175072843,RessiveNetworks,Doing Business in a Networked World. Social Media and Social Network Analysis driven business analytics.,3,0,0,0,3,300
18008785,CiroV1,Sr. Software Engineer for Space Launch and Test Range Systems Technology with the U.S. Space Force. Opening portals to Space. Tweets are mine. 🚀,0,1,0,0,1,300
31051381,connormccabe,Techie,4,0,1,2,7,261
163272475,PhiloWeb,"Acedemic Web and Philosophy events (PhiloWeb 2010+2011+2012, Philosophy & Engineering workshop @IC 2011+2012), seminars, publications, research projects, etc.",1,0,0,0,1,300
162684694,kerstinsailer,"Reader in Social and Spatial Networks @BartlettArchUCL. Co-founder of @brainybirdz. Speaker. Blogger. Mum. All about workplace, networks, visualisation, data.",1,0,0,0,1,300
11094912,soramaki,"Founder & CEO of Financial Network Analytics Ltd. 
Editor of J. of Network Theory in Finance. 
#suptech #regtech #analytics #simulation",0,1,0,0,1,300
110633876,miz_oka,ウェブサイエンス・人工生命。筑波大学・准教授。Alternative Machine Inc. 代表取締役。人工知能学会ウェブサイエンス研究会・主査。一般社団法人ALIFE Lab.理事。『作って動かすALife』オライリー・ジャパンより発売中https://t.co/jQnO7uJXE1,0,0,1,0,1,300
27104786,rabeeh,"Researcher, interested in Social Computing and Network Science",2,0,0,2,4,300
124736636,msm_2010,"First workshop on Modeling Social Media, co-located with Hypertext 2010 conference",2,0,0,0,2,84
22749856,Gephi,Network visualization and analysis platform.,2,0,0,0,2,300
18715444,hunch,Hunch makes great recommendations by learning your tastes,1,0,0,0,1,300
39393,bru,starling whisperer,0,0,0,1,1,300
89738262,sdivad,"Researcher in computational social science. Social networks, online discussions, peer production, digital democracy",2,0,0,0,2,158
12855572,openp2pdesign,"Metadesign for Open Systems, Processes, Projects. Studying and enabling open collaborative projects and the systems that design them since 2005.",0,0,2,0,2,300
53137489,ReBritz,Curious engineer. Maker of hardware. Hugging and pushing obstacles only on PCBs.,1,0,0,0,1,300
14300960,arthur3131,"Professor @Uni_Wue, Informatik, Data Science und KI, Leiter der @dmirgroup",0,0,0,1,1,300
53125787,FoolsDelight,Security plus time is comedy. Drink Nafsu Cola - the third most popular soft drink!,1,0,0,0,1,300
49562780,strawspulled,"Love Japan, love photography, love travels, love technology. http://t.co/a36BwPsMaB",1,0,0,0,1,300
13069682,eduardomacan,geek.,1,0,1,0,2,300
5159271,napo,"fbk, openstreetmap, gis, neocartography, okfn italy,  open data, open source, software libero, sociologia, trento, pallavolo, digital commons lab",0,0,1,0,1,300
89327703,harlingg,"Epidemiologist @UCLGlobalHealth & @AHRI_News. Focus on social networks & health (HIV, TB, dementia). Mostly in sub-Saharan Africa. Currently working on #COVID19",4,0,0,0,4,300
1192898921015758860,Stitch_Sapienza,The Center promotes interdisciplinary research activities aimed to expand scientific knowledge and industrial relocation of innovative health technologies,1,0,1,0,2,103
2999677683,Lai_CDC,Senior Research Fellow @WorldPopProject & @flowminder. Interested in population movement and infectious disease dynamics.,1,0,0,0,1,150
57268983,future_andi,"data scientist, photographer, volunteer for OLPC",1,0,2,0,3,300
25530648,Peter_Sloot,http://t.co/C3WFZpzttf,0,0,3,3,6,300
2666790169,ProjectDrawdown,The world’s leading resource for climate solutions. Download your free copy of the Drawdown Review from our website: https://t.co/7Uhp6tGOXR,0,0,1,0,1,300
1845494474,EpicScotland,"EPIC (Epidemiology, Population health and Infectious disease Control) is an ambitious Scottish animal heath consortium project.",0,0,0,1,1,300
268337552,kourtellis,"Privacy, big data, stream mining, socially-aware distributed systems",2,0,0,0,2,121
1119052984606965761,cbatista_econ,"Associate Professor of Economics @NovaSBE | Founder and Scientific Director @NOVAFRICA | International migration, financial inclusion & development economics",1,0,0,0,1,120
931458348,fevaldovinos,"AssistProf @UMichEEB & @UMICHCS, studies #EcologicalNetworks #MutualisticNetworks #FoodWebs #Pollination #TheoreticalEcology #Mutualism",1,1,0,2,4,181
228840354,EpidemiologyLWW,"Epidemiology publishes original research from all fields of epidemiology. The journal also welcomes review articles, and other articles on public health issues.",1,0,0,0,1,300
1186648442,Heinonmatti,"Cargo-cult complexity scientist studying health behaviour change, promoting scientific integrity, & un-understanding Zen. RWRI survivor. I eat my own medicine.",0,0,1,0,1,300
1384800560,emmaspiro,"Assistant Professor @UW_iSchool, Co-Founder @uwcip | PhD in Sociology from @UCIrvine | social networks, sociology, misinformation & computational social science",1,0,0,0,1,172
997914914147721216,meharpist,"I’m a harpist and scientist, working as an editor for Nature when I’m not making music, biking or skiing. All views are my own.",1,0,0,0,1,266
502278199,PLOSNTDs,"The first open-access journal devoted to the world's most neglected tropical diseases. Image Credit: Miss Roumaissa Gherbi, University of Ferhat Abbas",1,0,0,0,1,300
1125449088839774208,homahmrd,Computational Social Science · Network Science . Wearable sensors · Human Behavior ·  Missbehavior · Cyber Bullying,0,1,0,0,1,16
1139605052346253313,Complexity72h,"Workshop bringing together young researchers in complex systems. 72 hours to carry out a project! July 1-4 2020, @UniLUISS, Rome, Italy #Complexity72h",0,0,1,0,1,111
66998391,ecekamar,Artificial intelligence researcher,1,0,0,0,1,57
779319067807191040,sonia_kefi,"researcher @cnrs. Ecology, networks & stability.",0,0,0,1,1,149
298143992,RMaria_drc,"Complexity Economist @INETOxford. Mathematics PhD student @OxUniMaths. Studying automation in the labour market, networks, and shock propagation.",0,1,3,0,4,281
21386804,ilyabo,mobility data visualization engineer at @teralytics. past @ixt @unifr. creator of https://t.co/B5uBA9qHcL,0,0,0,1,1,300
20507623,RSocPublishing,"Publisher of the life and physical sciences, including the world's oldest science journal. Part of @royalsociety https://t.co/68tUhenDzJ",0,1,0,0,1,300
39281968,IQSS,Harvard's home for social science research.,1,0,0,0,1,300
2293415520,theNASciences,"Society of distinguished scientists. Provides independent, objective advice to the U.S. on science & tech. Meetings, symposia, & @PNASNews. Pres @marcia4science",0,0,1,0,1,300
193301414,EUScienceInnov,Official account of DG Research & Innovation @EU_Commission Managing @EU_H2020 prog & implementing Commissioner @GabrielMariya strategy. Follow also @JEPaquetEU,0,0,0,1,1,300
1171918842,novafrica,Interested in business and economic development in Africa and around the globe,1,0,0,0,1,300
635986661,QatarComputing,Qatar Computing Research Institute. Data Analytics-Social Computing-Cyber Security-Distributed Systems-Arabic Language Technologies-CSE. @QatarFoundation Member,1,0,0,0,1,300
221838349,Austen,CEO @LambdaSchool: A CS education with no tuition until you get a job (really). I have made remarks I do not agree with 🤷‍♂️,1,0,0,0,1,300
932563102499000320,NatMachIntell,"A @SpringerNature journal on AI, robotics and machine learning. Tweets by @LCVenema and @yanniscaus",0,1,0,0,1,300
620339799,AndyTatem,"Professor, University of Southampton. Director of the WorldPop project  (@WorldPopProject) and co-director of Flowminder Foundation (@Flowminder)",1,0,0,0,1,300
573691525,MPIDRnews,"Max Planck Institute for Demographic Research (MPIDR), Rostock, Germany. News & press releases.",1,0,0,0,1,300
1026299734116392960,CCS2019_NTU,,1,0,2,0,3,73
591924206,PolNetworks,Twitter feed for the APSA Political Networks section.,3,0,0,3,6,300
1439362303,RowlandKao,"Professor of Veterinary Epidemiology and Data Science, working on bovine Tuberculosis, FMD and other diseases, using genetics, math, stats and social networks.",1,0,0,2,3,300
980141996663824386,ComplexDataSRL,"We love science and technological challenges. We create cutting-edge algorithms for complex data analysis, simplifying research in all fields.",0,0,1,0,1,83
14131652,ittagroB,Social network analysis; Knowledge,1,0,0,1,2,185
877077656117940224,DataScience_PhD,"The Data Science Ph.D. Program is a Joint initiative by Scuola Normale Superiore, University of Pisa, Sant'Anna School, IMT Lucca
and National Research Council",1,0,1,0,2,279
3270678680,pmddomingos,"Professor of computer science at UW and author of 'The Master Algorithm'. Into #MachineLearning, #AI, #DataScience, and anything that makes me curious.",1,0,0,0,1,300
50095170,lawrennd,"Professor of machine learning at the University of Cambridge, co-host with @kgorman of @TlkngMchns. Opinions are my own.",0,0,1,0,1,300
2906491178,NeuroStats,"Graphical models. Inferential network science. Causal inference. Predictive Inference. Maker of skggm.
@StanfordPsy | PhD @RiceU_ECE  | BS @ECEILLINOIS",0,0,1,1,2,300
714936930509701121,annamonreale,,1,0,1,0,2,272
90842304,datascience_mi,"The Data Science Lab at Politecnico di Milano studies theory, methods, tools, technologies and applications for data science in real world problems.",1,0,0,0,1,300
630206666,Tsourolampis,"Asst. Prof. Boston University, Harvard SEAS Assoc. ""We cannot change the cards we are dealt, just how we play the hand."" (Randy Pausch)",1,0,0,1,2,300
786168247301185536,logic_magazine,A magazine about technology. Current issue: Nature. Next: Security. Subscribe at https://t.co/I1lj5O0rao,1,0,0,0,1,300
28108594,mary_madden,"Affiliate @datasociety + Proud @BKCHarvard / @pewresearch @pewinternet alum / 
sometimes making music, sometimes making concerts",1,0,0,0,1,300
4345234454,MFiterau,"Assistant Prof @umasscs, @UMassAmherst. Formerly postdoc @Stanford CS. PhD from @mldcmu. Research: ensembles, structured sparsity, deep fusion, ML4Health.",0,0,0,1,1,300
3108011055,TheGoodLobby,"The leading advocacy movement democratizing lobbying for the many, not the few - founded by @alemannoEU | Subscribe to our newsletter at https://t.co/TgHm6ZHFJw",1,0,0,0,1,300
757224325,MaxiSanMiguel,,0,0,3,0,3,300
1403263087,EricaKlarreich,"Mathematics and science journalist. My work has appeared in Quanta, Nature, The Atlantic, New Scientist, Science News and other publications.",0,0,0,1,1,300
467551928,ERC_Research,"The European Research Council, set up by the EU, funds top researchers of any nationality, helping them pursue great ideas at the frontiers of knowledge. #H2020",0,0,0,1,1,300
520778935,visualized,Data + Storytelling + Design,0,1,0,0,1,300
2882431042,uclbdi,@ucl Big Data Institute: Promoting the development of new #datascience theory & algorithms to make sense of #bigdata. Led by Sofia Olhede.,0,0,0,1,1,300
753068531764252673,CCS2016_AMS,"AMSTERDAM CCS 2016, will be the major international conference &event for complex systems& interdisciplinary science. For more info, log on to our website!",0,0,1,0,1,38
2598162997,ML_NLP,"We share news, discussions, videos, papers, and tutorials related to Machine Learning and NLP. Subscribe on Reddit!",1,0,0,0,1,300
4286328013,netsci2016,NetSci2016: International School and Conferences on Network Science,1,5,0,4,10,300
2907682397,graphext,A data science no-code platform for business analysts. Data U Science U Design U Business https://t.co/mhUsrFiaTR… https://t.co/khChOSDg3R,1,0,1,0,2,300
452365369,AlessandroSpin,"Data Protection Officer at the European Medicines Agency; tweets are strictly personal views, for official positions check: @EMA_News.",1,0,0,0,1,300
54204367,ssnstudy,,2,0,0,0,2,194
2374215589,netsci14,"NetSci 2014 will take place on June 2-6, 2014 in Berkeley California, at the Claremont Hotel and the Clark Kerr Campus of the University of California.",1,0,0,3,4,263
6334772,eytan,"Research manager at Facebook leading the Adaptive Experimentation team. Bayesian optimization, Bayesian ML, bandits, RL, experiments, causal inference.",0,0,1,0,1,300
2200407048,QuantumISI,Basic science research - quantum physics - adiabatic quantum computing - tensor networks - complex and networked systems science.,0,11,0,1,12,226
989,om,I was a reporter once. I write about tech. I make photos. I invest @TrueVentures Blog: https://t.co/AvBTBiv8hn. Telegram: https://t.co/scnlDQXWMY My Newsletter: https://t.co/6bHJ6TCjN4,1,0,0,0,1,300
360537923,PepeBruselas,,0,0,1,0,1,78
18204430,sgourley,"Physicist, Decathlete. Mathematics of war. CEO and Founder of @primer_ai",1,0,0,0,1,300
14556945,yvesalexandre,Asst. Prof at @ImperialDSI leading the Computational Privacy Group. Frm Special Adviser to EU Commissioner @Vestager. @MIT @MediaLab PhD. Opinions are my own.,1,0,0,0,1,300
1022609606,LasagneFP7,EU Project (FP7) on multi-LAyer SpAtiotemporal Generalized NEtworks,0,3,3,1,7,300
845434484,netsci13,"NetSci is the leading conference on Network Science and it aims to bring together leading researchers, practitioners, and teachers in network science.",0,0,0,1,1,1
17943596,visang,"research on quantitative assessment of patterns of traffic, human population distribution, cross cultural linguistic semantic space & urban scaling",0,0,0,1,1,300
529389246,StevenBishopUCL,"Professor of Mathematics, specialising in Non-Linear Dynamics and Complex Systems, at University College London.",0,0,1,0,1,210
161539552,DataPointed,Stephen Von Worley. Data visualization and words: https://t.co/G908V2HFmI About: https://t.co/xpBlnBfHab,1,0,0,0,1,300
21713505,okdistribute,"Public interest tech in solidarity with marginalized communities @digidem 
board @dat_protocol @codeforsociety
alum @delta_chat @0debtzone @aspenpolicyhub",0,0,1,0,1,300
14810361,kunegis,"Network scientist, web scientist & data scientist at University of Namur, Belgium. Leader of @KONECTproject. https://t.co/1wMcCevhZ0",5,1,0,2,8,300
2893971,gigaom,"GigaOm is the leading global voice on emerging technologies. We help transform enterprises with insight and guidance in an AI-enriched, data-driven world.",0,1,0,0,1,300
240514272,mappingscience,"A ten-year visual trek through the evolution of science mapping, from its earliest beginnings to its most cutting-edge developments.",0,0,0,1,1,60
275596584,rui__carvalho,Assistant Professor at Durham University.  Work: convex optimization and statistics (data science). Don't blame my employer for my views.,0,0,1,0,1,300
254791849,SciPyTip,Tweets about SciPy (Scientific Python) and related topics from @JohnDCook.,0,1,0,0,1,300
273309183,gisc_group,"Grupo Interdisciplinar de Sistemas Complejos: Research on complex systems since 1996 at Universidad Carlos III de Madrid, Universidad Complutense, and others",1,2,3,2,8,300
16060978,datalicious,Marketing Data Specialists. Google Marketing Platform. Media Attribution. Media Mix Modelling.,1,0,0,0,1,300
23779644,mentatseb,"CEO of @linkurious, @Gephi co-founder, PhD in computer science, I democratize network thinking.",1,0,0,0,1,300
14344469,peteskomoroch,"Machine Learning, AI, Data Science Exec & Investor. Past: Cofounder/CEO @SkipFlag (acq by @Workday), @Accel EIR, Early data team lead @LinkedIn, ML @AOL @MIT",1,0,0,0,1,300
33786195,bwaber,"President and Co-Founder of @humanyze (nee @sociometric), he/him, @medialab Visiting Scientist, former Senior Researcher @ HBS, author of @peopleanalytics",0,0,0,1,1,300
84351228,timberners_lee,"Director of W3C (https://t.co/uyt4YeYD5u), the Web standards place.  Founded https://t.co/kq0t1e4pVj - let web serve humanity. CTO https://t.co/vsUasPsY5r to develop https://t.co/iPoqAldF1M",1,0,0,0,1,300
17089636,NewsfromScience,"The latest stories in science, brought to you by the @ScienceMagazine news team.",0,0,0,1,1,300
18805477,jakehofman,"senior principal researcher at msr nyc, adjunct professor at columbia",1,0,1,0,2,300
17595439,chr1sa,"CEO of @3DRobotics, runs @DIYRobocars, @DIYDrones, @Dronecode. Wrote Long Tail, FREE, Makers. Ex Wired, Economist, Nature, Science. (Profile photo by Joi Ito)",1,0,0,0,1,300
743913,davidorban,"Blockchain and Startup Investor / Advisor & Faculty, Singularity University – Analyzing and investing in cycles of accelerating technological change.",2,0,0,0,2,300
815138720051511296,kieran_mepham,PhD Student @ETHZ / SNLab || Network sociology | Opinion dynamics || Weights & cardio | Cooking (poorly),3,0,0,0,3,120
303553181,benjamindhorne,"Soon to be Asst. Prof. of Information Sciences @UTKnoxville 🍊, By way of @RPI & @UnionUniversity, I study safety in online spaces, devoted Denver sports fan.",0,0,1,0,1,300
1226766935431364608,statsof1,Personalized #DigitalHealth | Blog about your #statistical methods for individual-focused analysis at https://t.co/4kjIuCVyjz (by @ericjdaza) | #nof1 #wearables,0,0,0,1,1,202
23772560,FredrikMoberg,Director @albaeco and on leave from my half-time position @sthlmresilience to write a book about #Biomimicry (in Swedish). Tweets are my own.,0,0,1,0,1,300
44336748,SRoyLee,"Assistant Professor at University of Saskatchewan, working on data mining, natural language processing, machine learning, and social computing.",2,1,0,0,3,300
3900044009,KnoebelSu,,1,0,0,0,1,300
740106610182356992,UvA_IAS,"Where outstanding researchers bridge disciplines, scales and paradigms to unravel wicked problems",1,1,4,3,9,300
119054265,JohannH_M,"Physics of Complex Sytems at Biomedical Engineering. Universidad de los Andes. Colombia.
Grupo Interdisciplinario de Sistemas Complejos Madrid (GISC). Spain.",1,1,1,2,5,300
389347085,venkat_rpr,"Head of Data Science @ #GOPAY, @gopayindonesia, @gojektech. Physics PhD. Dabbler in complex systems and networks.",1,0,1,0,2,300
1066288106,fdabl,"PhD Candidate Psychological Methods || Bayesian statistics, Causal inference, Dynamical Systems || Data for the Social Good @CorrelAidxNL & @versuscorona",0,0,1,0,1,300
3247591613,IAS_LiU,"The Institute for Analytical Sociology (IAS) at Linköping University conducts big-data influenced research on important social, political, and cultural matters.",0,0,0,1,1,168
2884725684,complexitycobus,PhD researcher in complex adaptive urban systems (University of London) Urban Futurist and Partner | Urban Complexity at Systems Innovation,0,0,1,0,1,300
80750540,gruzd,"Visit the COVID19MisInfo Portal by @SMLabTO at https://t.co/9sfEv2IfnT 

Bio: Canada Research Chair & Assoc. Prof. @RyersonU, Toronto | @socmediaconf Co-Founder",1,0,0,0,1,300
985144418,ClemensJarnach,"Doctoral Student in Sociology, @SociologyOxford.
Interests: political sociology, social networks, quantitative methods, music, and protecting the environment",2,0,0,0,2,229
770057,soci,"Principle Data Scientist  - Quant and Qual Analysis, Social Media and Ethics Lead at HMRC #teamHMRC. #Leedsalumni",0,1,0,0,1,300
928925064216694784,AKeuchenius,"PhD @UvA in computational sociology, studying the spread of ideas. Organiser of CSS Amsterdam, https://t.co/R46zFnx62b. My latest work: https://t.co/VIPPpg19Ld",1,0,0,1,2,189
1322797574,neurovium,"#{I COMPUTE, THEREFORE I AM}#
Physics of Bio-computation,  Theoretical Neuroscience, Bio-inspired Intelligence, Complex Systems.
Current: Allen Discovery Center",0,0,1,0,1,300
60862893,Rikatier,"Complex systems researcher at Centre for Complex System in Transition (CST), Stellenbosch University, South Africa",0,0,2,0,2,300
996776255755358208,cuihaosabrina,"PhD candidate in Network Science @dnds_ceu, former #MScMathematics #EötvösLorándUniv #NetworkScience #NLP #MachineLearning #OnlineSocialNetwork",0,1,0,0,1,54
83392573,silviamajo,"Researcher on political communication at the Reuters Institute for the Study of Journalism, University of Oxford & Networks passionate | See more https://t.co/T4t12icQld",1,0,0,0,1,300
193836620,ramona_roller,PhD candidate in data-driven modeling of socio-historic systems at ETH Zurich,1,0,0,0,1,10
1016004827174916096,janalasser,"Researcher at @CSHVienna, physicist, DataScientist #OpenScience activist, #coder, advisory board @N2PhDNet, #fellowsfreieswissen | she/her",0,0,1,0,1,300
81143606,dvladek,Someone with lots of questions and few answers. Currently research padawan at @uuinfolab and chess arbiter in my free time.,2,0,2,2,6,300
1019605193523113985,ChuecaCristina,Politics & Quants Graduate @GlasgowQStep | PhD AQM Studentship recipient on network polarisation @SocSciScotland | Interested on social media research.,0,0,0,1,1,300
1134260544381341702,BurkholzRebekka,"PostDoc at Harvard University. Research on complex networks, cascades, gene regulation, and machine learning.",0,1,0,0,1,0
2211673627,amirhfarzam,"PhD student in Applied Math @NorthwesternU with broad scientific interest ranging from Social to Bio Sci. Alum @umichMath @UMich, @ManUniMaths, & @UnivOfTehran.",0,0,1,0,1,20
115291227,geofurb,"Physics PhD student studying complex networks. Grudging altruist, frequently wrong. Sisiphyian figure who had the option to roll the boulder downhill instead.",0,1,0,0,1,300
2919801897,miguelmahechag1,"Earth System Data Sciences, Ecosystem Functioning, Climate extremes, Prof. at the Remote Sensing Centre for Earth System Research @UniLeipzig",0,0,1,0,1,300
285813689,egoitzaulestia,"Entrepreneur, Scientific Designer, and Futurist working in complex systems innovation 🔭+🔬",0,0,1,0,1,300
2305187539,EUSNConference,"4th European Conference on Social Networks (EUSN) Zurich, Switzerland 9-12 September, 2019
#eusn2019",6,0,0,0,6,300
910968376830414849,r9vina,,1,0,0,0,1,178
86460131,PetrovVladimirU,"MarieCurie program in BigDataFinance. Fintech, Blockchain: from Science to Art. 
PhD candidate at the University of Zurich, Banking and Finance.",1,0,0,0,1,300
573245349,juaninona_,"Physicist (complex systems). 
💜
Feminista",0,0,1,0,1,300
967415814646267905,AnToniPichler,"PhD student investigating complexity in the economy @INETOxford & @OxUniMaths & @CSHVienna
**technological progress **production networks **systemic risk",0,0,2,0,2,59
772115981430816768,sibel_eker_,Researcher @IIASAVienna; modeling | uncertainty,0,0,1,0,1,200
461482865,ikryven,Utrecht University,0,0,1,0,1,16
718022858748923904,marciaf25062138,"PhD candidate. Interest in Innovation Dynamics, Spatial Mobility, Evolutionary Systems, & SciSci. @CSHVienna, @tuvienna,  & visiting fellow @cwtsleiden.",1,1,2,0,4,138
256225479,brentauble,"Computational Social Science, Data Science, HR, Workforce Analytics, Agent-Based Modeling, Social Network Analysis, Computational Narrative Generation, Python/R",1,0,0,0,1,300
720968635049779200,philipp_mendoza,"PolSci & Sociology Res. MAStudent @UvA_Amsterdam
Affective Polarization | Populism | Computational SocSci.

-atm looking for a PhD / other cool project opport.-",0,0,1,0,1,235
266622410,SimStolz,Predictive Analytics | Digital Marketing | Big Data | Social Networks | R  - @whu_edu,2,0,0,0,2,274
3011101451,moritzhoferer,"PhD candidate in @mip_ethz group at @ETH Zurich. Research: Political campaigns on complex networks. Studies: @LMU_Muenchen, @LaStatale & @ComplexAndBio.",0,1,0,0,1,48
785848339476705284,MAbbasiharofteh,Research Assistant @iamoLeibniz,1,1,0,3,5,111
3457644501,evang_ioannidis,,1,0,0,0,1,6
138464018,bobirakova,"Social change through response-able systems. Fellow @PartnershipAI, #ResponsibleAI @Accenture, Assembler @BKCHarvard, Research @Samsung, NCS TF @SingularityU",2,0,1,0,3,300
1025075607074299904,kim_steffie,"@USCAnnenbergPhD Interpersonal health communication, VR therapy, Social anxiety researcher | R, Python, Adobe Creative Suite",1,0,0,0,1,39
16549181,pako7,,1,0,0,0,1,300
156204739,zdepablo,Data Scientist @ BBVA Data & Analytics. Crunching numbers and letters,1,0,0,0,1,300
34570530,feedkoko,"Asst Prof @NUSingapore, ex - NTU, UPenn, AdobeResearch | Beatles fan | NLProc social media x communication | #womenalsoknowstuff | she/her",0,0,0,1,1,300
331080165,j_neidhardt,,0,0,0,1,1,191
16342929,DrRyanBoyd,"Social/Personality Psychologist, Computational Social Scientist, and Occasional Software Developer.",1,1,0,0,2,300
14835654,jalorenz,"Computational social scientist, agent-based models, opinion dynamics and collective decision. Sometimes english, manchmal deutsch",0,1,0,0,1,300
94874333,juhi153,"Postdoctoral researcher at @gesis_org.
Research fellow at ""Algorithmed Public Spheres"" research network at @BredowInstitut.
PhD from @socialmpi, MPI-SWS.",1,0,1,0,2,140
146287709,johannes_wachs,Assistant Prof. @wu_vienna and @csh_vienna. Interested in networks and social computing. PhD from Central European University,3,1,1,1,6,300
2330414268,scorpiommma,"Once a scientist, always a scientist. So I question everything in life, unless it is art that I admire",1,0,0,0,1,300
1550265457,Jan_Korbel,"Ph.D., researcher in mathematical physics.

 'Zkuste při soutěži kdo řekne větší číslo vyhrát, když začnete.'",0,0,1,0,1,300
47881149,jacobgroshek,Emerging media researcher and digital experience management analyst . Examine media content / diffusion and its effects. TCAT admin | https://t.co/5DNOLLmJtA,0,0,1,0,1,300
246780608,mariabargues,"Theoretically a biologist; or a theoretical biologist. Pursuing the doctor prefix at @MPI_EvolBio. Piulo poc, però per poc que piulo, repiulo prou.",0,0,1,0,1,300
583637312,srijankedia,"Assistant Professor, College of Computing, @GeorgiaTech. Research: data science & machine learning for the web and society. Past: Google AI, Stanford, UMD, IIT",1,0,0,1,2,300
14817871,DanielMRomero,"Assistant Professor @UMSI working on Social Networks, Complex Systems, Network Science, Social Media, Computational Social Science. 🇨🇴🇺🇸",3,1,0,1,5,300
78688499,kwelle,Information scientist with multi-disciplinary interests. Social media researcher at @gesis_org. Former digital studies fellow at @KlugeCtr/@librarycongress.,1,0,0,0,1,300
443888271,fredayala,Yet another PhD in CS #datascience #bigdata #python #scala #pmpcertified #entrepreneurship. Data scientist at @Rovio. One man army at https://t.co/PAPZc5JvLU,2,0,0,0,2,300
21253578,geistesblitzer,"LOVE-IT, YellowOSM",0,0,0,1,1,249
3233351260,NetSciGuy,,1,0,0,1,2,192
1552901424,ddharo,"No soy un 'data scientist', sólo un sociólogo que programa. A ratos, alguna cosa más. // Analizando redes en @aloha_sc",0,0,0,1,1,175
262557900,miguelfvega,"#WordPress #SEO #FacebookAds @wegaws | New Technologies, Privacy, Organizations Development | #dowhatyoulove in @coworkingSBG | InterNations Ambassador Salzburg",2,0,0,0,2,300
304916518,stefandaume,"Forester, AI researcher, Coder, Digital Naturalist (that order or any other)
Explores #SocialMedia, new #CitizenScience models, ecological monitoring @scitingly",1,0,0,0,1,300
2169114774,AtmaConnect,"Atma is building a movement to empower communities from the ground up. We use technology to empower people to connect, help each other, and take action.",1,0,0,0,1,300
2562016410,bigemptiness,"The Industrial Revolution and its consequences have
been a disaster for the human race.",1,1,1,0,3,53
398987599,A_Rapis,Physicist  (Ig Nobel prize winner) working on complex systems and passionate photographer (see my portfolio  here https://t.co/prYDu0vFyu),0,0,1,0,1,300
1393926458,CChelmis,"Living, thinking, inquiring, tinkering with networked data for social good --
Assistant Professor in Computer Science",0,0,2,1,3,300
3697716563,DataVienna,"We focus on the Science of Data Science | Open for everyone interested in Data Science, Big Data, AI, ML",0,0,0,1,1,300
1096376827164180482,profjamesevans,"Sociologist and Computational Scientist @UChicago tweeting about science, technology and augmented imagination.",1,0,1,0,2,61
112323469,william__brady,"Postdoctoral Fellow @ Yale studying morality, emotion and social identity in online social networks",2,0,0,0,2,300
29987775,nahema_marchal,PhD candidate @oiioxford | ✍️ about digital communication & politics | #disinfo researcher @polbots | previously @dowjones @WorldPolicy | 🥐 devourer,2,0,0,0,2,300
1247724121569382402,WombatCurious,"On a journey.

All things: startups - complex systems - localism",0,0,1,0,1,10
1423946731,kwaters126,"Non-Equilibrium Economic Geographer. Climbing, Yoga, Beer, Hiking, Boats, Bread.",1,0,0,0,1,62
53349895,jamesmiraflor,Student of complexity sciences,0,0,1,1,2,300
2979995302,ManuelSacasa,"Responsable de Ciudades Inteligentes en Telefónica I+D. Profesor de innovación y prototipado en UChile y Unab. Maker, Sibarita profesional y mixologo amateur.",0,0,0,1,1,300
405154732,_screaming_mm_,"Comp. Neuroscience & Data Assimilation @TUBerlin •interdisciplinarist• tweets on neurons, math, complexity, art, climate, sharing economy & overcoming gravity🎪",0,1,1,0,2,300
1244018558348247040,JisungYoon8,"Studies complex networks, graph embedding, and Science of Science. Ph.D. Candidate at Pohang University of Science and Technology",0,1,0,0,1,0
174266927,Bharat26oct,"PhD Student; Biology, UAB",1,0,0,0,1,36
1233436156051718144,tmillington1,"Research Fellow at the University of Edinburgh, PhD student at the University of Southampton. Interested in complex networks and machine learning",0,1,0,0,1,6
239349336,Akshayextreme,,1,0,0,0,1,183
1239239196868567040,apvelilla,"Antropólogo Colombiano. Hierarchies, political organization, cultural evolution.",0,0,1,1,2,53
17905203,epalazzolo,"Program Manager, Army Research Office",2,0,0,1,3,300
2869143802,onelifemax,"Motivation, inspiration, knowledge, science, philosophy, health/fitness/wellness, entrepreneurship, growth, business/investing, books and the good life.",0,0,2,0,2,300
79784122,safemyth,"Sometimes tweeting about #infrastructure, landscapes, design, mobility & digital transformation. Fond of ferments",0,0,1,0,1,300
295634353,EvaNavarroLopez,"Naturally curious and endlessly enthusiastic in maths, control, engineering, network science, computer science, AI, philosophy, poetry, art, music...discovering",0,2,0,1,3,300
870401095998226432,helpurself_gf,𖤐,0,1,0,0,1,300
90871277,sudarshaniisc,"A reseacher, fitness enthusiast, extremely anthropophyllic and a diehard lover of life! Works @ IIT Ropar",1,0,0,0,1,300
28357827,nima87700,I am a researcher working on transforming social networks from its autopoietic artform into tangible science.,1,0,0,0,1,0
97139947,charleswtapp,MD/VP @Stand_Together | @MarsGlobal @Koch_Industries @AppState alum |Anglican+Husband+Dad of 3+Angler+Picker+Oenophile| RT’s & Likes🚫endorsements. #letsgoduke,0,0,1,0,1,300
607187695,Ger_Batista,"Postdoctoral fellow at Harvard University. Hensch Lab. Neuroscience, critical periods and social behaviors.",1,0,0,0,1,300
1235680209728401411,TObservatorium,Real-time monitoring of multi-level network structures for the study of knowledge generation and opinion dynamics on the Internet,0,0,1,0,1,29
1166834304782979072,shriyamite,Passionate about optimization research and applying AI. Tweets may reflect my current views but not my employer's. And RTs just express my intrigue.,0,0,1,1,2,300
911949088303800321,BruceTedesco,"data scientist | AI advocate | supports education STEM changes K-12 |TV, radio commentator",0,0,1,0,1,300
468696087,DeanKorosak,,0,0,1,0,1,224
482088677,BellomoDomenico,"Head of Bioinformatics, Melanoma @SkylineDx. I make a living applying machine learning to biological & medical data. Synthetic biology enthusiast.",0,0,1,0,1,300
3949317869,alex_goritz,Research Associate @UniLeipzig & PhD Candidate @FU_Berlin interests: climate politics | social networks | international bureaucracies | climate change education,1,0,0,0,1,222
1237404013915705344,natamesc,"PhD student at HSE University, Interested in network science",0,0,0,1,1,0
724006529238732800,Fatemehsrz4,Machine Learning/Network Science,0,0,0,1,1,113
749225951909842945,OrdStudent,An Ordinary Student. Visit my blog.,1,0,0,0,1,300
131481660,jmetzcar,Patient-researcher. NSF CNS-NRT Fellow @IUBloomington @sice in bioengineering and complex systems. Interested in #mathonc and neuroendocrine tumors.,0,0,1,0,1,217
1235753586983747585,endCOVID19,"https://t.co/Q9HtIX5BvG is an action network of @NECSI, scientists @Harvard @MIT and volunteers. We educate in order to end the outbreak of Coronavirus COVID-19.",0,0,1,0,1,300
40479887,sumitsrbh,Quant@ING | Reseacher@UvA,0,0,1,3,4,124
107202491,MAE_Center,"Developing integrated approaches for risk, reliability and resilience analysis for natural and anthropogenic hazards.",1,0,0,0,1,300
134687994,shahanalimemon,"Tartan '17, '20.

I study people and their voices by using computers. 
Interested in social computing, voice forensics, network science, and AI for good.",0,0,0,1,1,66
1230346607100485633,novelli_leo,"PhD Student @Sydney_Uni. Interested in complex networks, information theory, and their applications in neuroscience.",0,1,0,0,1,2
17369964,olyerickson,"#rstats #DataScience #WebScience #SemanticWeb #Semantalytics @RPI (Newfound Lake, NH, USA)🐧",1,0,0,0,1,300
873308336120352768,virginia_ahedo,,0,0,0,1,1,300
1591794578,rdomagalski,"Mathematics Ph.D. candidate at MSU 🧮 
Graph Theory & Social Network Analysis 🌈
Husky Dog Momma 🐾 
Plant Lady 🌿
She/Her 🌸",1,0,0,0,1,119
1219658679651381250,TuftsDataSummit,"2020 Nutrition Data Summit @TuftsNutrition 
Feb 28 + 29, 2020
Friedman School, Boston, MA
Register here: https://t.co/h0rEgcXOt4",0,0,1,3,4,24
1227967293478645760,AlexnderChapman,"Ph.D candidate in Sociology and Demography at Penn State
Areas of Research: Substance use/abuse, mental health, social networks",1,0,0,0,1,11
1227657491128946694,khushnood_abbas,I am a researcher interested in network science.,0,0,0,1,1,6
1227460020859801600,DynamicsEmo,Tweets about emotion dynamics in psychology,1,0,0,0,1,26
29471574,luchokool,"Apoyando pequeños empresarios que se esfuerzan por cambiar el mundo. Ing. Químico, Coop Int'l. MPhil Estudios Desarrollo, IDS. Master de Aprendiz. Cine Terror.",0,0,1,0,1,300
399331417,MaxFalken,Complexity Scientist @ Imperial College London,0,1,2,1,4,209
1100407053820940288,zsuemoon,social networks/language learning/kpop,1,0,0,0,1,0
270614452,DrSarahLogan,"Politics of the internet, the information state and homegrown extremism. Department of International Relations, The Australian National University.",1,0,0,0,1,300
17145553,punkstrategy,"AI Researcher. Founder & CEO, Corto. Director of the Project on AI & Neuroscience in Media at USC's Entertainment Technology Center. Nerd/cowboy.",0,0,1,0,1,300
1489206901,Jp_odwyer,"Associate Professor @iBioIllinois, @SimonsFdn Investigator in Math Modeling of Living Systems, @JSMF Complexity Scholar",2,0,3,0,5,300
2855287383,GPforER,"Lecturer @sheffieluni @shefACSE, Aerospace Engineer, Network Enthusiast, man of ideas (cit. from Operation Petticoat)",0,0,0,2,2,300
506010430,AnnaPriante,Assistant Professor @RSMErasmus |Networks-Social media-Collective action-Crowdfunding| Musician | Foodblogger @AromaDiCannella | #MPC2020,1,1,0,0,2,300
97267781,chavalarias,,0,2,1,0,3,300
1248843625,sumanacharyya01,"Trained as Physicist. Study Complex Systems. Interested in Books, Movies, Musics, Running, Swimming and Table Tennis.",0,0,1,0,1,9
805119087689035776,knkl33,Value Investor,1,0,0,0,1,300
1223558910,CyberAbogado,#CyberDemocraciaCo,1,0,0,0,1,300
176077756,johnhearnbcn,"Science and software. Works at @smadex co-founder @cityexp_spain, @cityexp_argen",0,0,0,2,2,300
1032294401651949568,mathematikai,Aspiring quantitative urbanist. Lover of cities & complex systems. @OppInsights econ pre-doc fellow. Math/urban studies @Vassar. They/them.,0,0,1,0,1,81
982750644246384640,SantoshManicka,Complexicist,0,0,1,0,1,182
2738620066,jalawlor2,"Community psychologist. Research fellow @ Umich umsi. I love systems thinking & modeling, social networks, stakeholder engagement, #evaluation, running.",1,0,2,0,3,300
1378576892,HemanShakeri,"Assistant Professor
University of Virginia",0,0,1,1,2,211
416692624,SebinoStram,Fisico,1,2,0,0,3,300
3235512952,marcophrd,"Research Associate at Institute for Manufacturing, University of Cambridge",0,1,0,0,1,65
1204064299225944064,Amazing7071,PHD candidate，interested in #economitric，#social network，#ABM，#spatial analysis，#text anaysis #China,1,0,0,1,2,93
31313008,interintel,"AGI Researcher, Robotics enthusiast, Connectomic Engineer, Neuro-roboticist",0,0,0,1,1,300
351849242,JuliaBrennecke,Reader in Innovation Management @UoLManSchool. Research on #networks and #innovation.,3,0,0,0,3,153
100778935,petererdi,,0,0,0,1,1,259
1202893536246415360,ShilunZ,"I'm looking for PhD position in graph mining, network science, computational social science.",0,0,0,1,1,0
2922691415,pdpenev1,,1,4,2,0,7,300
1113606218180730880,melnetsna,The social networks research group of Swinburne and Melbourne universities,1,0,0,0,1,97
1083092799006875649,ConnectionsSNA,Connections is a peer-reviewed journal of the International Network for Social Network Analysis (INSNA). We publish articles dealing with applications of #SNA,1,0,0,0,1,46
146244593,martinzh,Wir sind die Roboter,1,0,0,1,2,300
3228032934,MishtyMuskan,,0,1,0,1,2,86
377049708,eltrompetero1,"researcher at the intersection of physics and society--using lessons from physical models, ideas, intuitions to look for general principles in human behavior",0,0,2,2,4,300
1195677112918855680,YorkWinner,"WISE Lab, Institute of Science of Science and S&T Management, Dalian University of Technology",1,0,0,0,1,4
3100249258,uvmcems,The College of Engineering and Mathematical Sciences at UVM,0,0,2,0,2,300
3287849094,tolivier9,"Assistant Professor @FAU_PublicAdmin
Public policy, collective action, water governance.",0,0,0,1,1,300
80032895,mmfcordeiro,"PhD student in real-time data stream mining, Data Engineer (kind of) in a private held company. #BigData #MachineLearning #EventDetection #NLP #Graphs",1,0,0,0,1,300
1191110997056139266,RaphN3,Postdoc in network science @criparis • Interested in bipartite networks and community detection • @LIP6_lab PhD alumni,0,0,0,1,1,0
45194738,justinmjones_,Ph.D. student in I-O psychology at The University of Georgia interested in computational social science and teams research methodology.,0,1,0,0,1,300
1328995902,skydetainer,"When you can understand and explain the universe,you’re a smart man.",1,0,0,0,1,300
987565609595625472,AlexeyAOrlov,"PhD in Medicinal Chemistry. Postdoc in chemoinformatics. Interested in chemoinformatics, data science, network science.",0,0,0,1,1,16
1011347184581738496,OnlyTeemoMid,CIBM Postdoc Fellow @ Anantharaman Lab @ UWisc : Complex Systems : Emergence : Biology : Computation : Ferrets : Teemo : They/Them,0,0,3,0,3,300
34401622,camenal,"Democracia, Computação, Direito e pesquisando sobre desinformação.",1,0,0,0,1,158
2294685608,AlBondSportBiz,Sport Management Scholar @Carnegie_Sport I Associate Editor @MSL I @FB_Collective member l @SunderlandAFC Fan I My views only,2,0,0,0,2,300
596643522,MihneaConst,curiosity,1,0,1,0,2,300
3017865323,g_giase,"Data Scientist, DPhil (PhD) in theoretical Physics, BSAC diver, evolution, raspberry pi, drone & LEGO enthusiast, basketball fan",0,1,1,1,3,300
1047251910280065026,jonathanbrathw5,,0,0,2,0,2,300
1160392860832817154,datadreams_corp,un antropólogo mirando,1,0,1,0,2,300
14659319,ArashBadie,"""The hypothesis of vortices is beset with many difficulties.""",0,0,1,1,2,300
211180521,polarbear0627,Previously @UCLA and @Columbia. Political economy of development and institutions; race and ethnicity; stats. Hibernating @Tsinghua_Uni.,1,0,0,0,1,300
2151986323,FSanchezUCR,I have PhD in Biometry. Research in epidemiology and social dynamics. I like video games and fishing.,0,0,1,0,1,300
1616964710,BS_Hartmann,"Sociologist in training @IUBloomington. Racism/race, immigration, boundary processes, and political culture + computational sociology. Golden Gopher. He/His.",1,0,0,1,2,182
86974614,avsolatorio,"Data Scientist — @WorldBank | Machine Learning and AI Researcher | Human

I train little kids inside computers. I wonder how learning happens.",0,2,1,0,3,300
56600197,CWDillon,"Aquarian. Blue-collar computational social scientist. Come what may, come May.",0,0,0,1,1,300
88082111,rita_gracio,"Sociologist (PhD), poet. Interested in how people (re)produce techno-socio-cultural worlds. Interested in arts as active ingredient in everyday life.",0,0,1,0,1,138
699395297118523392,J_B_Winters,"Interested in spatiotemporal information networks. #Complexity, sustainability, geospatial, market dynamics. Consulting in data strategy, network analysis, code",0,1,0,0,1,300
2892489526,econophysicsLAB,"Quantitative economist, specialized in econophysics, chaos theory, nonlinear dynamics, financial markets, bigdata, cryptocurrencies. Retweet ≠endorsement 🇦🇷 🇪🇸",0,0,2,1,3,300
1406419332,eell_p,,5,6,0,4,15,300
1019186841529016322,MarcoPagani1985,"Interested in translational imaging, brain connectivity, statistics and autism",0,1,0,0,1,300
882884848909770752,roalisco,"PhD researcher in Science, Technology and Innovation Studies at @EdinburghUni.
| Collaboration, Social Network Analysis & Zebrafish by conversion.",1,0,0,0,1,251
1003681519335104513,aralu69372938,Physics of Complex Systems,0,1,1,0,2,191
877180385855254532,Kat_Albrecht,"JD/PhD Candidate in Sociology and Pritzker School of Law at Northwestern University. Studying computational methods, data transparency, crime, and pizza.",0,1,0,0,1,242
2299078723,awara_tara,Public Policy Graduate Student at McCourt School,0,0,3,0,3,300
3403467406,brissettecj,he-him / Computer science PhD candidate with a math and physics background / Complex networks / Network dynamics / Parallel computing / Clustering,0,0,0,1,1,24
775894463763755008,Testudinidude,"He/him. Recently minted PhD!!!! Turtle  conservation. Also a dad. Really into 🐸🐊🐢🦎🐍, quantitative conservation tools, nerd humor, and good beer.",0,0,1,0,1,251
50757820,leilabighash,Assistant Professor of Communication at the University of Arizona; PhD in Communication from USC Annenberg,0,0,0,1,1,300
1163182239284379648,angelicasmata,"I'm a physics professor and researcher. I study statistical physics, complex networks and dynamical processes. As a  hobby, I like to run and read.",0,1,0,0,1,9
15579524,jorge_albarran,"Father, mathematician and security professional. I tweet about security, science, AI, data, design, technology, communication, education and art.",0,0,0,1,1,300
277176597,riodesangre,Ph.D. candidate @ucdavis studying power & institutional change in California water. @wur 🇳🇱 @Supagro 🇫🇷 alumn. Running & mountains. I prefer uphills. 🇳🇮,1,0,0,0,1,300
837635778117259264,RickQuax,"Complex systems, networks, information theory, controllability",0,0,6,1,7,167
167420591,ProDataLab,Decentralized Software Systems. Proposing a Modern Software Ecosystem called CodeDepot using Blockchain tech and Flow-Based Programming. OpenSource Advocate.,0,0,2,0,2,300
811349952815398912,milan_janosov,"network science phd candidate at @ceuhungary, former @belllabs and @morganstanley",0,0,0,2,2,91
118229888,ruydg,"Networks and Data Science.

I like Python. I use Emacs.


Postdoc at @elcolmex",1,0,0,0,1,300
25117183,arielstrong,"A Jill of all trades is master of none, but often better than a master of one. Art/music/tech/nature. Still a firefighter/EMT @ heart. Curiosity feeds the cats.",1,0,0,0,1,59
1266763711,kestutis_lt,,0,0,0,1,1,23
329192001,selinzileli,"Ph.D. Candidate in Intelligent Mobility - Royal College of Art,  Intelligent Mobility Design Centre",0,2,1,0,3,300
1110104402449321988,NathalyR_GR,,0,0,1,0,1,297
3016920315,HNR_org,"Network analysis in the historical disciplines: OA Journal, Events, Newsletter & Bibliography.",2,1,0,1,4,300
3942208575,otrasenda_AC,"Lévy walker of life, trying to have #SkinInTheGame and practicing #antifragility",0,0,1,0,1,300
1005198732,joanavirtual,"Leitora? Sim! Cinéfila? Sim! Sonolenta? Tbm. Comilona? Às vezes. Viajante? Sempre!!  Insone? Só à noite. Risada Indiscreta? Imagina, isso é intriga da oposição.",0,0,0,1,1,300
18920924,danielrc,"Software systems engineer U Distrital; artificial life MsC UNAL. Complexity, biology, technology simulation.",0,0,1,1,2,300
74544435,Biswa09,Researcher-The University of Tokyo,0,0,0,2,2,300
3898915157,WendyThorogood,"MSc Animal Behaviour. Researching giraffe social networks and African wild dogs in small reserves. Also love hyena, rhino, elephants and honey badgers.",1,0,0,0,1,264
994157918701441025,alex_smolyak,,0,1,0,0,1,2
2167578054,otrebor_340,Doctor en Tecnología Avanzada,2,2,0,0,4,114
1113909875808116739,adwenturous,Economist @FrontierEcon Data Science for Social Good Fellow @datascifellows #ComplexityEconomics #CausalInference #BehaviouralEconomics #AIforgood,1,0,1,0,2,72
416510292,Anupama_Sharma_,"Mathematician turned experimentalist,
Assistant Prof @BITSPilaniGoa",0,0,1,1,2,141
1118166906756837376,federico_holm,"Environmental policy, social networks, and an endless array of interests [Oh, there's no such thing as a ""climate change debate"", by the way]",1,0,0,0,1,122
1112516210636279808,MACanbaz1,"Assistant Prof., Ph.D. in Computer Science. Understands a little about Network Measurements, Network Science and Data Science.",1,0,0,0,1,97
826808603566813185,uttara_tipnis,Computational neuroscientist in making. Photographer. Foodie. Language enthusiast. Classic rock lover. Climber of non-musical rocks. Inked.,0,2,0,0,2,257
11647652,ccafiero,クレイトン・カフエイロ,0,1,0,1,2,119
3850874475,MetExplore,"INRAE researcher, head of #Bioinformatics group working on #metabolomics and #omics data analysis in the context of metabolic networks. #MetExplore",0,0,0,1,1,300
1695363828,lylengyan,"PhD at MIT. Network scientist working on social science problem. Will join McCombs at UT-Austin as an assistant professor in July, 2020.",1,0,0,0,1,62
800465126,MattBarlin,,0,0,1,0,1,157
1109208593839112194,nophi1ter,Experimental Economics / Computational Social Science / Network Science and Complexity. Engineering Social Systems. PhD Student & Research Fellow @ FSU,0,0,1,0,1,11
850392993852923904,AliciaBarrena,“Alicia through the Looking-Glass.”,0,0,0,1,1,300
1921085773,p_zukiewicz,Professor at @UniWroc. Constitutional law - social networks - gender & queer politics,1,0,0,0,1,300
1161197143,APantelous,"Department of Econometrics and Business Statistics, Monash Business School, Clayton Campus",0,0,1,0,1,122
1126224551363469315,marra_marianna,Associate Professor (Sr L) @SussexUni @SussexUBusiness UK | PhD @AstonBusiness | #networks #science #innovation #patents #VarietiesofCapitalism,1,0,0,0,1,300
532718832,RhodriLeng,Citation network analyst studying citation bias/distortions & evidence use and interpretation. Researcher/tutor @EdinburghUni & author of The Matter of Facts.,0,0,0,1,1,72
1133094734673698816,zonywu2,"Phd students in Beijing Normal University. Interesting field: Network Embedding, international trade network, economy and complex systems.",0,0,1,0,1,0
1126459282197811200,DePersonales,Laboratorio de Redes Personales y Comunidades (LRPC) de la Universidad de Sevilla (HUM-059),1,0,0,0,1,150
1130945249659039744,marten_marius,Graduate program in Cognitive Neuroscience/AI @Radboud_Uni & @DondersInst | Cognitive and Neural Computing | Former @maastricht_fpn & @goetheuni,0,0,1,0,1,132
2815337172,mkuijjer,"Mixed bag of bioinformatics, computational biology, and cancer research. Group leader at NCMM, University of Oslo",1,0,0,2,3,161
1130943810580623361,michellehfeng,Ph. D. Candidate. I do politically inspired math things! (She/her),0,0,0,1,1,6
1009853502108110848,TeresaFarinha2,,0,0,1,0,1,69
983345860129026049,EuritoH2020,EURITO aims to create a new generation of indicators to transform R&I Policy and enabling better decisions with bigger and better measured impacts,0,0,0,1,1,249
187160532,MursaBogdan,PhD student and Complex Networks researcher with a focus on Network motifs. Hobbies: Chaos Theory and Basketball,0,0,0,1,1,16
1444469748,vijayan_priyesh,"Ph.D. scholar at McGill University and @MILAMontreal.
Deep learning for Relational Representation and Reasoning.",1,0,0,0,1,31
3883624217,JBugoni,"Community ecology, species interactions, complex networks, hummingbirds, seed dispersal, Hawaii, Postdoc at Univ. Illinois. 🇧🇷 🇩🇰 🇺🇸",0,1,0,0,1,146
1105636921756340224,boolbinarybayes,"Just another dimensionless theoretical alchemist vibrating within the sonoluminescent spectra, using multidimensional collective consciousness.",0,0,2,0,2,300
223285978,HarryRofl,"PhD from @UTAS_, communication and policy officer at @CAULalert, research associate at @ANUausi. Designer, web developer & data analyst. Views are my own.",1,0,0,0,1,300
738001927040995328,yesmorephysics,어쩌다 인지과학과 time series data를 다루고 있는 물리학도,0,0,0,1,1,157
119448974,tiagomssantos,Developer and complexity science student,0,0,1,1,2,300
2728209696,infoxiao,swe @google geo search. hci/comp social science. previously @cornell_tech @facebook @airbnb. networked trust. ai-mediated interactions [sh-i-ow] views are mine.,0,0,0,1,1,300
212468862,Razzamafaz,All views own. Aspiring to create impactful change. interested in all the levers to enact social change #talkreformtome,0,0,1,0,1,300
423836457,ihuertat,"Computer Science, I love the video games, the cellular automata and I'm Geek from heart...",0,0,3,0,3,300
264232910,vsemesh,,4,3,5,3,15,300
305978886,JaredEdgerton,@osupolisci Currently a PhD candidate in political science. Interested in political violence and social networks.,1,0,0,0,1,66
1118345314581147649,ChunyingFang,brain network,0,0,0,2,2,46
381265375,mcditoos,"Doing a Msc in Physics 
Mainly interested in Quantum foundations , optics and information 
Sometimes I Tweet quotes , sometimes I just retweet stuff",0,0,0,1,1,300
89478386,sandervhaperen,Postdoc / Complex Networks / Social Movements / Digital Sociology / Governance / Leadership / https://t.co/9yMpFem1Dt,0,0,0,1,1,300
1043877694004490240,markditsworth,network science enthusiast,0,0,0,1,1,300
38648816,GheorghePaul,Post-Doctoral Associate-U of Minnesota|Epidemiologist|Global Health|Wildlife Veterinarian|Interested in Zoonoses at Human-Animal Interfaces,1,0,0,0,1,300
3379178554,elenadata,"CS Professor @UICCS. Research in machine learning, causal inference, data bias, social networks, privacy. A night owl turned into a morning person.",1,0,0,0,1,300
384894395,drchangelove,"PhD, focused on social uses of technology for emergency management while trying to have fun along the way",1,0,0,0,1,300
1102922977,Koo_ec,"PhD Student, University of Hull, UK 😎",0,1,0,0,1,107
2872838791,razib7641,"Postdoctoral Fellow, Computer science and engineering,  University of South Florida",0,1,1,1,3,83
303955868,pat_sweeney,Views my own.,0,0,1,0,1,53
76078018,Yesid09,From 🇨🇴/Bioinformatics/Parasitology/Infectious Diseases/ From Protein Diversity to Biological Networks /@UdeA/@rsgcolombia/,0,0,0,1,1,300
1019535224537939968,newapollo__,"Si hortum in bibliotheca habes, deerit nihil.

Math, Statistics. Data science/ML from a risk, complex systems perspective.",0,0,1,0,1,300
82291993,PHCerdan,Dr. in Biophysics. Advocate of open source and open Science. Most of the time working with images and simulating biopolymer networks in complex systems,0,0,1,0,1,242
9756012,PaulBHartzog,"father, husband, programmer, futurist, writer, drummer, musician. Into scifi, lego, panarchy, complexity, ecology, commons, culture, politics, and economics.",0,0,1,0,1,300
1919987095,IceLab_umea,"Integrated Science Lab, Umeå University, Sweden. Connecting Researchers Across Disciplines. Harbor Ice image by Steven Campbell. Posts by members of Icelab.",0,0,0,4,4,300
749337334303383552,markdhumphries,Theoretical systems neuroscientist. Spotted in the vicinity of: basal ganglia; dopamine; network theory; cortex; and sea slugs. Senior Fellow of @The_MRC,0,0,0,1,1,300
948959573205045248,ColettaLudovico,,1,1,0,0,2,253
355654498,marcolin91,"Humans are weird, I blame {🧠} · Structures🕺Spaces · CogNeuroSci🤯 · building bridges

Scattered around science, arts, and contemplative mazes",0,0,0,1,1,300
1104418255639404545,changzhen_wang,"PhD student in Geography, focus on social network analysis in transportation and public health",0,0,0,1,1,25
1032606539981434880,ScottBee11,"Mathematics PhD Student, who focuses on epidemiological modelling and the forthcoming weekend. 👍",0,1,1,0,2,94
1049108661308669952,lalunanueva78,A human being.,0,1,0,0,1,162
3247866682,Steven_r_72,,0,0,1,1,2,300
1103390639977365505,ThosVarley,"#ComplexSystems & Computational Neuroscience PhD Student, @IUBloomington. @CNS_NRT fellow.
MPhil, Cambridge, Clinical Neuroscience 
#Consciousness #Networks",0,1,4,1,6,300
498272322,Lindanbaum,"human rights, narrative persuasion & social media; research assistant + PhD candidate @Viadrina & @CIHR; co-founder @fc__org, project lead @dhrlab",2,0,0,0,2,300
3010426722,PattMeeples,Archaeologist and Associate Professor of anthropology (archaeology) in the Arizona State University School of Human Evolution & Social Change.,0,0,0,1,1,300
27412566,andrewlamb77,"Digital strategist interested in data, networks, web design, photography, food, London & buying more books than I can afford or store.",1,0,0,0,1,300
12277612,szhorvat,"complex systems, interdisciplinary physics, network science, brain networks, nature photography, Mathematica, Wolfram Language",0,0,1,1,2,300
4708024889,nomadicturk,"Of,Istanbul, Boston. @RobertCollege. @Wellesley. @SOAS. Social&Economic Networks. Digital Media. This world was not supposed to be home anyways. RT≠Endorsement.",1,0,0,1,2,300
993864381107601408,StuartJOldham,PhD student slaving away at brain connectivity at @BMH_Lab,0,3,0,1,4,184
579371308,Spacegirl220212,,0,0,0,1,1,97
618542250,fengzhimu,Complex (Bio)Systems | Evolution | Control | Design,0,0,2,1,3,300
258030141,AmyJaneODonnell,"Faculty Fellow, Newcastle University. Substance use | Implementation science | Data science | Mixed methods research. All poorly articulated views my own.",0,0,1,0,1,300
19318816,vwendy,Ph.D. candidate in the Dept. of Human Development and Family Studies at Penn State. Interested in applying network science on everything ;),0,0,1,1,2,43
1095739820817727488,ghscosta271,"PhD student of Physics at Federal University of Viçosa. In search of the Fundamental Question to Life, the Universe and Everything Else.",0,1,0,0,1,26
1091437305389350912,Masoud73887234,Researcher in complex systems,0,0,1,0,1,6
1094328305459843074,kak680,,1,0,0,0,1,7
1007101819154194433,phdStudnt,A phd student lost in his big dreams. Seeking the way to success.,2,0,0,0,2,238
1093238283541405696,joelleau1,,2,0,0,0,2,7
26510538,michaelweissca,"Associate professor in the @timprogram at @carleton_u. Teacher, mentor, occasional writer, innovator, and long distance runner. CEO of http://t.co/JS6ukXD81M.",1,0,0,2,3,300
1090299796764676101,AidaFranco212,,1,0,0,0,1,8
2778483506,farhanaminpk,"Passionate Researcher. Area of interest is Data science,Network science ,Big Data and Graph theory. Love to explore the beauty of nature and history 😃",0,0,1,0,1,276
91112909,satuelisa,,0,0,1,1,2,300
68056693,divi_lekha,,0,1,0,1,2,31
913050243788353536,lixiande2007,,0,1,0,0,1,8
728595932305076224,netphys1,"Canada Research Chair II / Director Brain Networks & Neurophysiology Lab/ #Neuroscience, #Pain, #Climate #philosophy #Academia",0,0,1,0,1,300
705499008559611904,Martin_A_SPHSU,PhD student studying alcohol and drug recovery communities,1,0,0,0,1,300
1641202350,IJRoIJals,"Brain, and Complex Systems scientist                          ...and anything in between!",0,1,0,0,1,159
144720064,JinuCarvajalino,"Colombian lawyer. Human rights, international criminal law and transitional justice. PhD candidate at @DurhamLawSchool interested in Complexity Theory.",0,0,1,0,1,81
300876776,andrasonea,Politics. Financial Services. Maps. Technology. • PhD candidate @WISCWarwick #spatialanalytics #networkscience • Solution Architect at @Fintech_OS #fintech,0,1,0,0,1,300
1080431555565285376,ConsultComplex,Scientific consulting business using Big Data and complex networks for understanding human cognition.,0,1,0,0,1,300
14250258,pkondzior,"Passionate about programming languages, software engineering, science, neuroscience and geopolitics, watch out for my multilingual tweets.",1,0,0,0,1,300
2411551568,egoweb2_0,This is a twitter account for providing updates about EgoWeb 2.0 which is software for collecting social network data. Maintained by David P. Kennedy.,3,0,0,1,4,147
240220267,DanielBorrasM,,0,0,1,0,1,300
975079716259581952,k_ramali,Social Data Researcher-Data analyst |Focus on Libya/Mena |MA @SOAS| @ImperialCollege Alumna| RT ‼️Endorsements| opinions my own| https://t.co/G6Mxcl355p,1,0,0,0,1,300
999711751594741760,N3Initiative,"""Networked Science for Networked Cities""
New Initiative @NorthwesternU @IPRatNU leveraging the science of networks to make our neighborhoods healthier and safer",5,0,0,1,6,300
1125647276,VergotteG,"Postdoctoral researcher, ISAE-Supaero. Brain and behaviour, connectivity",0,1,2,0,3,300
962992867990892544,Herlobster1,无故加之而不怒 猝然临之而不惊 严于律己 宽以待人 美到极点 好好学习,0,1,0,0,1,30
802934549630033920,kesm_ith,UKRI innovations fellow @ University of Edinburgh. Theory of biological networks and health data science. Opinions of nobody.,0,2,0,1,3,146
1378594146,discombo_bulate,I try to grok things.,0,0,1,1,2,300
1954814149,andre_lhu,"I use robots to study cyborg societies.
Assistant Prof. of CSS #DataAnalytics @HarrisburgU.
#socialinfluence #tech #informationsociety",1,0,0,0,1,300
2987884727,MathisintheAir,Blog on Applied Mathematics | Blog divulgativo di matematica applicata .,0,1,0,0,1,300
397475407,kronglc,,2,1,0,0,3,287
81485025,AlejoBernardin,"Physicist, free software lover and cyclist.",0,0,0,1,1,300
831077559299346432,B_Lindstroem,"Researcher at University of Amsterdam. Social learning, computational modeling, reinforcement learning mechanisms in social behavior.",1,0,1,0,2,300
3005996199,Anna_De_Simoni,GP and Clinical Lecturer at  @QMULBartsTheLon. Online #peersupport for patients with #longtermconditions through #onlinehealthcommunities,6,0,0,2,8,288
1000030443453014016,yuanyuan_2,"PhDc @MIT (@mitidss, @medialab). Curious about how computational methods (causal inference & machine learning) help understand economic behavior and networks.",3,0,0,0,3,88
397909798,giacomolivan,"EPSRC Early Career Fellow in Digital Economy, University College London",1,1,4,1,7,300
1024830987811807232,LangLEvoI,"MRes student @CLSRadboud & intern @mindlabs2
#LanguageEvolution #Dialectology #NLProc",1,0,2,0,3,298
7876232,mohsaqr,"Academia, Analytics, Network analysis, Neuroscience, works @UniEastFinland @stockholm_uni formerly, @criparis @inserm",0,0,0,1,1,300
2573903549,alsurina,,0,0,0,1,1,51
1973058649,zpneal,"Undisciplined #networkscience & #urbanstudies @michiganstateu a/prof. I connect dots with lines, and maintain https://t.co/IRceSlw9AK & 𝚋𝚊𝚌𝚔𝚋𝚘𝚗𝚎. Also, wine.",1,0,0,1,2,300
754099967040577538,SoulCosmo,,0,1,2,0,3,300
783921780733935616,Waydze1,"Ex-researcher, ex-Elsevier employee, latent Left, #rstats neophyte. Allergic 2 fascist, neocolonial & discriminatory rhetoric. Hatemongers will have no empathy.",0,1,0,0,1,300
17637947,_jesusmcortes,"Researh Professor at @Ikerbasque and @upvehu. A combination of physics, machine learning and image processing applied to neuroscience and medicine",0,0,0,1,1,300
105513349,cristophersfr,MSc. Student in Network Science and Engineering,0,3,0,0,3,300
24371728,richardclegg,I am a lecturer in Networks at Queen Mary University of London and an amateur Scuba instructor. I find it best these activities are not performed concurrently.,0,1,0,2,3,300
83456590,carstenmurawski,@unimelb decision scientist,0,1,0,0,1,300
1005482708066340864,maximelca,"Physicist playing with complex systems and networks. Lover of many things. Curious about everything.

@univAmu and @centuri_ls.",1,1,1,1,4,117
797108811186262017,JonathanJCroft1,"Complex networks, dynamical systems and computational neuroscience",0,0,0,2,2,240
1048281553401516032,siragerkol,,0,3,0,0,3,5
942720522491744256,amanuel_herrera,"Research Associate in Distributed Intellig. Systems at @IfMCambridge - @Cambridge_Eng. Interested in #Complexity, #NetworkScience & #Criticalinfrastructure",0,2,1,0,3,300
1903640552,OpenMOLE,"Try OpenMOLE to run, explore, diagnose and optimize your numerical models, taking advantage of distributed computing environments. It is free and open-source.",0,0,1,0,1,221
311355919,Pirri_Mayo,Research fellow in Management of Innovation and #DataScience | Work on #RareDiseases #DigitalHealth #OpenData #HealthEconomics,0,1,0,0,1,300
1025625999998951424,BordesCamille1,PhD student @BarIlanUniversity | behavioural ecologist | animal social network | fear ecology |,9,3,0,1,13,300
297755371,juancsherrera,"Food networks, food recipes, data science, network science, organic food, food + city. NYU",1,0,0,1,2,300
482327389,InDolven,"Pigeon lady for research purposes: PhD student at Odum School of ecology, studying pigeons collective behavior.",1,0,0,0,1,300
971700554618597377,battle_fisher,Systems Thinking | Bioethics | Public Health | TEDxDartmouth | Author of Systems thinking and health 📖 | poetry | photography,1,0,0,0,1,300
980724144940691456,theahouse10,MRes+PhD student researching body perception at Macquarie University.,0,0,0,1,1,136
904265566415937536,SrebLetina,"PhD candidate in Network Science, PhD in Psychology,
believes in scientific potential of the combination of (❓❓❓suspense...) network science and psychology ▶️",4,0,2,3,9,300
148116431,dapr12,,1,0,0,0,1,282
976105732994228225,CNE_EBS,"The Centre for Networks and Enterprise at @EBS_Global, @HeriotWattUni, Edinburgh Campus. Facilitating network analysis research for the business community.",0,0,0,1,1,43
2666001037,CritMemr,,0,2,3,0,5,256
1024401396521754630,TeagueRHenry,"Post doc at UNC-CH. Quantitative Psychologist: Networks, neurons, and central limit theories! Author of the netjack #rstats package.",1,0,0,0,1,300
41155612,ChrisTokita,"Computational biologist studying social organization & societies, @Princeton PhD Candidate • Fmr: S&T Policy Institute; NJ Govt • @Yale alum • Angeleno • Hapa🤙",3,0,1,0,4,300
1031918044354736130,HSB_Lab,We're based @penn_state researching how humans produce emergent social phenomena and studying the bases for violence and warfare. Headed by Luke Glowacki,1,0,0,0,1,261
875277400099180545,martonolbei,"Earlham Instute, Norwich | PhD Student @KorcsmarosLab | Networks, Salmonella, Genomics",0,1,0,1,2,300
1720066448,CEBuddenhagen,"family, sound science, biosecurity (pests, weeds & diseases), plant evolution, biodiversity, network analysis, primary production, collaboration 🇳🇿🇺🇸",1,0,0,0,1,300
1027180042491768833,ResilienceTAMU,"Urban Resilience, Networks, and Informatics Lab I Zachry Department of Civil Engineering I Texas A&M University",3,0,0,0,3,64
4178632847,DJacoby_Marine,"Research Fellow, social and spatial ecology of #sharks, #AnimalTracking, #Networks, love music, love sport, love books. Based @ZSLScience views my own",0,0,0,1,1,300
2563924602,GaryLin89,"postdoctoral fellow @HopkinsMedicine, systems thinker, engineer, data scientist, computational modeler, complexity researcher, and disc golf enthusiast.",0,0,1,0,1,45
1025591659365638144,LDLord13,brain dynamics • networks • complex systems • consciousness •  @UniofOxford • @CIHR_IRSC • @HertfordCollege • @HedoniaResearch 🇨🇦🇬🇧🧠,0,0,2,0,2,129
872266923869917188,BriquetBen,"Deep interest in statistics (and its misuse), evo psy and complex systems. Self-help junkie, finally starting to take action.",0,0,1,0,1,0
722685439690326016,SHIRESBASTIAN,🤖🤖🤖 Know nothing at all.,1,3,0,3,7,290
745286282142593024,SarukZ,,0,1,0,1,2,300
1006934525379825664,a_researcher_,Researcher in complex systems,1,0,3,0,4,154
3045030351,wlcota,"Born and raised in Twitter in July 2009, now I return. PhD candidate of Physics. Epidemics and information propagation on complex networks. 🇧🇷 UFV | 🇪🇸 UZ",0,1,0,0,1,300
384811761,DescartesSRF,,0,2,0,0,2,230
109258239,nagayaman,大学教員/経営学者。創造性の研究をしています。ツイート内容は所属と関係ありません。Associate Professor at Hosei University. My research interests are organizational/team creativity.,1,0,0,0,1,300
523241142,JusteRaimbault,"Research Fellow at @CASAUCL in #UrbanSimulation
Associate researcher @ISCPIF, @OpenMOLE and #EvolutionaryComputation
#ComplexSystems #UrbanSystems",1,0,3,0,4,300
56125869,dmonsterman,"Physicist gone social scientist studying human interactions in vivo, in vitro, in silico at Aarhus University.",1,0,1,1,3,300
1435868238,daniel_keske,"Machine learning and Data Science enthusiast. Interested in deep learning, startups, and what makes people happy. Studying Master Web Science in Koblenz.",1,0,1,0,2,300
2448485714,NicoArmansin,Interested in why animals behave the way they do. Confused about why humans behave the way they do. PhD: wildlife epidemic models using social network analysis,6,0,0,0,6,300
1002621855046471681,valdanchev,Postdoctoral Scholar @METRICStanford | Computational Meta-research & Sociology | Networks | Data Science | Reproducibility & Replicability | Open Science,0,0,0,1,1,80
277974043,tsohahost,,1,0,0,0,1,300
807648096121339908,KorinnaAllhoff,"Physicist who has fallen in love with #ecology. 
Tweets mostly about #TheoreticalEcology, #EcologicalNetworks, #EcoEvo & #WomenInSTEM. 
Assistant prof @uni_tue",0,0,1,0,1,189
85302647,PatrickSteyaert,"Upstream, Customer, Discovery and Improvement Kanban; Creating value for your customers through meaningful work; Okaloa Flowlab - flow needs to be experienced",0,0,1,0,1,300
462500972,FerAlatriste,"physicist, Professor at the master in complexity sciences , Autonomous University of Mexico City",0,0,4,1,5,300
1009158503901138944,Iehchel,"Statistical physicist, network scientist and genomicist with a tint of theoretical biologist.",0,0,1,0,1,300
56366462,ElbertMacau,"Full Professor at Federal University of Sao Paulo (UNIFESP) at Sao Jose dos Campos, SP, Brazil. Research area: nonlinear dynamics, chaos, complex networks.",0,2,0,0,2,300
33555058,sbmrtnz,PhD Student Statistics - University of Glasgow.\\ Go fun yourself\\ Glasgow-Berlin-Bogotá,0,0,0,1,1,300
45969214,AlduCornelissen,"I come from Koekenaap, simply because someone has to. Data Séantist. Fractal from center.",1,0,0,1,2,300
907812392213630976,ED_STAR_,,0,0,1,0,1,188
1281383443,GaalBernadett,"Senior editor of @NatureComms. Systems and computational biology, aspects of complex systems. All views my own.",2,3,2,1,8,300
720545088225587200,Connected_Data,"Connecting Data, People & Ideas since 2016. Using relationships, meaning, context in Data to achieve great things #KnowledgeGraph #GraphDB #AI #semantic #tech",0,1,0,0,1,300
996320797625958400,LimaoEmperor,,0,0,0,2,2,95
87796783,maticgoran,Innovation Strategist | Co-Founder at Chaordic Design | OCAD U SLab,0,0,1,0,1,300
64683266,Chiaronzia,"Interested in science communication, biology and mathematical modeling. Fighter for equality and diversity. Co-founder of @MeMicroscope",0,1,0,0,1,300
984335903060578304,AndreeaNita11,"Environmental Researcher @ University of Bucharest
Governance | Conservation | Network Analysis | Environmental Policies |",1,1,0,0,2,109
2444978305,UnFrederic,C'est pas facile mais prend ton temps,0,0,0,1,1,100
997209232884805632,BrainComputing,"BrainComputing: Theoretical Neuroscience and its Applications
Conference on Complex Systems 2018. #CCS #Neuroscience #DeepLearning #ComplexSystem #Greece #Brain",0,0,2,0,2,46
293552287,k09ht,Wherever the road goes we will always find our way.,2,1,3,0,6,300
222777271,tanvvu,"PhD Candidate, Hasegawa Lab, UTokyo",0,1,0,0,1,68
15614600,MattPirkowski,"Bringing Order to Chaos, and Chaos to Order.

Transmittere in memoria.",0,0,1,0,1,300
23979935,ankushoriginal,Computational Biologist interested in integrative inferences on multi-omics data in cancer. Perfecting  the art of making Indian masala team #genprot ¯\_(ツ)_/¯,0,1,0,0,1,300
73704272,josemanuelp0,"Emprendedor, programador, aprendiz. / Entrepreneur, programmer, learner.",0,0,1,0,1,300
734426409993670657,bioshapes,,0,1,1,0,2,131
22403036,sroecker,"data scientist / ex particle physicist @CMSexperiment @CERN / private account, all views and opinions are my own.",1,0,0,0,1,300
14278719,yanivdover,"Assistant Professor @ JBS, The Hebrew University",2,1,0,0,3,191
982719351244472320,cryptoecongames,"COO, @KommerceTF / occasional cryptoeconomic game theorist / interests: networks&information, transactions, 
formation, asymmetry, economics, failure states",0,0,1,0,1,300
747591747950215169,mora_castro_ba,PhD in Anthropology - CONICET - UNAJ - Health Care Systems Research - Social Network Analysis,1,0,0,0,1,190
858112071505895424,chfan1993,Networks - Data Analytics - Social Science - Urban resilience - Sustainable infrastructure,1,1,0,0,2,79
971075024693084162,metheney_erica,Statistician for the Program on Governance and Local Development at the University of Gothenburg.,2,0,0,4,6,268
984793295564881921,AnagatVidhaata,Curious. Retweets are bookmarks.,0,0,2,0,2,300
982778943949303808,complex_park,"hic et nunc
Network science for infrastructure resilience",0,0,1,0,1,145
830375762,paolapesantezc,"Professor at Universidad de Cuenca. PhD, MSc in CS. Engineer. #Bioinformatics #GraphAnalytics #Math #WomenSTEM. Data scientist in progress. Software developer.",1,0,0,0,1,300
979754698176696320,IRCSNS,اخبار و‌ موضوعات مورد علاقه محققان ایرانی در زمینه سیستم‌های پیچیده،  علم شبکه و علوم اجتماعی محاسباتی,4,1,1,1,7,202
27491678,Rudolf_Angeli,Antiquariat // A Passion for Books,1,0,0,0,1,300
165905874,brandonlkramer,"postdoc @UVA_BI. i use network science, ML, NLP & STS to study diversity/inequality in health, science & tech. he/they.",1,0,0,2,3,300
931967049789792257,AI_ilachinski,"I straddle two worlds: one grounded in science (complexity/AI), the other, in art (photography). This page is focused on the more scientific pursuits.",0,2,2,0,4,300
19198693,christophavila,"AWS Solutions Architect

""I work for @AWSCloud & my opinions are my own""",0,1,0,0,1,300
854274580504031233,AlexanderNBrand,"Sociologist | Bamberg | Data Enthusiast | Researcher Human-Computer Interaction Group @unibamberg | #python, #rstats, #data",1,0,1,1,3,178
99449135,xin_zhi_zhang,"Assistant Professor, Dept. of Journalism, @hkbaptistu. On political communication, computational journalism, and digital popular culture. Alum @CityUHongKong.",1,0,0,0,1,254
2436484735,ceciletamura,"Pres. & CEO Okasaki Tech Holdings, Managing Dir Airily Corp., Country Dir MakeItMedia,  tech evangelist , founder, startups, accelerators, energy",1,0,0,0,1,300
3920955269,vmbotwin,,0,3,2,0,5,300
3011222470,marianagmmacedo,,0,0,0,1,1,2
31762096,CecileBothorel,"Research on attributed social networks, communities detection on social media",3,0,0,1,4,300
68644956,mdeske,"Network biologist MD, PhD, postdoc/ Use networks to deal antibioitics resistance, UC and rare diseases/Magic the Gathering fan",0,0,0,2,2,300
956949936704249857,ReconNeCT_USP,RECONstruction of NEtworks and predicting Critical Transitions.  The project is supported by @iserrapilheira  at @usponline and directed by @TiagoMaths,0,2,0,0,2,46
960523692630474752,physicsofdata,"Master of Science in Physics of Data.
Social policy Unipd https://t.co/bqH9le2XZM",1,0,1,0,2,102
970229427253559296,sabsconstantino,Informatics PhD student @IUBloomington @IULuddy | complex (mostly social) networks and systems | from 🇵🇭,0,0,1,0,1,20
367150813,amanahramadiah,PhD Student at @uclfincomp. Currently working on systemic risk in financial networks.,0,0,3,0,3,300
4638316322,RachaelMilwid,PhD candidate. Disease modeller in the Epidemiology department. Dog lover.,4,0,0,0,4,68
70371720,rongwangsna,"Assistant Professor at Department of Communication, University of Kentucky, researching issues on social networks, technology, & organizational communication.",3,0,0,1,4,300
966951648512888833,sbegusic,PhD student in computer science. Trying to teach machines (and myself) to do financial stuff.,1,0,0,0,1,44
955113738620809224,SergioGomezJ,Networks everywhere!,0,0,1,0,1,147
504803544,bio_diverse,Dad | Scientist @McGillU | #biodiversity change and it’s impacts on society | Director @csbq_qcbs | EIC @Oikos_Journal | @LEAP_sci | Entrepreneur @Eco2Urb |,0,0,1,0,1,300
411770253,ReiRabb,"Assistant Professor of CS, McGill; Canada CIFAR AI Chair, Mila; interested in all things connected, network science, data mining & machine learning.",0,0,0,1,1,32
965944656453398528,j_schoenbrunn,Organisational developer and researcher in inter-organisational group processes & networks @UniofGreenwich //  Organisationsentwicklung // Marketing // Design,0,0,0,1,1,34
288153999,matzlo,Developer and phd-student @gesis_org | Admin of @gesis_gitlab | Research in RDF data management | clean code first! | sailing instructor @hhu_de #hochschulsport,0,0,0,1,1,300
2590,dangrsmind,"Applied mathematician, chaotician and graph theorist gone wrong. Lecturer, computational futurology. One of the original thymonauts, Prescience HFC team.",1,0,0,0,1,300
962271223844622341,ComplexSystemAI,,0,0,2,0,2,3
326122681,mmolinamaydl,"PhD student in Sociology, Cornell University",1,0,0,0,1,83
761799570426765312,vosonlab,"Virtual Observatory for the Study of Online Networks (VOSON) Lab, Australian National University",0,0,0,1,1,111
959564071975735302,elena_m_tur,"Investigadora en Holanda. Hooked by diffusion in social networks, psychological simulations, and sleeping beauties.",1,0,0,0,1,274
846084560,smbroome,"Research & social innovation. Community, mental health, social networks, ageing, recovery. Visiting Prof/consultant/therapist & managing @2seasHAIRE in E Sussex",5,0,0,0,5,300
818529,CMS3rd,Engaging / humble techie/ 3D Director and Producer /web evangelist expert on social networks and network science and digital art and most all technology -,2,0,0,1,3,300
1408123332,georgepanago5,CS PhD candidate @dascim_polytech @Polytechnique working on network science and machine learning. Previously research & teaching assistant @UHouston,1,0,0,1,2,98
733181629993091073,UniSimplexity,"As Simplicity, Complexity & Chaos co-exist, a Nature-inspired pragmatic problem-solving approach that exploits universality, emergence, uncertainty w min effort",0,1,1,0,2,300
1510919082,MitchellSNA,"Mitchell Centre for Social Network Analysis, Manchester. A interdisciplinary research group interested in #SNA theory, applications, mixed-methods and modelling",9,0,0,0,9,300
956286280047902720,theCaINlab,A research lab by @MBouchardCrim and his graduate students @sfucriminology. Tweeting about #networkedcriminology.,5,0,1,0,6,250
2230310916,_K12345_,,0,0,1,0,1,159
2927307373,anwarsaid135,Graduate student @ Information Technology University; Ex-programmer; graphs; machine learning; complex networks.,3,1,0,0,4,134
1217118984,leofn3,"Professor at the Institute of Science Technology and Innovation, Federal University of Bahia
LABHD - Digital Humanities Lab
#DigitalSociology #CAQDAS #Rstats",0,1,0,0,1,300
184032232,parklize,"Research Scientist @BellLabs. Previously @socialsemantics @insight_centre (formerly @deri), and #hyundai #mobis",1,0,0,0,1,300
952947716392275968,Black_cityU,No special,1,1,0,0,2,57
588130750,zxzok,"scientist, network science, graph theory",0,0,0,1,1,59
1456487114,WeisiG,"Chair of Human Machine Intelligence - Cranfield. Using ML👨‍💻& complexity 🦑: infrastructure, communication, conflict. Ex: Cambridge, Warwick, Turing Fellow.",1,0,0,1,2,300
822469056901091328,showmesociology,Encouraging MU soc 1000 students to share sociological insights with one another and to connect class concepts to their everyday lives.,1,0,0,0,1,260
249156491,KesterRatcliff,Former biologist turned online social networks researcher. Advocate for refugees and against authoritarianism and nationalism. Queer 🌈 Catholic humanist.,2,0,0,0,2,300
771669953028104192,DanEllisScience,"Data Analyst, Scientist and Visualisation Programmer; Atmospheric `Chemist` and occasional misanthrope :/ Views are my own.",1,0,0,0,1,300
737359492283797504,ZelminaL,"Researcher in bioinformatics at University of Skövde, handbollsmorsa. Tweets about research in biomarker discovery, personalised medicine, AI, handboll...",1,0,0,0,1,300
436255679,aakos_m,"Doing that thing. Research fellow at the Department of Government and Public Policy, Centre for Social Sciences, Budapest \\ @ceu alum, PhD",1,0,0,0,1,300
408779704,Massi_Pasqui,"Physicist, Atmosphere scientist, biker ... a Ducati biker actually.",0,0,0,1,1,300
4853798219,KrutiVekaria,"Behavioral Science @lirio_llc, @Georgetown PhD + @USC alum. Using #behavioraleconomics + #cognitivescience to improve decisions + behavior.",3,0,0,0,3,300
2682697944,dhama_sakshi,Always thrive to create your own space cause the boundaries are created and measured by minds living a comfortable lie #SocialNetworks #complexnetworks,7,0,0,1,8,247
937390732922490880,cosmo_bird,"IndieResearch,NoPhD,Designer,Hacker;GIS,Complexity,ABM,NOT,OSM,FOSS,FOSH,Open[ScienceDataResearch]https://t.co/DaKBoSCRrP, https://t.co/dRyMg2SvJV",0,0,1,0,1,300
2766227690,leonardoivanrc,https://t.co/DS4xdC5FKQ • https://t.co/oKYARubCgF •,0,0,2,0,2,300
2165258262,jacopo_80,"interested adaptation, transformation and resilience of complex adaptive systems.

Tweets are my own.",1,0,2,1,4,300
255298853,Mostafavi_Ali,"Assistant Professor. Civil Eng, Texas A&M, Researcher of Urban Resilience, Complex Systems and Networks, Disasters, Smart Cities @ResilienceTAMU",2,1,1,1,5,300
221381860,diogofpacheco,Um eterno aprendiz...,0,0,0,1,1,262
1250096852,SmithMatt90,m.smith@greenwich.ac.uk,5,0,0,1,6,300
3341694263,mathiaswullum,"Associate Professor, Department of Sociology, University of Copenhagen",1,0,0,0,1,279
39765069,eronlloyd,"Eron Lloyd is the COO of @mawcominc, a telecommunications engineer, and geospatial data scientist.",0,0,0,1,1,300
29626001,MariaSimoneau,"Project Manager, Harvard Chan. After working @  networking companies, love applying networking concepts to society&health. We’re all interconnected.Tweets mine.",0,0,0,1,1,300
3337300840,AskvividXet,"Her şeyden biraz biraz .. curious,self-learner, hardworking, and questioning. Fascinated with intersection of life, technology, science & maths..",0,0,0,1,1,300
919469476835291136,YusukeIde1,ランダムグラフ，量子ウォーク，複雑ネットワーク，グラフスペクトル，グラフフーリエ変換，量子アルゴリズム，機械学習，無限粒子系 などなど，グラフ（ネットワーク）そのものや，グラフ上の確率モデル・量子モデルに興味を持って研究しています．,0,6,0,0,6,300
735998316614279168,tylerdell6,"MLIS student @IUPUInformatics and developer at @sunapsisteam 
Digital libraries, ontology, social informatics, and philosophy of information and computation",0,0,0,1,1,269
924360589476065280,Kaysonfakhar,"PhD student @ICNS_Hamburg, causality, biological and artificial brains, epistemology, and breaking stuff to see how they were working.",0,0,1,1,2,300
18809341,PlexusInstitute,"A Professional Network interested in addressing real-world challenges through understanding, practicing and advancing principles of complexity.",0,0,1,0,1,300
412720637,LuisMColonPerez,Physicist and neuroscientist 🤓 at UC Irvine. I try to study the brain using MRI and network analysis 🧠. Puerto Rican 🇵🇷,0,2,0,0,2,151
912817448029581312,RSevillaE,,0,1,0,0,1,90
900504243660099585,MagaliALopezC,,0,1,0,0,1,54
331913125,DrCCostelloe,"Senior Lecturer and NIHR Career Development Fellow @ImperialSPH, Director @DigHealthImp, #stats #digitalhealth #AMR",1,0,0,0,1,300
2935395411,BabuAdhimoolam,"Visiting Research Associate, Department of Psychology, Biomedical Imaging Center, Beckman Institute, UIUC.",0,4,2,1,7,300
916697075018092547,jayati2512,"PhD Grad student at @IIITB_Official. Interested in Autonomous Systems, Multi-Agent Systems, Network Science and Game Theory.",0,0,1,1,2,210
2304177918,amdavadiprof,"@Purdue #Student, #Reader, #Explorer working for exploring and #learning #innovation #networks at #grassroot level",2,0,0,1,3,300
3312886389,NeuroGabriel,"NeuroImagingScience for everyone! 🧠Sharing basics and advanced research on brain analysis (PET, MRI, EEG, fMRI, ...)
https://t.co/Y6ueQKgxX8",0,1,0,0,1,300
915980235887251456,cika_arta,PhD at @UniofOxford | Scientist and math enthusiast | #TechWomen100 award winner | She/her,1,1,0,0,2,291
452869995,Latemoon_Jc,Focus More,1,0,0,0,1,3
2441491405,j3r3mg,"PhD student @AramisLabParis, @upmc, @icm_institute - Multimodal Brain Connectivity, Neuroimaging, Multilayer Complex Networks, Graph Theory.",0,0,2,0,2,143
123641749,GalinaEW,1987 | MSc Public Administration & MSc Psychology | PhD Multilevel Networks in Healthcare | Radboud University Nijmegen |,1,1,0,1,3,300
2220997760,katerinabohlec,Founder of Communication & Culture map. Mother to 4 wild girls. My scout name was Bison. I'm still roaming the world looking for a place to call home,1,0,0,0,1,300
903272047316525058,DCardoso_72,I'm Veterinary. I've my hobby to take a pictures and to study complex network.,0,1,1,0,2,84
769657994,gaurangsyadav,"I am made of little rooms, full of thoughts, emotions and memories. You cannot define or get me by just listening to me. I am too complex.",0,0,1,0,1,170
21385600,ossimokryn,"Researching Data, Information, Networks - and how to connect them. https://t.co/h80pEPZ5Fi",1,0,2,2,5,300
1079945316,Mark_McCann,"Research Fellow at the MRC/CSO Social and Public Health Sciences Unit, Uni of Glasgow. Mental health, substance use, social networks, complex systems.",1,0,3,0,4,300
832067063619448832,kimsev1,"Putting energy and passion into leadership, business development, client relations, and community engagement",0,0,5,0,5,300
109681112,lion_house,"Data science reseacher, working on machine learning.",0,0,0,2,2,153
3874532295,bapalto,"PhD, Artificial Intelligence and Deep Learning Researcher, Senior Lecturer, 
LinkedIn: https://t.co/BH5Rcw5gF6",0,1,0,0,1,300
2780008599,aristotletruth,"Physics PhD, Complex Systems, Machine Learning, CrossFit, Coffee. ETHZ, Switzerland",0,1,0,0,1,18
32739727,AnitaKeshmirian,"Neuroscience PhD Candidate, LMU, Munich. Interested in collective/moral decisions. pre: Computer/Cognitive Science-Neuroscience in Berlin/Bordeaux/Boston/Tehran",1,0,0,0,1,300
35014165,jkpaulin,"Researching complex financial systems, networks and algorithmic trading",0,0,2,1,3,300
160223198,justinpcoon,,0,1,0,1,2,81
809749684205948928,sensorcomm12,,1,0,0,0,1,232
180429399,calvin_zcx,"Ph.D. CS, AI, Data Science",1,0,0,0,1,177
869817339826413568,mponthiru,,1,0,0,0,1,97
230305971,taku_ito1,"Neuroscience PhD student, Rutgers University",0,1,0,0,1,300
336219960,bettstetter,"Professor https://t.co/IaPL7Da4zg • Scientific Director @lakeside_labs • Grad @tu_muenchen • Networked + autonomous systems: wireless, drones for good, self-organization.",0,0,1,0,1,300
15889892,venky_nk,"Agile, Lean, Systems Thinking, Complexity Science",0,0,1,0,1,300
31413346,lonardu,Postdoc at @INPE_MCT and a visiting scholar at @PIK_Climate. Researcher interested in network science and machine learning,0,2,0,2,4,300
3219018691,chezick_allen,"💙Complex Systems , information moves through networks, feedback and evolution happen, for actual equal opportunity, not forced outcome",1,0,8,0,9,300
757931125314510849,Microbe_Whisper,"Bio-Network Systems, Ecology, Evolution & Education (BSE3) Microbial Ecology & Network Science: Understand Technologies of the Oldest Lifeforms on Earth.",1,0,0,1,2,300
705583506,rogermwhitaker,"Professor - Collective Intelligence. Dean of Research and Innovation for Physical Sciences, Cardiff UK. My views etc",0,0,0,1,1,300
292139586,emmanuelpua,"Clinical neuropsychology, neuroimaging, and autism research - Think big!",0,1,0,0,1,300
877667079062794240,CriptodivisasMx,"Grupo de Desarrollo, Exploración e #Innovación en #Blockchain e #InteligenciaArtificial
https://t.co/3dlXbbtwul
https://t.co/mpo9yGal8X",1,0,0,0,1,300
77516226,viditkundu,UrbanFoundry,0,1,1,1,3,300
780407517457309696,devops_mba,Watching the world getting eaten by software. #Elastician Alter ego of @nephel_,0,0,1,0,1,300
2460562405,elisaborowski,"engineering + social sciences, transportation, urban planning, human behavior, city solutions, urban mobility, data visualization, sustainability, communication",1,0,0,0,1,300
1964532204,nestorserrf,"RN. PhD student @HSciences, U of Southampton. Health and social sciences are not mutually exclusive #nursingscience #nursingart Intensity=poetry+triathlon",3,0,0,0,3,300
1169681750,JuliTavella,"Ecóloga postdoc - UBA 🐜🐝🌱-
Network science lover -
Nunca no estoy perdida",0,0,1,0,1,300
378885073,ecorazio,urban sustainability ecologist,0,0,0,1,1,232
2171814826,bewurth,"Lecturer (Asst. Prof.) @StrathHCE | MD @EERNetwork | Fulbright Alumnus | Entrepreneurship, Ecosystems, Complex Systems, Simulation | Trail Runner",0,0,1,0,1,300
285394452,AlexMRuch,"Machine Learning Researcher Engineer @Graphika_NYC. Cornell Sociology & Info Sci ABD PhD MPH student. ML, NLP, graphs, experiments, social dynamics, contagion.",1,3,0,2,6,300
360362547,Mengsen,"Street nerd, Complex Systems scientist & barstool philosopher.  
Currently institutionalized @ Stanford.",0,0,1,0,1,300
3953824113,BiroJJ,Professor of Communication Networks and Computer Science,0,9,0,1,10,138
716900344899485696,alvaldeolivas,"PostDoc in #bioinformatics, Physicist, Biological networks, System Biology, premature ageing, cancer",0,0,0,1,1,276
157486812,kuuhak,Synchronicityの考え方に魅せられ、この社会・人の情報科学的側面に興味を持つ。幅広く興味のあるものをReしていきます。,1,0,0,0,1,10
845115344700162048,natalie123__,,0,0,2,0,2,91
757500469749035008,garedaba,"neuroscience, brain development, data. the odd beer.",0,1,0,0,1,300
539444250,SylviaMorelli,Researcher at Instagram interested in empathy and kindness,3,0,0,0,3,300
775371000397565952,mmcr85,#NetworkScience  #DataScience #rstats #MarketResearch  #SportsData . Miembro de @antropocaos . Investigación y datos para @analiticasports y @superligainnova,0,0,0,1,1,300
17917334,WeiaiWayne,Assistant Prof. of @UMassCommDept. uses computer codes to study digital platforms and politics. #ComputationalCommResearch. All opinions mine. Proverbs1:7,1,0,0,0,1,300
86239760,jvalverr,"Research Scientist
PhD, MsC & BsC
Data Science & Machine Learning
Social & Urban Computing
Complex Networks",2,0,0,0,2,300
2972319052,OceanFact,Ocean SciComm and Network for young marine scientists to promote their research to the public,0,0,0,1,1,300
377431987,JorgePRodriguez,"Aventurero, músico, rutero, atleta maratoniano, inquieto, escritor, físico y antropólogo. Albaceteño, siempre. Making complexity understandable.",1,0,0,0,1,300
838196579290902528,zhujunfan,"Undergraduate Student at Dalian University of Technology, China. Major in Finance, interests in applied maths, evolutionary dynamics and other interdisciplines.",1,0,0,0,1,49
23355247,pgildersleve,"PhD Student @oiioxford  /// Computational Social Scientist  /// Wikipedia, Networks, News, Memory ///",0,0,1,0,1,62
3430042697,MahdiSeyednejad,,1,1,0,0,2,91
2375888137,kaizhu717,PhD students,1,1,0,1,3,274
774529682033213440,Bertalan_Polner,"Psychologist @BME_en Dep of Cogn Sci. Interested in creativity, psychosis, openness, and indiv diff of cogn processes.",0,0,1,0,1,174
838716338986188800,gialdetti,"🌑🌑🌒🌓🌔🌕🌖🌗🌘🌑🌑 
Neuroscience, network science, machine learning and physics.",0,0,0,1,1,27
3821879722,__GabyContreras,"An academic interested in networks, fitness and dance #calalumni #expat #sna #economist #netherlands",1,0,0,0,1,92
788787252205854720,TraversingBits,"University of Strathclyde; Network science and SNA, digital social research",3,1,0,2,6,300
839481184803557376,CBNA_UoG,The Centre for Business Network Analysis at Greenwich University applys techniques of organisational network analysis to a wide range of business problems.,4,0,0,1,5,190
801039984241311744,ENIC_2017,,0,0,0,1,1,14
1930102580,pinkplay1990,,0,1,0,1,2,300
4116625874,d4emergence,"A Magazine for the Network Age. For interviews, story & art submissions contact Managing Editor: @flyingheron",0,0,0,3,3,300
797394847577608192,ina_deutschmann,"🗺🌅🌊💧➡🌐🕸

Biomathematician disentangling marine microbial networks @ICMCSIC. Member of @SINGEK_ITN. PhD candidate in Applied Mathematics @FME_UPC.",0,0,0,1,1,300
833625369597136896,DSFlock,All about data!🏂,1,1,1,0,3,223
629128211,greg_alanis,"Scientist, Programmer, Readaholic, Traveller, Gamer",0,3,0,0,3,300
832306283835486208,katburzynska,Asst Prof @Radboud_uni @RadboudNSM | At the nexus of #SocialNetworkAnalysis #economics #management with a pinch of #China,4,1,0,2,7,160
2365614774,sergejlugovic,Information Behaviour | Foodtech | Senior Lecturer | Zagreb University Of Applied Sciences | Technology Entrepreneurship & E-Business | DJ,1,0,0,0,1,300
2290127024,jpospinalo,Ph.D Student in Computer Science at National University of Colombia,0,0,1,0,1,93
1462224631,ecopeng,"PhDing @DamienFarine Lab, @CollectiveBehav, MPI Animal Behavior & @unikonstanz, exploring eco & evo consequences of habitat configurations for social animals",1,0,0,0,1,169
1920301580,sebstevens99,#eHealth #SocialNetworks #PhdStudent #Lecturer and lover of dogs!,1,0,0,0,1,300
126650122,douban2010,hi,1,1,0,0,2,224
529452973,_akpiper,Applying computational analysis to the study of literature at McGillU. Author of Enumerations: Data and Literary Study (2018) and director of .txtLAB.,2,0,0,0,2,300
2157146090,Gensollen_N,"Postdoc researcher in the Complex Networks team, at LIP6.",2,0,1,0,3,72
2277181716,NidhiSridhar,Undergrad Student at NITK Surathkal,0,0,0,1,1,26
175473813,JimBadDaSailor,Explorer,0,0,3,0,3,300
792416615463813120,RECENS_network,RECENS is a research group at the Centre for Social Sciences of the Hungarian Academy of Sciences,1,0,0,1,2,231
111425923,shaipilo,"I am an ecologist, studying the complexity underlying ecological systems, especially in the context of disease ecology.",0,0,0,1,1,40
1267730028,exposome,In pursuit of the exposome: revealing the importance of the myriad of environmental factors on human health and disease,0,0,0,1,1,300
82867773,svalver,"Complex Systems scientist @CSIC. Studying the Evolution of Innovations. Technology is a product of Life. El pare joglar, el fill timbaler.",0,0,3,0,3,300
291770297,AlGreco92,"Baritonal singer inside the shower, student of complex systems outside.  Academic profile: https://t.co/yO4cGWaUgH",0,0,1,0,1,300
811860973934051328,DatabeersDub,"Data Science & Beers, in Dublin! By @aonghuslawlor @davidecellai @ConidiFrancesca +Roberto Sarracco @simon_d_rees @GargantiniSte. Inspired by @databeers",1,0,0,0,1,290
487643748,hermetictrader,PhD. Philosophy (cum laude). Postdoc research fellow in Department of Semiotics at University of Tartu (Estonia). Chair of Associació UNESCO de Lleida.,0,0,1,1,2,300
720600614829338625,celineyunya,"Associate Professor of Journalism, Director of AI and Media Research Lab, School of Communicaion, Hong Kong Baptist University",1,0,0,0,1,103
3750724576,JLGuisado,"Associate Professor at Computer Architecture and Technology Department, University of Seville. High performance computing, complex systems, educational robotics",0,0,1,1,2,300
360021152,ShawnTErvin,Data Scientist,2,0,0,0,2,300
3082967789,artbyrichy,For Democracy & Science,0,0,1,1,2,300
3147458090,TANTlab,Computational humanities at AAU Copenhagen.,0,0,0,2,2,300
812337545610727424,Andre_SCarvalho,,0,0,0,1,1,300
64858903,diegompin,"Postdoctoral Scholar at University of California, Davis",0,0,0,1,1,95
813383228128161793,cognitivescibr,Cognitive Science Research at Federal University of Amapá (Brazil),0,0,1,0,1,97
807564604054368256,complex_warsaw,"Complex Systems Scientific Group at the Faculty of Physics, University of Warsaw",0,3,5,0,8,274
519859632,csutkusz,"Multipotentialite PhD student, volunteer, dreamer. 
Interested in role &future of states, startup, innovation, egov, networks.
European - Hungarian",0,0,0,1,1,237
1377963726,SuzannaSumkhuu,"Development policy planning, SDGs, policy coherence, systems thinking in the Government of Mongolia l Views mine",0,0,2,0,2,300
3329965827,enasmel,"MSc Physics student interested in brains, complexity, open science and SciArt.",0,0,1,0,1,248
798895198692478976,moshtabaes,"Complex Systems, Social Networks, Cognitive Science , Behavioral Economics, Statistical Mechanics, Algebraic Graph Theory, Evolutionary Psychology & Game Theory",1,0,2,0,3,147
746999636724965377,85maier1,"Communication researcher @FU_Berlin, @pukberlin & @SFB1265. Computational methods, networks, digital public spheres",3,0,0,0,3,139
1437289212,zoe_zoo_sun,,1,1,0,0,2,184
3305767423,saadiht,Sostenibilidad | Justicia Ambiental | Agua | Cambio Climático | Ecología Política,0,0,1,0,1,300
2423561148,MeTebolomics,Precision Medicine Enthusiast. Pharm.D. PhD. Clinical Chemist. #SystemsMedicine #DataSciences #ClinicalOmics #AI #Healthcare,0,1,0,0,1,300
796533138033876992,247huma,". On Medium, somewhere as (for moment) 247humanLuhmann. I've departed from Luhmann overly you see.",0,0,1,0,1,300
718402189312569344,r_hannam,"Ph.D Applied Mathematics
Researcher | Data Scientist | Tech Nerd
https://t.co/gA0WInhJ6P",0,0,1,0,1,114
888476300,paul_tencent,@wechat information diffusion; social influence; social network,2,1,0,0,3,26
977133822,jzhu006,Assistant Professor at University of Connecticut,0,1,0,0,1,38
791540690073387008,TKajdanowicz,Wroclaw University of Science and Technology,0,0,0,1,1,12
634615079,MariLiseDuP,Navigating complex systems. Catalysing desirable futures.,0,1,1,0,2,300
752586697,MicheleLBarnes,Environmental social scientist / social network scientist. @arc_gov_au DECRA Fellow & Senior Research Fellow @CoralCoE,5,0,1,2,8,300
2778419832,fanliang86,"PhD student @UM_CommStudies | Chevening Scholar @cheveningfco | ex journalist in China | SJTU alumnus. {Communication, Politics, Social Media}",0,0,0,1,1,254
40686645,michaeltheaney,"Research Fellow, U of Glasgow & Adj Res Prof, U of Michigan. Political scientist studying social networks, social movements, interest groups, & pol parties.",1,0,0,0,1,300
2965004180,vinhloc_dao,"PhD student @IMTAtlantique, network analyst. Interested in psychology, politics, sociology.",0,0,0,1,1,5
793145738846998528,engmathematics,Tackling real engineering problems with mathematical techniques,1,0,0,0,1,70
2846351406,BristolEngMaths,"The math that powers engineering.
Curated by the department of Engineering Mathematics at @BristolUni.",0,0,0,1,1,300
271379207,SpeckOnADot,"Scientist of some sort. Complex systems, inventions, patents. 
@VicUniWgtn🇳🇿 ➡️ @EPFL_en🇨🇭 ➡️ @Hitotsubashi_U🇯🇵 (soon!).",0,0,1,0,1,49
2707726136,NeuroJenya,Postdoctoral Researcher at Indiana University. Working on brain networks and connectivity in Alzheimer’s Disease.,0,0,0,3,3,255
3292643643,luisa_cutillo78,"Lecturer @UniversityLeeds school of mathematics. Visiting Scientist at DCS Univ. of Sheffield.  Always looking forward, with one eye rolling back sometimes.",0,0,0,1,1,300
773129734104449026,WCENLondon,"Independent charity in South West London

An integrative approach to community care & health promotion through relationships & shared learning 🤝",2,0,0,0,2,300
16977293,semenoffalex,"(Social | Network | Data) Analyst, Junior Research Fellow @ International laboratory for Applied Network Research, NRU HSE; the guy behind @dota_science",6,2,1,3,12,300
472924596,Le_Xaz,"Bioinformatic engineer, web development & omic data integration
at @MedDayPharm 
integrated into the @MetExplore team at @INRAE_Tlse
@RFMF_junior web master",0,0,0,1,1,252
4737589834,heyebrain,"Postdoc interested in brain development, network neuroscience  @IndianaUniversity",0,2,1,0,3,217
2909708327,sabultema,PhD candidate dedicating brain power to advancing knowledge of collaborative governance and community health system transformation.,1,0,0,1,2,105
635766529,Maykolrp,,0,0,1,0,1,300
784138144870457344,MariantoniaMic3,"Teacher of students with disabilities, an architect, I'm interested in many things, I love to look around",0,0,2,0,2,300
3625498215,MargaretTraeger,"@YaleSoc PhD candidate. Social networks, HRI, public health. RT ≠ endorsement.",3,0,0,1,4,300
203130075,caglarkoylu,Asst. Professor of GIScience at the University of Iowa,1,0,0,0,1,257
15181766,marmenes,"Profesora e investigadora en Tec de Monterrey. Medios, Internet y cultura digital. Ciudadana vs la corrupción y las #FakeNews (cuenta personal)",1,0,0,0,1,300
36476777,FlxVctr,"Postdoctoral Researcher @BredowInstitut, PhD from @qutdmrc. Exploring network science for large scale mediacom studies. Hitchhiker. Piano player.",0,0,0,5,5,300
20652827,sudharam,"Professor, I love Data,  Analytics, Network Science, and Prediction Models;  Director,  INSITE: Center for BI and Analytics (https://t.co/5M26C8lCbF)",0,0,0,1,1,300
753355325412110336,UB_ICS,"Universitat de Barcelona
Institute of Complex Systems",0,6,5,0,11,300
3288148599,ComplexGov,Chair for the Governance of Innovative and Complex Technological Systems\\complexity\\governance\\innovation\\technology+society\\RT not necessarily endorsement,0,1,1,0,2,300
1065569197,dachuwu,妳好,0,0,0,1,1,27
425840652,thestevemo,,0,0,1,0,1,187
44755097,ComplexitySci,Complexity Simplicity is the website to discover a world of complex systems and the pop culture they inspire.,0,0,8,0,8,217
781530506949173249,DaBurbanoL,Assistant Professor/Faculty Fellow at the Department of Mechanical and Aerospace Engineering @NYUTandon,0,2,1,1,4,72
210246510,implicitnone,"I study fish and networks, make robots, and drink vermut.",0,1,0,0,1,300
2718962111,shiversea,Post-post-modernist : tweet-and-retweet.,0,1,0,0,1,300
221964622,Phageman0911,Biophysics in C. elegans behavior,0,1,1,0,2,300
890677933,edwindjonge,"Data afficionado, data scientist, ,R, datavis, machine learning, complex systems, python, d3, javascript,gis",0,0,1,1,2,300
2972596395,kai_erlenbusch,@Templeton_Fdn Strategic Alliances Associate; @UoLondon MBA Candidate; #impinv; Complexity #CAS & #Pluralist Economics Advocate; Formerly @RFKHumanRights,0,0,1,1,2,300
3104786868,indrajitwithyou,Researcher in Mathematical Epidemiology and complex networks @ Indian Statistical Institute,0,1,0,0,1,8
2715950677,alexpmagalhaes,"Uncovering GA contribution to stress. A multi-omics approach and allot of network.
Mostly I fix stuff😁",0,1,0,0,1,300
390010995,infohack,"Physician scientist: Infectious disease physician, computational biologist, systems immunologist #IDTwitter #medtwitter #rstats",0,0,0,1,1,300
764121685905866752,NetSciX2017,International Conference on Network Science,3,0,1,1,5,300
214950636,vee3my,"I am interested in formal approaches to complex systems, where syntax meets dynamics and learning.",1,0,1,0,2,300
3642332000,soum_sarkar,"CS PhD student @ASU. Research on diffusion in social networks, ML for search relevance, economics of matching markets.",1,0,0,0,1,61
4542016108,roboenki,a socialist who awkwardly enjoys playing monopoly,0,1,0,0,1,97
753800945658572800,AMiner_org,https://t.co/t1t546Cb5m is a free online service for academic social network analysis and mining. More info at Wikipedia https://t.co/CEBk63bAql,1,1,1,0,3,203
327798532,joshuagrochow,"Asst. Professor @ CU Boulder Comp. Sci. & Math; interested in theoretical computer science, pure mathematics, and complex systems. He/him.",0,0,3,1,4,300
2317996459,szymkowiakj,Behavioral ecologist fascinated by information use and flow in wild animals. Nature photo & forests addict. Assist. Prof. @popecolamu. Heading @WoodWarblersWNP,1,0,0,0,1,300
233288768,jladubbeld,"Mathematical physicist working on statistical physics,
polymer physics and differential equations and complex networks",0,1,0,0,1,112
174809159,xarisp,"Research Director at ATHENA RC, Natural Language Processing Lab",0,0,1,0,1,300
765159839848865796,SpatialNets,Spatially Embedded Networks is an EPSRC-funded project aimed at creating new analytical techniques and models for graphs embedded within a bounding geometry.,0,0,0,1,1,64
105466176,agaudeul,"Putting the ""mental'' in experimental economics! Industrial organization, social networks, consumer choice, and all that fits in the laboratory.",1,0,0,0,1,300
316144376,drtimslade,Researcher @TheMatilda_USyd focused on the intertwined areas of psychiatric epidemiology and psychiatric classification,5,0,0,0,5,300
760468244574724097,Gloria_Cicerone,"Postdoc at @GSSI_LAQUILA 

https://t.co/zuQrRGCHag",0,1,0,1,2,39
121110083,moadaldabbagh,From the Mideast to the Midwest,0,0,1,0,1,300
32829729,thiduong,Self-driving car engineer. PhD dropout.,1,0,0,0,1,178
4843136061,JamesACoutinho,"Research Fellow, Social Network Research Lab, Faculty of Business, Swinburne University of Technology",2,0,0,1,3,89
392755065,ISCPIF,"ISC-PIF is a CNRS institute dedicated to the development of interdisciplinary research on complex systems at the crossroad between modelling, HPC and Big Data.",0,0,3,0,3,300
38634612,dsg22,Data Scientist & Systems thinker @ Check-Risk: Using data science to reward risk-taking & enhance decision-making. Opinions expressed are solely my own.,3,2,3,1,9,300
1004489611,GiuliaTtt,"PhD student in Math @ CoMuNe Lab, studying geometry of complex networks.",0,3,0,0,3,88
739940334529024000,OttawaGraph,"The Ottawa Graph meetup - A monthly meetup discussing everything graph/network related: analysis, visualization, databases.",1,0,0,1,2,93
401737242,ivgmz,El único principio que no inhibe el progreso es: todo vale: Paul Feyerabend. Interesado en la humanidad. Viejo lesbiano.,0,0,1,0,1,300
2233518096,carsonicator,"Senior Research Data Scientist and Head, Digital Systems Dept. @galterlibrary, @GalterDataLab. Views are my own.",0,1,0,0,1,89
876070884,DianePayne12,Director UCD Dynamics Lab- Center for Computational Social Science; Associate Professor UCD School of Sociology.,0,0,0,1,1,300
26939835,chandlertwilson,"Head of Data Innovation @HSBC. Focused on embedding machine intelligence, #network thinking, #OSINT & alternative data within massive organizations. Views mine.",3,0,0,0,3,300
1631414496,_osimpson,"probably tweeting about math/CS, network science/data science, shows/goings on in the city, items of cultural significance including, recently, politics",0,0,0,1,1,186
717393660292280321,t_s_v_k,School of Applied Mathematics and Physical Sciences (NTUA)// Mathematical analysis and statistics// interests: The use of mathematics in social phenomena,5,5,2,1,13,266
382338386,EyadHAbed,"University of Maryland Professor of Electrical and Computer Engineering; Consultant in systems, control, power grid, aerospace, & network modeling and analysis.",1,0,0,0,1,114
1532002951,Andre_CRMartins,"Complex systems, opinion dynamics, evolution, epistemology and more",1,0,0,0,1,300
168667197,demivasques,"Research Associate @IEG_Mainz | PhD Physics @AucklandUni, BEng @ufscaroficial | Complex systems and networks | @Corinthians, travelling, rock and roll 🤘🏻🍻",5,2,3,2,12,300
578700482,Chandraviegas,#multilingualism #datavisualization #networkscience #indigenouslanguages #complexsystems #maps #datascience,1,5,2,2,10,269
2846662954,PasquarettaC,Behavioural ecologist interested in social processes and networks,2,0,0,0,2,210
33994542,franksh_,"PhD Student in Network Science, Physicist and Data Scientist",0,0,0,1,1,193
744492364241080320,ZidongZhao,,1,0,0,0,1,163
3245278331,mohan_timilsina,"Insight Centre for Data Analytics at National University of Ireland, Graph Mining, Machine Learning , Datamining",1,0,0,0,1,130
62883520,EricVorst,Husband & Dad. PhD in Political Science / U.S. Politics & Social Network Analysis. Adjuncting so I can keep researching: https://t.co/84n5HDQybv Cellist & music-lover,1,0,0,0,1,300
114881969,pablofleurquin,"Head of Data at @pedidosya | For those about to fail, I salute you",1,0,0,0,1,300
2993024498,mvrimkus,"I am what I am.  Nothing more, nothing less.",0,0,1,0,1,300
701717088738656257,mpelli3,"Associate Professor at Heriot-Watt, Edinburgh Business School, UK.",2,0,0,0,2,300
18121470,jessemfagan,I study organizations and networks.,1,0,0,0,1,253
1596087746,dvdevill,Computational brain imaging for cognitive & clinical neurosciences. Data science. Signal processing. Happy lab at @EPFL_en and @UniGE_en.,0,0,0,2,2,240
2977667175,Omegaman0015,@MITsloan alum; eats hard-to-digest network science for breakfast;  30+ countries traveled; 20-year career in the fat-tailed distribution.,0,1,0,1,2,300
1301048936,DostlJakub,,0,1,0,0,1,18
2312325042,EmanuelBussemas,Tweeting about digital technologies and data visualizations.,0,0,1,0,1,49
732084666803617792,Xaaraaaa,Data Science | BigData | Machine Learning | Blockchain |,0,0,0,2,2,168
2302136228,singularpattern,,1,0,0,0,1,300
16428756,rejectionking,Bonsai Wolf. Tiny and Mighty. Adorkable chihuahua. Hobby reverser. Dogged and rigorous. Bit of a #weirdo. RT =/= endorsement. Email: theloopcast@gmail.com,0,0,1,0,1,300
314830088,srgtmt,"Here to retweet! Researcher on ecological networks. RT science, conservation, network science, interesting/funny (or not) random stuff. I'm crap with @ and #!",0,0,0,1,1,300
728196755037229058,lovrosubelj,Network scientist at the University of Ljubljana,0,7,0,1,8,34
1085908998,saeedzahran2,Bio-signal processing and networks,0,2,0,0,2,65
1965363350,GomezLievano,"Postdoc Harvard University. PhD in Applied Math. Interests in Economic Development, Cities, Cultural Evolution, Machine Learning and Complex Systems",0,0,1,1,2,300
624277356,nelsoneric1179,,0,0,1,0,1,86
710244765,thereseokraku,"UX researcher & anthropologist @Microsoft // Interested in science, tech, & culture // Loves podcasts, data, & Ghana",1,0,0,0,1,300
1296023419,ArieStaal,Environmental scientist / theoretical ecologist | Postdoc @sthlmresilience on #EarthResilience in the #Anthropocene | Former PhD & postdoc @WUR,0,2,2,0,4,300
20319568,jbborges,Assistant Professor at Federal University of Rio Grande do Norte (UFRN).,0,0,0,1,1,300
150004763,andydominguezm,Appl. Maths,0,1,1,1,3,114
704435246725521411,MSAnalyticsUTT,Mastère Spécialisé® Expert Big Analytics et Métriques,1,0,0,0,1,259
2571703218,jaia89,"PhD Queen Mary University of London  
Postdoc Imperial College London & The Francis Crick Institute
Now at ICR London",0,4,0,0,4,174
70408252,gidonros,,0,0,0,1,1,135
506370304,AurinaArn,Neuroscience | brain imaging and genetics,0,0,0,1,1,101
4856065900,jmacshine,,0,0,1,0,1,300
3323727926,gilbertchen000,,0,1,0,0,1,1
44602679,antoniozippo,"Research Associate at National Research Council, Milan, Italy. Interest: Computational and Theoretical Neuroscience, Neural Coding, Machine Learning.",0,2,0,0,2,300
2909490018,taaprowse,"Interested in conservation, population biology, complex systems, fisheries, human-wildlife conflict, resilience thinking, biosecurity",0,0,1,0,1,300
2338497074,MattiaSFrasca,,0,3,0,0,3,13
715229286043521024,weigoosz,Researcher in Urban Informatics,1,0,0,0,1,14
2334984772,DucThiLuu,,0,0,1,0,1,58
2409117643,DebaratiDas1994,"PhD Student @UMNComputerSci. 
Computational Advertising | NLP.
Grad student by day, Noob Chef by night. 💁",1,0,0,0,1,131
65937227,PkSM3,Modeling the immortality of the crab.,1,1,1,0,3,300
1861280094,BronsonBHarry,"Data Scientist for NSW Health & Neuroscientist @MARCSInstitute. Interested in social perception & action, cortical organisation, reproducible science, R coding.",1,1,0,0,2,300
2973336639,david_unibas,"networks enthusiast - memory, emotions, the brain, and genetics. [d,f,s]MRI. @unibasel. https://t.co/Bje4yBLsOX. Curator of @fibers_papers.",1,0,0,0,1,300
395072179,BioRodriguez,Neuroscience and Animal Behavior student at Emory University. I am specially interested in birds and the evolution of behavior. Ecuadorian. #ReteMirabile,3,0,0,0,3,300
249470402,matomatsu924,,0,0,1,0,1,300
166033663,ALQITHAMI,"PhD in #ArtificialIntelligence, #ComplexNetwork, #ComputationalSocialScience & #MultiagentSystems",1,0,0,0,1,68
302485674,adrian_carro,Research Economist at Banco de España. Associate Research Fellow at INET Oxford. Opinions are my own.,0,12,0,0,12,300
227739732,khalidcustoms,"Worked at Pakistan Customs. Independent Researcher -- Philosophy of Time and the Nature of Nothingness.
Time goes through all times. 
Khalid Masood",0,0,0,1,1,300
4443535577,fjgranadosortiz,"Data Scientist | PhD in Maths | Industrial Engineer. Interests: Data Science, stochastic analysis, optimisation and fluid dynamics (CFD, UQ)",2,0,0,0,2,300
1087709240,HygorPiaget,PostDoc ULisboa - CFTC,1,0,0,0,1,300
32524995,pcalligari,,0,1,0,0,1,101
218652755,lsdalab,"Complexity, Patterns, Networks, Chaos and More",5,7,1,1,14,300
1320749256,KishanManani,"Data scientist. PhD at the interface of physics, machine learning, and abnormal heart rhythms.",0,0,1,0,1,67
205489912,katecac,"Writer * Author * Public Policy Professional/Project Manager * Systems Dynamics * Interdisciplinary Communications * Cannabis Policy, Politics, & Regulation",0,0,1,0,1,300
3394087359,bernard_sonne,Founder & Chief Editor @datenbusiness,0,0,0,1,1,300
2810989249,RobMurcio,"Exile Mathematician based on London. Strong feelings about far-from equilibrium stuff, particularly if there's social interaction involved.",0,0,2,0,2,265
2149314007,DevelopingHCP,"The Developing Human Connectome Project aims at creating the first map of the developing human brain 🧠  Led by: KCL, ICL, and Oxford University. ERC funded.",0,0,1,0,1,300
1259390492,joansie_x,Principal Investigator,0,3,0,0,3,32
2582276022,Kamil_Filipek,"UMCS, sociologist, data scientist",2,0,0,0,2,300
52635407,LuiscarlosG,,0,0,0,1,1,300
70512125,aesp08,"PhD Student in Sociology at @MitchellSNA, @UoM_SOSS. Interested in modelling social networks and scientific networks. Coordinator of @chisocnet Tweets in EN/ES",3,0,0,3,6,300
4418399352,yian_yin,Northwestern IEMS PhD working on complex systems and computational social science.,0,0,1,1,2,71
15123812,rudi51,"The time has come, the walrus said, to talk of many things...",1,0,0,1,2,300
4149189873,pik_copan,Exploring coevolutionary pathways and safe operating spaces in the World-Earth system since 2013,1,1,1,0,3,285
834314287,philocomplex,,0,0,1,0,1,300
1079304265,abbas_carimi,"CS PhD Candidate at Aalto University.
I work on Complex Networks & I write for the public about science at https://t.co/bBnK74y0wJ (FA). See https://t.co/tD8Nk1D9Xa (FA).",0,1,3,1,5,300
2172215396,Angela06Yang,A physicist and data scientist in complex systems at Northwestern University.,0,0,1,0,1,7
106497165,GabrielAxel,"⚔️🛡⚜️🔱 Neuroscientist, educator, musician, iconoclast. Ahead of the data. Architecting the future of consciousness. AI, VR/AR, DLT. sub specie aeternitatis",0,0,1,0,1,300
2385749016,TingChunKuo,"Assistant Prof at National Taiwan Ocean Uni, @UBCoceans alumni, founder & editor of @oceansays_info. Views are my own.",1,0,0,0,1,300
58265183,thomas_peron,Postdoc - University of São Paulo.,0,1,0,0,1,73
3382690971,CABDyN,CABDyN Complexity Centre engages in interdisciplinary research on complex systems and networks.,0,0,1,0,1,36
2253056460,erogludnz,"Network-Oriented Dynamics and Data Science Research Group [@nodds_lab] at Kadir Has University [@khasedutr], Istanbul",0,1,3,0,4,207
4107431188,piero_delellis,,0,1,0,0,1,36
1036636494,Akbari59,"Making enterprise applications intelligent, interested in social informatics and health informatics, Senior Research Associate, @UCL and Research Scientist @NYU",1,0,0,0,1,300
3972095026,FReedTsochas,"Professor of Complex Systems, Saïd Business School and Oxford Martin School, University of Oxford.",0,1,0,0,1,51
226155323,sandeep25789,"Computer engineer turned computational biologist. Postdoc researcher at LTRI, Mount Sinai Hospital.",0,1,0,0,1,300
2177408969,MohsenMosleh,"I'm interested in Social Networks, Social Media, Machine Learning, NLP, and Digital Experiments @MIT @MITsloan",3,0,0,1,4,93
1287235166,dew_socio_logic,Asst. Professor of Sociology. Retweets ≠ endorsements. Tweets are my own and do not represent the opinions of my employer.,1,0,0,0,1,300
3266252850,RYNooraie,"Assistant Professor at University of Rochester. Tries to bridge network analysis , implementation science, mixed methods, and other things! views are mine!",0,0,0,1,1,249
3883357954,weiwang_uestc,"PHD, foucus on complex networks, especially study spreading dynamics.",0,3,0,0,3,10
2871911475,edizquierdo,"Assistant Professor, Cognitive Science Program, Indiana University. Evolution and analysis of brain-body-environment models of adaptive behavior.",0,0,1,0,1,75
944471244,skbarodka,,0,0,1,1,2,100
261012244,abstrapasson,Research Fellow in Agriculture and Energy at Harvard University || Honorary Research Fellow at Imperial College London || Views are my own. Tweets in 🇬🇧 🇧🇷,0,0,0,1,1,300
199268892,emarinhobr,Business Developer | Connecting the Nodes,0,0,0,3,3,300
3696200237,JKlaise,Data Scientist @seldon_io | PhD in Mathematics and Complexity Science | Core developer of Alibi: machine learning explanations https://t.co/EBYMh7y3YW,0,0,0,2,2,300
324467897,APeterToth,,1,0,0,0,1,104
39768976,badebock,Ph. D. student clinical decision making  & complexity science,0,0,1,0,1,300
2338333836,Andre_Vermeij,"Innovation, R&D, Technology & Network Analysis Fanatic | Owner at Kenedict Innovation Analytics | Developer of Kenelyze: https://t.co/UW9EWskumO",1,0,0,0,1,254
562780524,j_yletyinen,"PhD in Natural Resource Management,Physical Geographer. I use systems science to understand what makes human-environment interactions resilient and sustainable.",0,0,2,0,2,300
128669820,Dr_SinaKhan,Postdoctoral Associate at Washington University in St. Louis.,0,0,1,0,1,140
67328794,bobbynorton,Applied Network Science | Lean | Agile | DevOps | Functional Programming | Startups,0,0,0,2,2,300
3435738946,Data_Machines,"Data Science, Statistical and Machine Learning,  Data Exploration and Visualization. Deep Learning and AI. Agile, Platform Thinking, Future Tech.",1,1,2,1,5,221
3337384126,kisharrington,"Assistant Professor. Biological modeling, scientific computing, image analysis, and artificial life for physical, chemical, and biological systems",0,0,1,0,1,300
38833417,MalikGul,Excavating the gap btw public agencies & communities-joining the dots btw the citizen & the state.Director @wcenlondon Post Grad @Imperial_PCPH Systems&Networks,1,0,0,0,1,300
287852311,VictorJMarquez,"Físico, amante de la música y fanático de los deportes.
PhD student at the Centro de Investigación en Complejidad Social (CICS - UDD).",0,0,1,0,1,300
33736056,rymohr,"Soul of a sailor, mind of a nerd. Father of three married to a pretty gal named Heather. Cofounder/CTO @kumupowered.",0,0,0,1,1,300
268203365,PLURplus,"Biological Scientist @SalkInstitute @Scripps_Ocean  dabbling in Bio DataScience, Neuroscience, Cephalopods, AI&HPC using Nonlinear Dynamics & Molecular Biology",0,2,0,0,2,300
362911004,kms_alexander,I research the nature of people and things. PhD student @USCAnnenberg,0,0,1,0,1,80
43908222,Abeer_90,"PhD student at City, University London. Interested in computational social science, data science and complex networks.",0,1,1,1,3,300
3303383715,tanja_milicic,"M.Sc. in Information and Communication Systems, B.A. in Art History and Informatics. Interested in Complex Networks and Machine Learning.",1,1,1,1,4,123
87223459,ComplexitySol,"Collective Intelligence & Complexity. Husband, dad, grandad, dog walker, cyclist. Stockport Mind, RSA, Demosophia.",0,0,2,0,2,300
68192377,sandrofsousa,"PhD Candidate at @QMULMaths. Having fun with Complex Systems and Networks, Urban Studies, computational models and data!",1,1,3,1,6,300
373038942,RykovYuri,"Digital Dasein: хочешь - купайся, хочешь - пей.",1,0,0,0,1,300
1070031997,AnomieNetwork,not me. us.,0,0,0,1,1,300
34215750,_dorgold_,,0,0,0,1,1,300
47401152,LenCosta3rd,Digital and #contentstrategy @RooneyPartners in NYC. Priors: @cfainstitute @memberlink @iimag @worthmag | #finance | #media | #socialmedia | #comms,0,0,0,1,1,300
2434997822,AlfonsiJessica,AEIOU,0,0,1,2,3,300
3025331027,DavidKDiehl,"Assistant Professor of Education - @VUPeabody @VanderbiltU            Schools, sociology, social networks, music and all things Michigan sports",3,0,0,0,3,152
18836209,EskoKilpi,"The art of interaction, the design of digital work, the science of social complexity https://t.co/jEQgML7ZoF",0,0,1,0,1,300
3091000564,BrodkaPiotr,"I am assistant professor of Computer Science at the Department of Computational Intelligence, Wroclaw University of Technology, Poland.",1,1,0,1,3,139
3310938832,Fra_Arrigo,"""Have a little faith. And if that doesn't work, have a lot of mimosas""  B.W.",0,1,0,0,1,77
1063843016,bedartha,"climate scientist, time series analyst; study of climate using statistical inference, machine learning, complex systems, nonlinear dynamics and complex networks",0,1,1,2,4,300
718799232,glezdiazh,"IKERBASQUE Prof., UPV/EHU, Dept. Org. Chem. II, @upvehu @Ikerbasque. Chairman @mol2net. Tweets: #Science, #Cheminformatics, #Networks, #Nanotechnology",0,4,0,0,4,300
871554606,VervetUndergrnd,"Behavioural ecology | conservation science | social networks | R |
Mostly primates and elephants.",8,0,0,0,8,300
9636402,davidballpdx,,0,1,1,2,4,300
1506010765,dmhlr,"Head of Artificial Intelligence
Altway Insurance",0,0,2,0,2,300
49358588,soulwhispers,#Sociology Lecturer@UA/PhD @digitalmethods #DigitalSociology & Methods & #CaribbeanCulture.She/her🤱:2. in♥w/ messy🤦🏽‍♀️#data #affectstudies #acwri #feminist,1,0,0,0,1,300
1951512187,DavidJPOS,Lecture in Statistics and Data Analytics at the University of Limerick,0,1,1,0,2,300
3092446545,pmackey80,"Software developer, computer scientist, and all around graph geek.  Postings on network science, graph visualization, analytics, algorithms, social science, etc",0,0,0,3,3,300
3067883084,D_Robinson_NZ,Data Scientist. Software Designer. Consultant. Criminal network graph specialist.,0,1,0,0,1,8
304583042,Wilber4se,Bioinformatics Analyst at Ohio State,0,0,0,1,1,70
2230335182,kratikaagar,,0,0,1,0,1,256
3102458214,INCS_RD,"INTERNATIONAL NETWORK OF COMPLEX SYSTEMS ANALYSIS, RESEARCH AND DEVELOPMENT",0,0,1,0,1,62
1061141504,phanein,Better living through graphs!,1,0,0,1,2,300
40904248,elplatt,"PhD candidate at @UMSI. Networks, decentralization, civic tech, cats, bad puns. Maintainer @seltzerCRM. Formerly @civicMIT @medialab @i3detroit. he/him",0,0,1,0,1,300
2729079048,ztisbest,"Postdoc at VIB.
Interested in genome evolution,
phylogenomics",0,1,0,0,1,289
413856651,ra1d_tw,,0,1,0,2,3,280
18998160,AdamEzekiel,"AI Entrepreneur. Human, not a bot (yet)",0,0,1,0,1,300
471294835,gabbyteku,"PhD, Lund University, Falculty of Medicine, Dept of Experimental Sciences. Bioinformatics and Systems Biology.",0,0,1,0,1,216
184365715,politconsultant,PhD in Political Science. Associate Professor of Political Science and Law from Moscow Region State University. Political Scientist,2,0,0,0,2,300
17729266,rsoumen,"Faculty at Bose Institute. Work in complex systems, network science, systems biology. Opinions are my own - surely not my employer's. RTs are not endorsements.",0,0,1,1,2,35
21217033,johncoghlan69,"technical, PR, media writer
Love: languages, writing, organizational theory,cognition, arts, music, travel, cuisine",0,0,1,0,1,300
2997018333,yoonsooyeon1,,0,1,0,0,1,15
1663649114,aktenyi,"Systems Medicine, Data Science, Big Data in Healthcare",0,0,1,1,2,132
1519465548,Ruth_HunterQUB,"NIHR Career Development Fellow/Lecturer in Physical Activity and Public Health/Physiotherapist, Centre for Public Health, Queen's University Belfast (QUB)",5,0,3,1,9,300
419532171,aialmeida,I love data. Researcher at @deustoMORElab. #analytics #DataScience #SNA #DataMining,0,1,0,0,1,300
155844551,alinchindea,"12 years a @UN worker. Now a developer @neontribe. I Iove #storytelling, #football, #cycling #learning & #technology",0,0,0,1,1,300
2885626041,me_soufiana,,0,1,1,0,2,76
2384193636,RainerKujala,Data & Mobility & Maps,0,0,0,1,1,58
45368931,TedSNA,"Research Fellow. @QUBSSESW. Network Analysis. School networks, Interschool collaboration, & Education in divided societies. Views expressed are my own.",0,0,0,1,1,300
2990327887,hokkoriwashoku,博士（工学）。現在は機械学習エンジニア。経歴：Bellface Inc. ← Arithmer Inc. ← Tokyo Tech. ←Osaka Univ. 興味：動くもの全般,3,8,0,0,11,219
2258732316,VincentLabatut,,1,0,0,1,2,269
166527685,ric_dicle,"Lecturer in Data Science, University of Exeter",0,1,0,0,1,104
283459376,amus0028,"PhD candidate @ APS Wageningen University and Research | Food-water-energy nexus; agricultural systems; sustainable development


RT≠Personal views",1,0,0,0,1,300
2920473025,talalrahwan,"Associate Prof. @NYUAbuDhabi, interested in Computational Social Science, Artificial Intelligence, and Graph Theory",1,0,0,0,1,90
245305900,Alon_Sela,"Interested in Information spread through social networks, self emergence and herd psychology in groups
These are my personal opinions",1,0,0,0,1,134
443200472,nrozaidi,Ph.D. (Rutgers): Social media in the workplace. Bank Negara Malaysia scholar. Avid traveler.,1,0,0,0,1,300
14697897,kakeru1002,,0,0,0,1,1,300
1625834826,ehotj,,0,1,0,0,1,39
2689097382,USyd_Complexity,"Complexity: where economics, AI, and psychology meet. ARC Chief Investigator looking at the Aus.  housing bubble. Climbs small mountains.",0,0,2,0,2,300
2365467716,orgmapper,OrgMapper is an organizational change management software which helps companies to identify the hidden influencers in their organizations to accelerate change,0,0,0,1,1,300
2425684825,DiktioLabs,Diktio Labs empowers marketing professionals by introducing network science into the marketing planning process. #BigData #PredictiveAnalytics,0,0,0,5,5,264
2792068671,Nacagy,,2,0,0,1,3,80
64454743,lucberthouze,I do research in mathematical neuroscience at University of Sussex.,0,0,1,0,1,79
252299874,BabakFotouhi,"Assistant Professor at @iSchoolUMD, 
Scholar of Computational Social Sciences.",4,0,0,1,5,273
27798759,craigtutterow,Data science productivity engineering @LinkedIn. PhD from @ChicagoBooth. Research in network science & organizational theory. Created @socilabdotcom a while ago,0,0,0,1,1,207
108777771,elflacosebas,Demography (PhD) and hip-hop. Adjunt Research Fellow. @ADRIshanghai +@UExternado + @CEDemografia. Opinions on my own.,0,0,0,1,1,300
2348997223,Erferta,,0,0,0,1,1,6
2802643037,Global4cast,"Global4cast reports on war dynamics and development of the International System, based on the study: '2020: WARning'.",0,0,0,2,2,300
2821294425,Proxmap,Proxmap is an evidence-based design tool measuring face-to-face student networks. Proxmap research  supported by the 2014-5 Perry Chapman Prize.,0,1,0,0,1,46
2730017803,Rafaelopez8,Data Scientist and Statistics lover.,1,0,0,0,1,300
28115026,hckim,"주 은혜라. It was his Grace.
Assistant Professor @Sangmyung University.",1,0,0,1,2,300
2763460574,EMAC3343,,3,0,0,1,4,291
80636218,SharkMourier,Shark Scientist & Behavioural ecologist at UMR MARBEC 248 @umrMARBEC @ird_fr | Observatoire des Requins de Polynésie (ORP) 🦈,2,0,0,0,2,300
155174180,C_Rozenblat,"Geographe, in love with the World, elegance, design and humor",1,0,0,0,1,25
2816991936,JenniferBadham,Computational social scientist,1,0,1,0,2,95
705300624,XiaoLongR,"PhD student supervised by Prof. Dirk Helbing at Chair of Computational Social Science, ETH Zurich",1,0,0,1,2,66
92076117,sxhmidog,"PhD Candidate in Systems Science.  Can't get enough of complex systems, agent based models, Network Science, and Bitcoin.",0,0,1,1,2,175
2710817030,RLC_SNA,"researcher, social scientist and artist | research interests include art, big data, climate adaptation, cooperation, data viz network science, policy, and more.",0,0,0,1,1,300
2803227620,jankulveit,"Physicist. PhD student working on nucleation, network science, complex systems. Tea lover, mountain junkie",0,0,1,1,2,3
615557864,LannyMorrow,"22 years with BKD; Senior Data Scientist;  Digital Forensics, Investigations, Cybersecurity; researcher, gamer, reader, dreamer, lover of libraries and museums",0,0,3,0,3,300
18061837,siganos,,1,0,0,0,1,39
2472367872,zhenzhunet,Lecturer in Network Science @UniofGreenwich,1,0,2,1,4,158
2496568255,AlexJBishop,"Data Scientist (innovation mapping @nesta_uk).

Views my own.",0,0,2,0,2,170
62787820,solokask,"assistant professor of giscience at wuhan university, working on urban mobility and spatial-social networks.",1,0,0,0,1,0
16391123,jolun,"PhD/Research Director, Megatrends @ Swedish Entrepreneurship Forum. Interested in complexity, new tech, the digital economy, cities and more.",1,5,2,1,9,300
14178358,JJSantana,"Assistant Professor in Technology Management, UC Santa Barbara.
PhD Sociology, Stanford University.",1,0,0,3,4,300
2607793988,C_L_Staudt,freelance data scientist | @point8hq @pydata @s4f_podcast,1,0,0,0,1,300
2560007514,ComplxtyHealth,"3rd International Conference on Systems and Complexity Sciences for Healthcare George Washington University
#Complxty17",0,1,1,0,2,211
1444603320,tomcm39,I develop multi-model ensemble algorithms to predict influenza rates and study how combining human judgement and statistical models can improve forecasting,0,1,1,0,2,300
1549209552,jacomyma,Digital tools + social sciences + design at @TANTlab & @PublicDataLab. Ex @medialab_ScPo. Co-founder of @Gephi & #Hyphe. https://t.co/h7AYtw1aFC,0,1,0,3,4,300
976620343,BillMcEvily,"Professor of Strategic Management, University of Toronto
Social Network Analysis, Organizational Research",4,0,0,0,4,300
36160345,FredAmblard,,0,0,1,1,2,90
18050575,DianeHCline,"History Professor, Cellist, Warrior against the assault on women, the arts & humanities.",1,0,0,0,1,300
84154956,cesagar,"Computational modelling of social and organisational systems, agent-based simulation, complex systems, Associate Professor @UniJaveriana @FCEAJaveriana",1,0,2,1,4,300
2377645411,mongoiz,,0,4,5,0,9,300
15031282,darguevara,"Estudiante de la carrera de Sistemas Informáticos UTPL, aréa Análisis de Redes Sociales. Programación Java, Android. Hincha Barcelona SC, FC Barcelona, AS Roma.",2,0,0,1,3,300
212702398,srobledog,Industrial Engineer - MBA - Ph.D.,3,3,0,1,7,265
482014425,_ianbrown,Web Science,1,0,0,0,1,300
228672214,427896,"Works at Product Innovation Data Scientist (Graph & Network Science), Scienaptic Systems, Manhattan, New York",1,2,1,0,4,300
75084047,azim0v,,1,1,0,0,2,66
318507634,gaojian08,Live a simple life and be a nice guy.,0,1,0,1,2,54
98097823,ConnectedAction,Connected Action applies social science methods to social media strategy & reporting. We provide maps & measures of social media spaces to guide investment.,3,0,0,0,3,300
2410980581,TanjaVojkovic,PhD math student with interest in complex networks,0,1,0,0,1,0
117399265,jonjon_cardoso,Comp Sci PhD @KingsCollegeLon | Data Scientist @datascience_br #networks #dataScience #rstats #python 🇧🇷🇬🇧🏳️‍🌈,1,0,0,1,2,300
18907427,charliebrummitt,,1,0,2,0,3,300
782012742,archilab7,"Residential architects. Research & #computationaldesign. #GeneticAlgorithms, #CellularAutomata, #ArtificialNeuralNetworks, #ABM #Python",0,0,1,0,1,300
2308636442,annaawrocka,thinker|doer,1,0,0,0,1,20
1140552372,zericardo182,,1,0,0,0,1,4
2360943163,SICC_IT,Società Italiana Caos e Complessità - Italian Society for Chaos and Complexity,0,4,2,0,6,136
106570084,mollymking,Assistant Professor of Sociology at @SantaClaraUniv. Information inequality. Gender. Computational social science. Proponent of #OA. She/her.  ♿️ Opinions own.,1,0,0,0,1,300
1245940818,changtao_z,Data scientist @twitter,2,0,0,0,2,300
859611673,baxterity,Complex scientist,0,3,1,0,4,154
18161577,hexheadtn,"Systems software specialist. 
Google Scholar: https://t.co/qV6bpI1bf9",1,0,0,0,1,300
558610612,cistronic,"curious primate, BioInformatician, codeMonkey, biomolecularNetwork Cruncher, GraphAddict - 

Life is a Graph!",1,1,0,1,3,300
156846707,cityu_jzhu,"social {media, networks, computing}",2,0,0,1,3,300
196949018,EdmondAwad,Lecturer at @UniofExeter Business School. Previously at @MIT @medialab. Moral Machine. AI Ethics | Computational Social Science | Multi-agent Systems. Syrian.,1,0,0,0,1,300
67538632,maric_kramer,"""Kind of like if a therapist and google had a baby.""",1,0,0,0,1,300
7746742,jorgaf,"PhD by Universidad Politécnica de Madrid. My research interests are the OERs, Linked Data and SNA. Programmer Java",0,1,0,1,2,300
166951898,Erskin123,"genetics, machine learning, healthcare, startup.",0,0,0,1,1,211
22402275,anupradhan,Senior Data Scientist.  Tweets are my own.,1,0,0,0,1,244
2226551180,statmech_netw,Tweeting the latest publications on complex networks and statistical mechanics.,5,18,0,0,23,300
14519511,uzay00,"Interested in Artificial Intelligence, Agent Based Modeling, Complex Systems and Networks",0,2,4,0,6,300
2192972156,sccs2014,"Student Conference on Complexity Sciences
19-22 August 2014, Brighton, UK",0,2,2,0,4,129
1701943525,squiresjl8,"""Shall we make a new rule of life from tonight: always to try to be a little kinder than is necessary?” - James M. Barrie",0,0,1,0,1,300
146175976,glabianca,Professor of Management at Univ of Kentucky.,1,0,0,1,2,300
1005614226,ModelingCommons,"Collaborate, share, discuss, and tag #NetLogo models!  Free to use, and always improving. Written and maintained by @reuvenmlerner.",1,0,0,0,1,300
156691887,shazanj,Dreamer | Pro-AI | Applied ML Scientist | Entrepreneur | MSc & BSc in CS | AMII | UofAlberta | UofColombo | Canada | Sri Lanka,0,0,1,0,1,300
1978330974,JacobBiamonte,"Studies collective effects in quantum computation, machine learning, condensed matter.  Professor.",0,2,0,0,2,300
486103392,CarlosSanz22,"PhD. Biologist interested in kinases, Cell biology and complex networks in the complex life of eukaryotic parasites 🇻🇪. Postdoc at UGA",0,1,0,0,1,300
286850802,SodreLuciana,"coordinator @odi_rio (open data)
Researcher & consultant at @crie_ufrj
(data ecosystem, data driven business, complex network design - topology)",0,0,1,0,1,300
140085981,EmergentPubs,Publisher of academic and business books on complexity theory and emergence.,0,3,0,0,3,123
87606674,nodexl,#Socialmedia network analysis and visualization #influencer analysis #marketing Get #NodeXL https://t.co/CAYK8AJLMv,1,0,0,0,1,300
61555249,financequant,"Applied math prof at Stony Brook University: quantitative finance, computational science, economics, public policy, space exploration. Co-founder RWRI.",0,0,1,0,1,300
38753076,igorkan,Prof. in computer science,2,1,1,0,4,149
629033,MoJoe,Exec: Design | Product | Strategy @Endeca @Oracle @Paypal @CapitalOne  Rides a bike a lot.,1,0,0,0,1,300
1350192474,marinakoganCS,"Computational social science, CSCW, network science, crisis informatics",0,0,0,1,1,57
81587287,y_kayama,"Scientist specialises in Complex systems, Cellular Automata. Department of Media and Information,
BAIKA Women's University",1,0,4,1,6,300
381813372,normonics,Applied Complexity Science. Localism. Homesteading.,0,0,1,0,1,300
13699852,peerlessdeepak,Helping machines beat toddlers in intelligence;Utopian;Kid-lover;Road Runner; A wonder machine,1,0,0,0,1,300
367355676,FPedroche,"Professor of mathematics at Universitat Politècnica de València. Matrix analysis of Networks, Linear algebra, Social Networks, Communication skills",0,1,0,0,1,56
1590920066,FilipaMRibeiro,"Science writer,  researcher, educator but, most of all, learner",1,0,0,0,1,300
17796685,mhlees,"Assistant Professor, UvA, Amsterdam. 
Complex Systems and Agent-based Modelling",1,1,1,0,3,132
135986860,rzafarani,I mine large scale data/networks/social media and analyze human behavior at scale. Professor of #computerscience @EngineeringSU @SyracuseU,1,0,0,0,1,190
14932068,dotjonas,"Assistant Professor, IT University of Copenhagen",1,0,3,0,4,300
19816992,Cohens,"British Academy Postdoctoral Fellow, University of Oxford | Faculty @oiioxford & Fellow @NuffieldCollege | Social Networks | Quantitative Sociology",7,0,0,0,7,300
45544402,somwrita_sarkar,"Senior Lecturer @ Design Lab, University of Sydney. Playing with #networks, #data, #datamining, #cities, #urbansystems",0,0,1,0,1,290
59705051,ardianeff,senang dengan hal yang menyenangkan. Bandung Fe Institute  I Center for Complexity Science Surya University,1,0,1,0,2,300
375155521,elmenreich,"Professor of #Smart #Grids, interested in #Complex Systems, #Communication #Networks, #Programming, #Embedded Systems
Blog at http://t.co/3Lkx6SQ8Zl",0,0,1,1,2,300
1702966718,HrvojeAbraham,"Explores numerics, financial risk, Python, enjoys photography and new technologies",0,1,0,0,1,253
1193843684,KenanHuremovic,@IMTLucca,1,0,0,0,1,87
390779798,JamesCookUMA,"Associate Professor of Sociology at UMA. Interests: Social Networks, Social Media, Social Politics. Posts do not reflect UMA institutional opinion. Obviously.",2,0,0,0,2,300
1358236452,JJ_Borrelli,postdoc studying species interactions and food web dynamics in freshwater systems,0,0,0,2,2,300
159118977,seb_herrmann,"PhD, Professor of Information Systems",0,1,0,2,3,175
294565032,rinziv,,1,0,0,0,1,300
1318712438,WRMcConnell,Assistant Professor of Sociology @FloridaAtlantic | @IUBloomington PhD & #Cleveland native | Tweets about #networks #health #SDoH #aging,6,0,0,2,8,300
187729861,heetaetweet,Network scientist at Asia Pacific Center for Theoretical Physics (APCTP).,0,0,0,1,1,12
23757543,djjupa,"UX Research, UI Design, Usable Privacy & Transparency,
Data Visualizations, and other stuff!",1,0,0,0,1,197
252155382,Neonomia,We need new names for old things,0,1,0,0,1,300
1500643860,SnorreRalund,,1,0,0,0,1,220
36396172,diegoraph,"Associate Professor, University of São Paulo (USP), Brazil. Interested in network science, science of science, complex systems, data mining and NLP.",0,8,7,5,20,300
602752230,RajKumarPan,"Postdoc @ Aalto University, Finland. Research on complex systems, networks and science of science.",0,0,1,0,1,8
109221382,ArcAldebaran,"One image is a thousand words but appearances can be deceiving...Always striving for that precious balance.
http://t.co/GfXdBIC8xF",0,0,0,1,1,300
1445781955,joshualevipayne,"SNSF Assistant Professor, ETH Zurich.",0,1,0,1,2,289
23728069,2weetn,"digital marketer & entrepreneurial tangentaholic | enthusiastic about coffee, wine, rain & sleep | @StrategicDig | @OpenAgent",1,0,0,0,1,267
1447437457,Andre_porru,,0,0,0,1,1,272
1432791084,MikePieters93,[Personal opinions only] Criminology && Math && Data Science && IT,1,0,0,0,1,242
154808811,Cristian_Huepe,Eclectic node: Theoretical physicist researching Complexity/ActiveMatter/Networks/Post-Truth. Electronic-musician/producer/performer as labo_labs &MakersOfSense,1,0,0,0,1,300
198562021,sizheng0320,"A researcher interested in complex network, online social networks, bigdata, and HPC",1,0,0,0,1,94
1331105262,KonstantinZuev,"Special Lecturer in Computing and Mathematical Sciences, California Institute of Technology",0,1,1,2,4,300
119767718,mejimenezxx,Social Network Analysis; Semantic Web,1,0,0,2,3,300
132520269,abhik1368,"Data Science / Cheminformatician AbbVie , Internet of things and lots more ..",0,1,0,0,1,300
1355417364,Rosemary_Braun,"A physicist stumbling ergodically through the life sciences, wearing the hat of an
Asst Professor of Biostatistics at Northwestern University.",0,1,0,0,1,50
37595783,ChengJunWang,"Associate professor in the School of Journalism and Communication, Nanjing University. I tweet about computational communication and data science.",1,0,1,0,2,300
80126969,VaclavBelak,"Data Scientist at Merck/MSD, previsouly Ph.D. and postdoc at DERI, NUI Galway: network analysis and data mining",2,0,0,0,2,300
21674887,kangzhao,"Associate Professor and Tippie Research Fellow, The University of Iowa",0,0,1,0,1,300
17584129,lestersoo,"Tech, disruptive innovation and learning addict. CTO who design, build and destroy things. Trying to make Internet a safer place ATM. RTs ≠ endorsements.",1,0,0,0,1,300
23425855,brtknr,"high performance computing, machine learning, distributed consensus, agent based modelling, network science and vegan food",0,0,0,1,1,300
162653054,afjohansson,Senior Lecturer in Systems Engineering @bristoluni @SystemsCentre - CTO @CrowdVision - Honorary Senior Research Associate @CASAUCL - Supporter of @FuturICT,0,0,1,0,1,172
175495970,SmithCCB,Center for Complexity in Business,3,0,6,0,9,300
303048766,Timothyjgraham,"Senior Lecturer in Communication at Queensland University of Technology, Brisbane. Researching: bots + trolls, mis/disinformation, platform architectures.",2,0,0,0,2,300
181760678,SirBrainghost,,0,1,0,0,1,300
295202806,buhrhelena,"Product Manager, sociologist and former data scientist interested in social networks, two-sided markets, and other related things.",1,0,0,0,1,182
997363584,BillBhame,"Pioneering innovative solutions for a better life. Broad knowledge of converging technologies including Telecom, Software, Cloud, Big Data, Social Media.",1,0,0,0,1,95
105586589,amitabhsharma13,"Assistant Professor of Medicine, Harvard Medical School, Network Medicine, complex networks!",0,1,0,0,1,0
1084584086,giorgiofagiolo,"Professor of economics. I am interested in network science, complexity, ict, and the future trends of our society...",1,0,0,1,2,300
124512688,antoniolopezg,Innovation coach. Agile agitator. Collaboration networks ninja. #agile #internetofpeople #moreisdifferent,1,0,1,0,2,300
119318963,annagua14,Curious.,0,0,1,0,1,300
393637473,ericdongyx,"Science of Science, Computational Social Science, Data Mining, Social Networks.",1,1,0,0,2,178
888914514,CaSEsbcn,Culture and Socio-Ecological Dynamics (CaSEs) is a scientific research group looking into the past in order to understand the present and improve the future.,0,0,1,0,1,300
363747144,SimulPast,SimulPast is an interdisciplinary research project funded by the Spanish Ministry for Science & Innovation under the Consolider Ingenio2010 call (CSD2010-00034),0,1,0,0,1,300
57167141,j_g_oliveira,"Physicist, University of Aveiro. Photography as a distraction.",0,1,0,0,1,300
182542362,dbtindall,"UBC sociology professor. Environment, social networks, social movements. Tweets on environment, climate change, social and political issues, & some satire.",1,0,0,0,1,300
304975204,_edelval_,#Research #SocialNetworks #Privacy #IA #Teams,1,0,0,0,1,300
33161920,andrybrew,i like most people,0,1,0,0,1,300
912590647,i_SCG,i:SCG International Smart Citizen Gallery - Building and connecting new generations. What would it be of Smart Cities without Smart Citizens?,1,0,0,0,1,300
331254964,nhodas,science. from social media to the rest of it.,2,0,0,0,2,300
920174594,tsaichinglu,Data and Network Analytics (DNA),2,0,0,0,2,127
272761249,jmsiqueiros,,1,0,3,1,5,300
838573957,achanalaris,"Biologist, postdoc, proud father of 2, loving husband. Mr Joe Average, actually Dr Joe Median.",0,0,1,0,1,300
418669059,MichaelSteurer,"Data Science, Social Network Analysis, Big Data, Internet of Things, Location-based Services. @beaconinside",1,0,0,0,1,265
271420612,cnscenter,Cyberinfrastructure for Network Science Center at Indiana University,0,0,0,1,1,196
83272167,alvarezmath,PhD Student at Universidad de Chile,2,10,4,0,16,300
438237068,camilopcalderon,,0,0,0,1,1,300
307880202,BlaiVidiella,Terraforming the Antropocenic ecosystems is the aim of my research at the @CSLab_UPF . [Biomedical Engineer (UPF) & MSc in Modeling (UAB) & PhD candidate (UPF)],0,0,2,0,2,300
310903892,USagarra,"Physicist, PhD network science & co-founder @dribiacom. Strictly personal & sci thoughts in this account.",0,0,0,1,1,300
637075471,SNAcourse,Free online course on Social Network analysis offered through @coursera by @ladamic.,2,0,0,0,2,136
111063946,ipsqwcn,"主に量子ウォーク、無限粒子系、複雑ネットワークを研究中。横浜国立大学 教授。Professor, Yokohama National University. My research topics are quantum walks, particle systems and complex networks.",0,1,0,0,1,300
726074365,tarik_ness,Postdoc @ MIT,0,2,0,0,2,288
85222315,toshi_tanizawa,A Network Scientist.,0,1,0,3,4,300
260415174,NoufAldosari,"Academic. Ph.D student of Government @uniessexgovt interested in public policy,Governance,& Iranian politics.Bookish in ❤️ with litertaure,Art & Music",1,0,0,0,1,300
320688727,_NoSo_,"There should be no such thing as boring math... - Cofounder and CTO/CIO of @fittinroom. math, science and tech lover",1,0,0,0,1,300
181364134,TheAdamEvans,"Product analyst @canva, previously @Instacart.",1,0,0,0,1,300
54735456,SocMikeStout,"Sociologist interested in public policy, community, and human development.",1,0,0,0,1,300
501197826,ResearchAtNU,"The latest research news from @Northeastern University, a global, experiential research institution.",0,1,0,0,1,300
30683863,jattipaa,Researcher/entrepreneur in finding patterns,1,0,0,0,1,300
42547844,kztakemoto,"竹本和広. 九州工大 准教授. Assoc. Prof. at Kyutech. Network Science, Computational and Integrative Biology.",1,0,1,1,3,300
36236674,gesteller,,1,1,0,0,2,135
192429859,fabiofxvanni,Research Fellow in Complexity economics at the OFCE SciencesPo,0,1,2,1,4,300
45910983,ViRAms,Scientist. I do shit. Complex shit. For fun I don't play golf.,0,0,1,1,2,300
225307244,j_r_n_d,,0,1,0,0,1,96
447891899,desertnaut,"Walking around, trying to make good things happen... Former UN Peacekeeper, now Data Scientist @ Nodalpoint Systems & Kaggle Master",0,0,2,0,2,300
35092656,evankats,"Prof Technology, Digital Transformation, Economics, Platforms, Data Science, Complexity",0,0,1,0,1,235
430673367,KddLabSocial,,1,0,0,0,1,21
465432339,cnn_non_plus,Yo veía CNN+ y ahora ya no lo veo. I watched CNN+ and I no longer watch it. J'étais un spectateur de CNN+ mais je ne peux plus le voir.,1,0,0,0,1,300
41342428,GaWC,Globalization and World Cities Research Network - the leading academic thinktank on cities in globalization,0,0,0,1,1,300
75645727,kremplo,"networks, visualizations and more",3,0,0,0,3,300
884854838827380736,DiegoRybski,"#cityscience, #urbanization, #citiesimpact, #citiesadaptation, #complexsystems; currently at @PIK_Climate",0,3,1,1,5,300
2258911,neva9257,"Asst Prof, @UMassLowell. Co-founder, @roguebioethics.  Bio/military/engineering ethics. Mountain bikes. COI: married to @rocza. (Photo by @kathwebster)",1,0,0,0,1,300
196877476,jplotkin,"Annenberg Professor of Natural Sciences, University of Pennsylvania",1,0,0,0,1,300
256793538,Magda_Skipper,"Editor in Chief @nature Geneticist, editor, accidental potter. Former Editor in Chief of @naturecomms. Views are my own",0,0,0,1,1,300
238675940,Sara_Imari,Theoretical physicist + astrobiologist. Associate Prof @SESEASU. Deputy Director @Beyond_ASU. Interested in solving the origin of life and finding aliens,0,0,1,0,1,300
1073326243246944257,PhysRevResearch,#openaccess #multidisciplinary @APSPhysics journal covering topics across physics and related areas of research. No article publication charges until July 2020.,1,0,0,0,1,300
741143121367556097,williamleif,"Assistant Professor of Computer Science at McGill University and Mila. Machine learning, graphs, and language.",0,0,0,1,1,292
102131542,iperisic,"Chief Data Officer, LinkedIn",2,0,0,0,2,192
49279876,nfergus,"International man of history. Author, broadcaster, @HooverInst senior fellow. Latest book is The Square and the Tower (Penguin, October 2017)",9,0,0,2,11,300
2387451451,CollectiveMIT,"How do team, cities, and nations learn? How can we create tools to facilitate collective learning? Official account of @MIT's Collective Learning group.",0,0,0,3,3,300
3449673255,DrMANowak,Martin Nowak is Professor of Biology and Mathematics  @Harvard and Director of the Program for Evolutionary Dynamics,1,0,0,0,1,300
19296759,sebastianahnert,"Physicist interested in biology, algorithmic complexity, self-assembly, networks, evolution, digital humanities, molecular gastronomy, and art.",0,0,0,1,1,300
317777498,BIFI_Instituto,BIFI is a research institute from the University of Zaragoza that promotes interdisciplinarity to face the big challenges of innovation and development.,0,1,0,0,1,300
546007186,IARPAnews,"The official IARPA Twitter account. A center of the Office of the Director of National Intelligence, IARPA invests in high-risk/high-payoff research programs.",0,0,1,0,1,300
15103075,stanwass,"Statistics, Psychology, Sociology.  Networks.   Researcher.  Indiana University.   An Editor of NETWORK SCIENCE",0,0,0,2,2,112
241272599,tobiasgalla,"Theoretical physics, statistical mechanics, complex systems. Applications in biology. @IFISC_mallorca, @OfficialUoM. Views are my own. Reproductive success n=3.",0,1,1,0,2,300
315718020,StoufferLab,"Stouffer Lab @UCNZ; quantitative community ecology, evolutionary dabblings, complex systems, and other fun head scratchers. Account effectively mothballed.",0,0,1,0,1,1
15134782,klout,"Klout has been shut down, and this Twitter handle is no longer active. We appreciate the loyal Klouters who stuck with us all these years – keep influencing!",1,0,0,0,1,300
108316166,assystcomplex,Action for the Science of complex SYstems and Socially intelligent icT,2,2,0,0,4,300
39260709,NetSciNews,Keep abreast of the new field of Network Science,0,0,0,1,1,55
20338124,networkscience,"Will surprise you with the facts about how viruses spread, how any two random twitterers are linked and how the whole world is a small world :)",1,0,0,0,1,13
2324423269,docmilanfar,"Principal Scientist / Director, Computational Imaging at Google Research. Opinions expressed here are my own.",1,0,0,0,1,300
1001521099237134336,LashkariShab,,0,0,0,1,1,171
922302474689634304,ChengLungChen1,Ph.D. operations research student from @UCF. Originally from Taiwan. #FirstGen,1,0,0,0,1,276
2803201472,Cisbat_,"CISBAT 2019 Conference on Climate Resilient Cities - Energy Efficiency & Renewables in the Digital Era, Lausanne 4-6 Sept 2019. Tweets do not engage institution",0,0,1,0,1,270
2629435574,arXivStats,Periodic updates with submissions to arXiv.stat. Maintained by @griverorz,0,1,0,0,1,300
1014857182121218049,19_ecc,Welcome to the official Twitter home page of the 18th European Control Conference!,0,1,0,0,1,67
1171493788230934529,DevaLetters,"Visions, apparitions, miracles, letters, and religious practices from St Mary the Vergin, Arbanasi monastery ""Sv Bogoroditsa,"" Veliko Tarnovo province, Bulgaria",1,0,0,0,1,300
3664632081,LutzMerbold,"Biogeochemist, Head of #mazingiracentre @ILRI, Nairobi, Kenya, passionate about climate change, views are my own",1,0,0,0,1,300
302377171,AlyssaWGoldman,"Sociology PhD Candidate at Cornell; studying health, aging & the life course, criminal justice system contact, social networks, & social inequality",1,0,0,0,1,24
1418703992,BayesianSNA,Tweets about Bayesian / Statistical Network Analysis from @albertocaimo,9,0,0,0,9,300
1227214032173707264,sn_nethike,Summer school on research methods for social networks 🌞/  6-11 Sep 2020 / Villa Garbald in Castasegna 🇨🇭 / organized by @snlab_eth / https://t.co/EfQMNsy3Qw,1,0,0,0,1,0
1192453353109884928,TiUNetworkGroup,Group of researchers at Tilburg University that focusses on statistical modeling of social networks.,1,0,0,0,1,2
1171347595186331648,uofebiznetworks,"University of Exeter Business School's Social Networks Centre (ECSN) advances research, training, and consulting in organizational social networks",2,0,0,0,2,39
219849860,SarazinMAC,"Postdoc @UCLouvain_be. Education, social networks, & music; recently teacher retention & mobility. Quant + qual guy; @UniofOxford & @UCL alumnus",1,0,0,0,1,95
742389077048217600,antonbandersson,"Sociologist, researcher at @SOFI_su_se and @Framtidsstudier. Research interests: Social capital, Inequality, Social networks and Social class. Born 347 ppm",2,0,0,0,2,300
3670040122,morocopeland,"Sociologist @DukeU studying social networks, health inequality, and gender",1,0,0,0,1,14
3869768539,amirgoldb,Sociologist @StanfordGSB who studies culture | Co-director of the Computational Culture Lab,0,0,1,0,1,300
122464459,tineadam,"Assistant Professor at VU Amsterdam. Research on knowledge flows, corporate social responsibility, online communities, social networks, food/waste",1,0,0,0,1,300
3297631089,fj_leonm,Sociólogo. Profesor e investigador @socioloxiaudc @GSADI_UAB,0,0,1,1,2,300
1103980039517937664,bringmann_laura,Psychological methods; Philosophy of psychology; Time series data; Experience sampling method in clinical practice; Psych Networks: more than a pretty picture?,1,0,0,1,2,300
749822228,JoelleRodway,Studies role of social networks in organizational learning | Assistant Professor Memorial University | Views are her own,3,0,0,0,3,270
2232759379,SocioVizNet,"SocioViz is a social media analytics platform powered by Social Network Analysis metrics.

#SocialNetworkAnalysis #NetworkAnalysis #DataViz #ddj",1,0,0,0,1,300
1639145466,Claire_LeBar,"PhD student in Public Policy and Sociology at Duke. Migration, International Development, Social Networks, Methods. She/her 🇨🇦",1,0,0,0,1,57
4315068679,emana_sv,PhD candidate of Geographical Sciences @UMD. Focused on participatory networks in coastal communities affected by Sea-Level Rise - Climate Adaptation Scientist,2,0,0,0,2,300
1682364702,carlaint,"Economic data scientist & techpreneur interested in social networks. IMF and Oxford alumna, now analysing networks and big data @ LinkedIn!",1,0,0,0,1,118
1096480259254423552,NetworksGender,The Mitchell Centre for Social Network Analysis (UoM) @MitchellSNA is hosting a one-day postgraduate event on the topic of 'Gender and Networks' on 3/10/2019.,1,0,0,0,1,37
28718742,jordanlnelon,"Current doctoral candidate at Texas A&M; sexual health and social networks. Love God, Embrace Beauty, and Live Life to the Fullest",1,0,0,0,1,300
923849731935260672,pj_mcr,"Post-PhD wastelander. Networks, narratives, gender in film, digital humanities, R, pop culture, superheroes. He/him.",1,0,0,0,1,300
1041759374677487616,JiinJung3,Visiting professor at the University of Kansas; social psychology; computational social science; agent-based modeling; interdisciplinary research,0,0,1,0,1,300
976135253789159424,danielj_redhead,"Postdoctoral Fellow at The Department of Human Behavior, Ecology and Culture at MPI-EVA. 🏳️‍🌈

Network dynamics, social hierarchy, longitudinal methods.",2,0,1,0,3,185
951765794156957696,DigDemLab,We research digital technology and democracy •• PIs: @fgilardi @LucasLeemann @ARGohdes @karstendonnay @ellliottt •• Developer: @MaelKubli •• Part of @UZH_dsi,1,0,0,0,1,300
3349632491,jlegewie,Sociologist at @Harvard,1,0,0,0,1,219
20257565,Jcastillodemesa,Profesor e Investigador Áreas de Sociología y Trabajo Social de Universidad Málaga. Doctor en Investigación e Intervención Social y Comunitaria por UMA,1,0,0,0,1,300
14146725,Wepps,@UWHousing Director. Tweets focus: #UWaterloo #GTD #HBR #CdnPSE #HigherEd #UX #Lean #Agile #Scrum,1,0,0,0,1,300
809693175254319105,soclgy,"Experimental Social Scientist. Head of ""Mechanisms of Normative Change"" Lab @ MPI Bonn. Interested in Social Norms, Society and Recreational Maths.",1,0,0,0,1,133
1105196163060453376,c_kroneberg,Sociology | professor @UniCologne | Funded by @ERC_Research | Views: own,1,0,0,0,1,140
94124019,NORCAN_US,"NORCAN is a network of law enforcement crime analysts and those interested in crime analysis. NORCAN consists of members from Washington, Oregon, Idaho, Montana",1,0,0,0,1,300
1106370258955177984,drjohankoskinen,Scientist of Networks. Some say I'm only in it for the beer,1,0,0,0,1,190
734866162949967873,marktranmer_UoG,University of Glasgow.   Academic tweets/retweets. Own Opinion.,4,0,0,0,4,151
2280973512,iammohdfazil,"Research Fellow @JamiaMilliaIslamia on Social Network Analysis, Likes to play Badminton, watch #cricket and #Football, Big fan of @RavishKumar and @ABDevilliers",1,0,0,0,1,300
28461336,petrmatous,,2,0,0,1,3,300
350364815,StefanoTasselli,"Associate Professor, Rotterdam School of Management, Erasmus University. Expert in #SocialNetworks #OrganizationalBehavior #OrganizationStudies",2,0,0,0,2,29
85542425,Milanes_guisado,"Data analyst and researcher. #researchdata #researchevaluation, #researchimpact #bibliometrics #clinicaldata #researchdatamanagement #RDM #Virgendelrociohosp.",0,0,0,1,1,300
863043022820442116,CharlotteVrijen,Postdoc | University of Groningen | Depression | Peer experiences | Information processing bias | ESM | Intergenerational transmission | Philosophy,1,0,0,0,1,128
368948051,OrjanBodin,Social-ecological systems; social networks; spatial ecology; interdisciplinary research,9,0,0,1,10,286
4896531067,MBouchardCrim,"Professor @sfucriminology, leads @thecainlab, research on social networks, crime, and illicit markets",4,0,0,1,5,300
37381670,shishong,Data Science Fellow @UM_MIDAS,2,0,0,0,2,158
1025445931502764032,UCDDynamicslab,"UCD Dynamics Lab at University College Dublin - researchers of dynamic complex behaviour in social networks, simulation, group processes and decision making",2,0,1,0,3,150
796651808215207936,futurict2,Large scale experiments and simulations for the second generation of @FuturICT #sustainability #complexity #blockchain #cryptoeconomics,0,0,1,0,1,300
2964284110,Mark_Lutter,"Professor of Sociology, University of Wuppertal",0,0,0,1,1,300
2701384105,balachac,"Broadly interested in models of social and economic change via mobility (e.g., job, career, upward, geo). @snsf_ch fellow. Views, tweets and retweets personal.",1,0,0,0,1,300
785978453862461441,jasannman,@IRPatNIH Postdoc @genome_gov | @UMich & @uva alumna | Lifespan developmental scientist studying social networks & close relationships,1,0,0,0,1,300
1001779721082982400,benitacombet,"Interested in educational inequality and gender inequality in the labour market. Lab and survey experiments. Bern, Lausanne, Munich.",1,0,0,0,1,250
904718509636296704,molinajlmg,Full professor,2,0,0,1,3,154
267454003,Roserferpe,,5,0,0,0,5,54
457699995,Gert_Stulp_or_G,,1,0,0,0,1,147
2951908043,Birkelbayes,Sociologist/Statistician. I work at the @fdz_dzhw and I'm a PhD student @ the University of Cologne.,2,0,0,0,2,300
2281192824,UlaTymoszuk,"Researching social connections, #loneliness, #art, #culture and their influence on physical & mental #health @CPerfSci #HEartS @SOCCAH_network",1,0,0,0,1,293
3452437873,manueljfischer,,1,0,0,1,2,300
47571889,RenseC,"Sociologist studying social networks, cooperation, trust, sharing economy | Utrecht |  | Tweets in ENG and NL | retweet =/= endorsement",1,0,1,1,3,300
4105000642,jaapnieuwen,"Sociology, human geography, neighbourhood effects, education, personality psychology, person-environment interactions @ZJU_China",3,0,0,0,3,300
40068619,peter_van_dam,"I work, live and create from my heart | CEO Whayle | Datascience done right | How can we help you to survive this crisis?",1,0,0,0,1,300
1468124203,paoInMilan,,2,0,0,1,3,86
998187955029147650,KoehlyLaura,"Social and behavioral scientist at the intersection of social network analysis, family systems, and genomics. All opinions are my own.",4,0,0,1,5,275
70705353,yeung2000,Associate Professor within the School of Computer Science at Fudan University | Former postdoc at Duke,1,0,0,0,1,167
2876272962,MarinaTulin,"Postdoc in Communication Science, Erasmus University Rotterdam.

Project: Trustworthy, Reliable and Engaging Social Science Communication Approaches.

She/ her",3,0,0,2,5,189
865404458,apilny2,Assitant Professor in Communication at the University of Kentucky. Tweeting mostly about social & neural networks. Dog-faced pony soldier.,1,0,0,0,1,126
26535879,stefan_breet,PhD candidate at the Rotterdam School of Management studying social networks and innovation,1,0,0,0,1,41
955411388,pat_stys,"Research Officer @AfricaAtLSE focusing on #publicauthority, networked dynamics of governance, mobilisation, flight and return, #SNA in Central Africa",1,0,0,1,2,300
1322412710,Elisabel76,"Sociologist, social network researcher, senior lecturer",3,0,0,1,4,300
2958696285,VriensEva,"PhD student Sociology, Utrecht University / ICS || Topics: commons, mutuals, collective action, solidarity || Methods: network analysis, experiments, ABM",1,0,0,0,1,52
280624416,albertocaimo,"Statistician interested in statistical network analysis, Bayesian computation, #Rstats programming.",1,0,0,0,1,94
910692288183111680,iambargar,"Techie/research engineer  building software to map the 'net @Graphika_NYC. Fan of the outdoors, morbid jokes, and giant bunnies. she/her",0,0,0,1,1,197
925853067232317440,auzaheta,PhD student @ ETH Zürich. Statistical network models for dynamic network data,2,0,0,0,2,46
309742322,federico_fb,Research on #solidarity and #peerreview | @sociologica_ | Psycho Grandma's Blues https://t.co/WRVT80cur4…,3,0,0,0,3,300
807665496933990402,miranda_lubbers,Associate Professor and Director of the GRAFO research group. Social networks · Poverty · Social Exclusion · Migration · Transnationalism · Social Cohesion,7,0,0,1,8,300
2201555874,DocTinaK,"Associate prof, research on social development. Tweets in German, English, and Dutch on science and life in het Hogeland (Prov. Groningen, NL).",1,0,0,0,1,300
757848211591614464,LLeszczensky,"Sociologist, MZES, University of Mannheim. Interested in intergroup relations, ethnic/religious identity, social networks, segregation & more.",6,0,0,0,6,193
934058870061912065,marion_hof,,2,0,0,0,2,19
139160563,Cast1978,"Data Science, Digital Research, Online Methodologies, Network Science, Computational Social Science, HER, Academic Analytics, Learning Analytics",0,1,0,0,1,300
2151059467,ESR_news,European Sociological Review: The flagship journal of the European Consortium for Sociological Research @ECSR_Soc.,1,0,0,0,1,300
930804909934485505,mario_angst_sci,"Part-time Postdoc | Part-time stay-at-home father 
Environmental Governance | Networks | Eco-Sufficiency Policy | #rstats
@WSL_research & @pego_group",0,0,0,1,1,267
2766583633,SF_Journal,An International Journal of Social Research.,1,0,0,0,1,300
1933669016,SociologyOxford,Department of Sociology at the University of Oxford.  RTs are not endorsements.,1,0,0,0,1,300
68498026,dimitriscc,Dimitris Christopoulos,4,0,0,0,4,250
766141614372847617,ASONAM_News,The 2019 IEEE/ACM International Conference on Advances in Social Networks Analysis and Mining,1,0,0,0,1,300
3357208594,asr_journal,"Official Twitter account of American Sociological Review (ASR), flagship Journal of the American Sociological Association (ASA)",2,0,0,0,2,300
4217153597,thomas_u_grund,Associate Professor | School of Sociology | University College Dublin,1,0,0,0,1,13
2436460596,Fidydvm,"Wildlife veterinarian, Epidemiologist & Disease Ecologist from #Madagascar. Postdoc @Princeton U, researcher @Stlzoo, co-founder of @mahaliana5  https://t.co/lZtHkTsNcY",1,0,0,0,1,300
40291925,amcasari,Multi-vector data + enginerd brought to you by 🐍 + the letter R. #OpenSource @ Google. Board @VetsWhoCode. @PyladiesSEA + @OReillyMedia author. tweets = me,0,0,0,1,1,300
1326645300,joedgallagher,"Data scientist @OptaPro & @StatsPerform ⚽ | Recovering evolutionary biologist | #rstats, #Python, #LFC, @WomensFootyStat",0,0,0,1,1,300
16256073,mfoolb,Curioso osservatore..,1,0,0,0,1,300
27297648,jhalloy,Research in collective dynamics in natural and artificial systems and sustainability. Physics Prof. @Université Paris Diderot,0,0,1,1,2,300
2838573563,diffiehh,,1,0,0,0,1,114
815506033,fatamolinara,"HEURÍSTICA https://t.co/yowm7aCpGI 
#DataPolitik también desde @H3uristica
#Enrdados1O https://t.co/0pmyLfTnUr
Investigadora @ClabBarcelona",0,1,0,0,1,300
405203843,dusancaf,"All things tech, internet & media | Cybersecurity | Accessibility | Internet governance",1,0,0,0,1,300
1127889559591645184,NebulaGraph,"An #opensource distributed #Graphdatabase, high throughput and low latency for super large scale datasets 
Find us on GitHub: https://t.co/NA4Rpm2MUW…",1,0,0,0,1,300
117720523,Elena2020,"Co-founder @fondazionehexma Social butterfly, interested in creative & innovative PR, digital ethnography & #we-government RT not always=endorsement ;-)",2,0,1,0,3,300
331506721,chrbennike,"Europakorrespondent på @Informeren, +4527574127 cben@information.dk",1,0,0,0,1,300
19015006,madewulf,Computer Science PhD turned into Python/iOS/Android/JS developer by the love of code. Project lead at https://t.co/EHrGtrQYnt Made https://t.co/3gdMLqRROD,1,0,0,0,1,300
3104179751,GideonGied,,1,0,0,0,1,289
33492190,sarabertuccioli,,1,0,0,0,1,300
998595177471201280,NigriAndrea,"PhD Student, Sapienza University of Rome
Faculty of Statistics",0,1,0,0,1,200
3306859296,GeorgStieler,"We help technology companies grow. German roots, global perspective. Cycling enthusiast.",2,0,0,0,2,300
243118371,martaseve,"University Paris Nanterre, Communication and media studies
Digital social research on cultural heritage and participatory dynamics / Digital methods / STS",1,0,0,0,1,300
17645466,giulio_mattioli,Transport researcher vith views on + than 1 topic - 🇪🇺🇮🇹 citizen with views on + than 1 country. Used to be in 🇬🇧. Now at @TU_Dortmund 🇩🇪. Views my own,1,0,0,0,1,300
345036553,funcaption,"@tamuEEB PhD Student.

Interested in why animals cooperate, how cooperation is coordinated & maintained, & social networks.

All things birds (especially 🦃).",1,0,0,0,1,300
545495543,nicgeard,"School of Computing and Information Systems, University of Melbourne

Computational models, infectious diseases, complex systems, networks",0,0,1,0,1,300
1054502754494939137,harfel3,,1,0,0,0,1,229
950266191523676160,MilindTambe_AI,"@Harvard Professor & Director @HCRCS Center for Research on Computation and Society  #AIforGood | 
Director #AIforSocialGood @Google India | #AIforSocialImpact",1,0,0,0,1,300
1067729167477805056,BigData_uc3m,"Promoting interdisciplinary research in analyzing Big Data. We are a partnership between @uc3m and @bancosantander  #IBiDat
instituto.bigdata@uc3m.es",1,0,0,0,1,300
2843617764,complexcase,"Prof Durham University. Developing complexity science, digital sociology and computational & case-based methods to improve health, infrastructure and policy.",1,1,3,0,5,300
2291049618,MuhammedKambal,Fact-checking @wikitribune| Law and Tech @globalvoices| INTJ|UofK Engineering |Haiku| I adore books if you ever want to send me a gift.,0,0,1,0,1,300
1027201792139042816,fcraw4d,"Associate Professor of Biostatistics @ysphbiostat @YaleSPH, SDS, EEB @yale_eeb, Operations @YaleSOM. Statistics, epidemiology, causal inference.",0,0,0,2,2,134
3904167322,sanja_selakovic,,0,0,2,0,2,44
480040776,helleringer143,"Demographer, associate professor @JohnsHopkinsSPH, with stops along the way @ENS_ParisSaclay and @PennPSC",1,0,0,0,1,300
393417248,SenayYitbarek,NSF postdoc @UCBerkeley. Evolutionary ecologist. Integrating infectious disease within community context. #BlackandStem,0,0,1,0,1,300
1949966430,jusaragiotto,"Computer Science, Biodiversity Informatics, Social Network Analysis",0,1,6,2,9,300
910033822040842240,LanderWillem,Scientist. Epidemiology. Transmission dynamics. individual-based modeling.,0,0,0,1,1,110
2286185809,evogom,phd candidate at the MPI of Animal Behavior looking at cultural evolution & social learning in bird species 🐔🐤🐤🐤  usually on here stalking fintwit.,0,0,1,0,1,300
327102962,rod_salas_f,"Doctor en Ingeniería Informática.
Profesor Titular Escuela de Ingeniería C. Biomédica @BiomedicaUV.
Investigador en Ciencia de Datos e Inteligencia Artificial",0,0,0,1,1,300
138153536,sandhillstrat,"Products @Cisco. NFV, cloud, DevOps, digital trans, machine learning, blockchain, Clojure. Christ follower. Love simplicity, haiku, whisk(e)y & bacon.",0,0,1,0,1,300
1296310352,ilumec,,0,0,0,1,1,49
777908401737261056,viappl,Group developing Virtual Interaction APPLication (VIAPPL) for experiments in social dynamics & networks. Tweets relevant academic work & original research,10,0,1,0,11,124
3371954553,BOTinLOVE,Complex Systems |  Design Thinking | Creativity | Networks | Machine Learning | DATA Science | MOOCs | español/english,0,3,2,0,5,300
95571923,BI_bestpractice,Visualizing the future of connected human experience @DataStoryMe #startup #dataviz #richdata. Alumni @uWaterloo @CIHI_ICIS #mhealth. #austin #SXSW #love,1,0,0,1,2,300
48665188,moKhabb,UW-Madison PhD Alumni; Data/NLP/ML Scientist;  Opinions are my own.,0,0,1,0,1,300
609723974,bahanbug,"Disease ecologist at the @CaryInstitute; #predictive #analytics of zoonotic pathogens using #MachineLearning, #AI, #womenintech #womeninscience",1,0,0,0,1,300
3655412534,ACEMathStats,Delivering world-leading research in #mathematics & #statistics to address challenging scientific problems in the real world. We are an ARC Centre of Excellence,0,0,1,0,1,300
3003028801,scpeiyaoyao,"GIS, Infectious diseases dynamical modeling. Applying ecology and evolution. Especially interested in Influenza now. To do some contributions.",0,0,1,0,1,155
4795232599,RafeAmir,Pedestrian dynamic researcher .. #Smart #Mobility ..#Complexity and #Food 🍕☕,0,0,1,0,1,116
3456615865,ProfMSmall,"CSIRO-UWA Chair in Complex Engineering Systems. Scientist, mathematician, physicist, author.  Proud and happy dad.",0,1,0,2,3,300
51395285,polid0ri,"illustrator, overthinker.",1,0,0,0,1,300
2182609360,jp_junghoon,,2,0,0,0,2,16
2401599727,UNGPDataScience,@UNGlobalPulse is a United Nations innovation initiative exploring #BigData and real-time analytics. This is the account of the Data Science Team.,1,0,1,1,3,217
2351562072,BunchedBlackSwn,Correlated extreme events and the complex systems that produce them,0,0,1,0,1,201
384201056,jgalgarra,"Engineer & Historian, PhD. Head of the Department of Engineering @U_tad",0,0,1,1,2,300
212431150,faryad_ds,"network science, controls, computational risk analysis of infectious diseases, machine learning, math modeling",0,1,0,3,4,191
18983429,thegrugq,"Hacker Attaché :: https://t.co/8j6qF4LQMi :: thegrugq@gmail.com :: PGP https://t.co/jgjIg4pBJe :: Не верь, не бойся, не проси :: you cannot defeat a meme with an exploit",0,0,1,0,1,300
55383035,CloserToTruth,"Closer to Truth is a continuing television series on PBS & public television focused upon intelligent discourses on Cosmos, Consciousness, Meaning",1,0,0,0,1,300
1244087220,AndrewLBeam,"Machine learning for medicine. Assistant Professor, @HarvardEpi / @HarvardChanSPH || Founding Head of Machine Learning, Generate Biomedicines, Inc",0,0,1,0,1,300
2411863357,D2DCRC,The D2D CRC was a five year CRC which wound up on 30 June 2019. This page is not monitored or updated.,1,0,0,0,1,300
252566566,Rishi_NK,"Half collaborator, half professional, one quarter mathematician. Chapter lead alumnus at @DataKindUK.",1,0,0,0,1,300
2828192991,blondelresearch,"Researcher in computer science, complex networks, big data, computational social science and privacy. Louvain and MIT.",0,1,0,0,1,5
155505157,DataSift,"Our data platform powers an ecosystem of businesses building privacy-safe insights from social, news, & communities. Part of @meltwater.",2,0,0,0,2,300
1010697330,spaghetti_folks,"** A PARTIRE DAL 23/9/19 QUESTO PROFILO TWITTA SOLO DURANTE I RADUNI **
Spaghetti Open Data, aka SOD, è la comunità di cittadini attorno a #opendataitaly.",1,0,0,0,1,300
37959591,PalantirTech,News and updates from Palantir,0,1,0,0,1,300
237410813,prdeville,Head of Analytics @Bisnode | Prof.  @SolvayEDU | PhD | AI & Network Science enthusiast | Belgian,1,1,0,1,3,300
17013577,blprnt,"Jer Thorp is an artist, writer & educator. He is an adjunct professor at ITP. He/Him/His.",1,0,0,0,1,300
208548072,YocoCSS,YOung scientists COmmunity on complex systems studies,0,0,1,0,1,10
701015997537501185,fedurekpiotr,"PhD student interested in evolution, animal social behavior and health. Motorcycle and heavy metal music enthusiast. EU citizen.",4,0,0,0,4,300
3353312415,carlbescoby,"PhD @UniofBath. Trainee Sport Psychologist MBPsS. Interested in #sport #injury, #rehabilitation, #socialnetworks #transplantathletes",3,0,0,0,3,300
42234968,Teekens,PhD Candidate Sociology @RUG / @SCOOP_Prog / collaborating with @NetwerkZON | Statistics Lecturer Arts and Culture Studies @eshcc | Zowel oot- als lankmoedig.,1,0,0,0,1,300
826721168510054401,MuzuriPapy,,1,0,0,0,1,181
1019961372908707840,NetworkPsy,"EASP meeting ""Introducing Structure - Networks in Social Psychology"" 31/10-3/11 #SoPsyNet https://t.co/Ke5fs0e5Ch  https://t.co/Md4LWSN2fo",2,0,0,0,2,299
4319859441,JeanStafford_,NIHR-UCLH BRC research fellow at UCL researching very late-onset psychosis and dementia @UCLpsychiatry,1,0,0,0,1,300
1627053481,SScottHenry,"Data Science & Tech Policy @Umich. @UBC Alumna. Prev: @WorldBank, @PremiseData, @iHub",4,0,0,1,5,300
1173185752093614086,Oisin_Ryan_,"Postdoc, Methods and Statistics, Utrecht University | Psychology | Dynamic Systems | Time Series | Causal Inference",1,0,1,0,2,70
2950505985,JoSoPerRel,"An international, interdisciplinary peer-reviewed journal that publishes the highest quality original research on social and personal relationships.",1,0,0,0,1,300
38911944,aaronjfisher,"Interested in all things Idiographic | Associate Professor of Psychology | University of California, Berkeley.",1,0,0,0,1,300
2789457827,EJWagenmakers,Check out http://t.co/FaLgoA2epr: A fresh way to do statistics!,1,0,0,0,1,300
1115181426,SachaEpskamp,Assistant professor at the University of Amsterdam.,1,0,0,1,2,300
15911169,rlucas11,Studies personality and subjective well-being at Michigan State; Interested in open science and research practices. Blog: https://t.co/lElYxMk6M5,1,0,0,0,1,300
701895505975107584,Networks_Health,Research Network on Social Networks and Health Inequalities - Wissenschaftliches Netzwerk (DFG) Soziale Netzwerke und gesundheitliche Ungleichheiten (SoNegU),20,0,0,1,21,300
1516235784,LetiziaMilli,,0,2,0,0,2,67
1157664699565170688,DrDonlan_,"Associate Editor at PLOS ONE. Chemist, open science enthusiast, baritone, cruciverbalist, remoaner, Oxon/Cantab. All views my own.",0,1,0,0,1,33
288044103,RemyKusters,Research Fellow and junior group leader Physics Inspired Machine learning at @criparis  Github: https://t.co/obi2LPma5n,0,1,0,0,1,132
1212299466083975168,GerritsLasse,complexity scientist // urbanist // technologist // sound artist // tea addict // @IHSerasmusuni,1,0,1,1,3,300
1096430215306321922,FabianoFerrari9,"Professor da Universidade Federal dos Vales do Jequitinhonha e Mucuri. Areas of interest: Physics, Dynamical Systems and Complex Networks.",0,1,0,0,1,49
898842684198092800,jiliechti,"Physicist and data scientist trying to make sense out of complex systems.
Been at EPFL (MSc.), at ETH Zürich (PhD) and wondering where to go next.",1,0,1,1,3,75
948961386167721989,Moi39017963,"Just a curious, optimist and worried man in a changing world. Sometimes, I'll try to use the wonder inside my skull! My opinion may - and will- change over time",0,0,0,2,2,300
98981572,faddadaniele,,0,1,0,0,1,300
1050690487714111488,scimferia,"twitter for science stuff | research interests are in complex networks, and dynamical systems, and other maths i guess",0,1,0,1,2,23
1059449647293444096,LDBarrett19,"Content Development Manager at @Hindawi, talk to me about running a Special Issue! | Views are my own",0,1,3,0,4,138
86746678,uruachim,Process control engineer; information theory enthusiast,0,0,1,0,1,111
1063066802211696640,AsllaniMalbor,"Postdoc researcher, University of Limerick",0,2,1,0,3,55
777781700302475264,a_mBliuc,"Social and political psychologist at the University of Dundee, Scotland 🇹🇩🇦🇺🏴󠁧󠁢󠁳󠁣󠁴󠁿",1,0,0,0,1,85
3031180306,nicvalla,phd student complex networks,0,1,0,0,1,26
3511309816,Bram_Siebert,PhD candidate studying spreading processes and pattern formation on complex networks.,0,1,1,0,2,81
1024247894474481665,furkangursoy34,PhD Candidate @UniBogazici | #complexsystems #networkscience #datascience,1,0,1,0,2,43
267932333,ABDURHMAN_ZAYED,"My Lord,make me an instrument of Your Peace to spread love, peace, joy, and knowledge (We have not sent you except as a Mercy to the world)Qur'an(21:107)",0,0,1,0,1,300
868966324751523845,AfricanPhysics,"The official Twitter account of the African Physical Society, the Pan-African professional society of physicists and the African Association of Physics Students",0,1,0,0,1,300
1131904705851002880,CompNetLife2019,"""Complex Networks in the Life Sciences"" is a satellite meeting of the EBSA 2019 Biophysics Congress. July 25 2019, more info on our web!",0,2,0,0,2,24
246453434,msaldias54,Research economist,1,1,0,0,2,300
53393389,wsjung,"Associate Professor, POSTECH, Korea & Executive Director, APCTP (Asia Pacific Center for Theoretical Physics)",0,1,0,1,2,300
1559204798,ComplejidadUD,Grupo de investigación de la Universidad Distrital  F.J.C.,0,1,2,0,3,230
766285029500678144,er_chechi,Professor @ Rio de Janeiro Federal University. Interested in politics from a Complex Systems perspective.,0,0,0,1,1,50
67985833,SabineBrunswick,"professor, researcher, mentor, student, artist, dreamer, twittering about #digitalinnovation,#datascience #computationalsocialscience #opensource #music, more",1,0,0,0,1,300
777224906937344000,LukaszJDebowski,"Mathematician @ IPI PAN (math/CS PhD, physics MSc). Works in information theory & stochastic processes. Curious about language & neural nets.",0,1,2,0,3,300
1626045738,PhemeEU,"Project on modelling and identification of phemes (internet memes with added veracity), as they spread across media, languages,
and social networks",2,0,0,0,2,300
146801452,EloyRD,"Ingeniero mecánico, lector multifacético y nadador improvisado.",0,1,0,1,2,300
1682838037,AndreaGiometto,"Physicists interested in Ecology, Evolution and Microbes!",0,0,1,0,1,141
1076541192228270086,marcogoni3,"science, physics, complex systems, computers, photography, electromagnetic stuff, books, movies",0,0,1,0,1,300
1005299808691630080,ontologymachine,ecosystem development & strategic collaboration 〰️ cryptowitch 🔮 fork the system! 🏳️‍🌈🏴‍☠️,0,0,2,0,2,300
735482904529096704,Dedalo_97,"Dopo il Festival, l'Extra Festival 2019-20: incontri ed eventi su #reti #sistemicomplessi #sanità #psicologia #filosofia #politica #bigdata #biologia #cultura",1,0,0,0,1,300
366179046,GianlucaMiglio,"Associate Professor of Pharmacology, University of Turin (Italy)",0,1,0,0,1,300
14775116,dteyssou,Geek #journalist managing @AFP Medialab R&D @InVID_EU & @WeVerify #innovation manager #H2020 #mediastudies #designthinking #UX building tools vs #disinformation,1,0,0,0,1,300
154914330,unonoctium,"Interested in ecosystem ecology, thermodynamics, networks, canyon and cave explorations, photography",0,2,0,0,2,217
81816509,andrea_pagani,,0,0,2,0,2,300
703993442129604608,matteo_cinelli,Engineer interested in complexity and networks 🧠,0,1,3,0,4,203
1360644582,Praetorian27,"Still on Wormer's ""double secret probation""! Personal vendetta against logical fallacies. Believer in virtuous malice. Copenhagen interpretation is probable.",0,0,0,1,1,300
129241616,ygandica,,1,0,0,1,2,103
1040521286496251905,tgubiec,,0,1,0,0,1,4
586304056,JianghaoWang,"Associate Professor @CAS (Chinese Academy of Sciences) & Research Scientist @MIT . #UrbanStudies #GIScience #RemoteSensing, and #ComputationalSocialScience.",0,0,0,1,1,196
216287774,a_liotta,"Professor of Data Science and Intelligent Systems, Edinburgh Napier University, UK",1,0,0,0,1,300
89803096,eaglu,"67yo complex systems designer/troubleshooter. Just completed radical design of new Internet layer, bridging across the  fragile edges of a widening chasm.",0,0,2,0,2,300
773786932228853760,rwolffoot,"Postdoctoral researcher - category theory, logic & computing",0,0,1,0,1,221
246216688,closeapproximat,Interpolator,0,0,1,0,1,300
4692076176,soooooo_soooooo,"Phd student in automation and robotics🤖@UCLA 
Random tweets Research 🚀 🌟History and Poli Sci 🤝🌍💞",1,0,0,0,1,300
22971117,cmacm,"Working on text and data mining at @EU_Commission @EU_ScienceHub. Personal account, my own opinions.",1,0,0,0,1,300
1008839835665227779,arnavbhavsar,Research,2,1,1,0,4,267
880004839958134784,_SagnikGhosh,"Undergraduate Student and Chief Editor, @KalpaIISERPune 2019 @IISERPune. NIUS Fellow at HBCSE (TIFR).",0,0,0,1,1,100
982477916616339456,lockchew,"Theoretical physicist. Research in nonlinear dynamics, chaos, statistical physics, complex systems. Curious on the fundamental nature of reality.",0,0,1,0,1,14
1888863344,moritszsz,,0,1,1,1,3,300
94153306,Kili_mandjarO,,2,0,0,0,2,300
2785038300,michelteivel,There is no fear in love.,0,0,1,0,1,300
739564041140604929,stokasticdreams,"Physics geek & purveyor of Complexity.
Day job in Data Science & Algorithms.
Design, Travel, Food, Drinks.
CEO of @IBB_Zurich.",0,0,0,1,1,300
420402901,TawfiqCs,عاشق متيم بعلوم الحاسوب والرياضيات والأدب,0,0,1,0,1,300
993456386284670981,digitaldustcons,,0,0,0,1,1,5
917258434365370368,emergir_co,Em dança com a Complexidade,0,0,1,0,1,284
1156096075,huangweibuct,"Researcher of GIScience, transportation and urban complexity.",1,0,0,0,1,44
387357277,yanqinghu1,,0,1,0,0,1,21
810463792568090624,oecd_naec,New Approaches to Economic Challenges (NAEC) develops a systemic multidisciplinary perspective and new analytical approaches to dynamic complex challenges,0,0,1,0,1,300
135784522,jefferywang0429,"PhD Student, NSF NRT Interdisciplinary Program in Complex Network and Systems (CNS) and Political Science, Indiana University Bloomington",0,0,1,0,1,71
1141870669,PhdSAnt,"Network science, Science of Science",0,0,1,0,1,13
2834144385,rferrericancho,Language researcher living in the totalitarian country of Spain,0,1,1,0,2,300
788718685947039745,T6Ecosystems,"T6 is a #consultancy company, offering specialized #research and #management support for international research implementation.",0,0,0,1,1,300
20535016,tinywindow,"Graphic facilitator, process designer, wannabe physicist (also https://t.co/JC5zZxoPEJ, https://t.co/2UNYiEPZxo, https://t.co/MXcHyT7Ge7). Enthralled by the cosmos, mycelium-minded.",0,1,2,0,3,300
26392769,SuGarGon,"Postdoc at #ORNL // Working on water science & sustainability // Interested in cities, complex systems, circular economy. 🇬🇹 🇧🇷 🇲🇽 🇺🇸",0,0,1,2,3,300
962268054519451650,ComplexNet_TR,,0,0,1,0,1,1
819840478355030016,NedaKaboodvand,"Passionate for NetworkScience & NonlinearDynamics🔥
LearningAddict🐣👶
PhD,ComputationalNeuroscience👩‍🎓@karolinskainst
MSc,BioelectricEngineering🤓#Amirkabir",0,0,0,3,3,266
2588847349,blahblah1058,Crypto Currency & Blockchain journalist...founder @blockmanity Looking to promote new projects.,1,0,0,0,1,300
823070294055276545,sbhtta,"Architect, HPC and Simulations Platform @SankhyaSutraLab",0,0,1,0,1,300
771486069221101572,systems_spin,Readings in statistical physics/dynamical systems— flows ~ spin ~ coupling ~ entropy ~ &c. by @biochemistries,0,2,1,0,3,101
916705911594536960,ona_digital,,1,0,0,0,1,8
70216914,diango_rieple,"Postdoc @ University of Kentucky. Fond of complex adaptive systems, evolutionary dynamics, origin of life and microbiome. Fan of mechanistic approaches.",0,0,2,0,2,300
871995214084403201,helloplanetmars,,0,0,1,0,1,286
872818089628499968,suzaleva,,1,0,1,0,2,111
872384139722457089,GiachiniDaniele,,0,0,1,0,1,112
223397280,Gius_C,"Theoretical Physicist, Network & Data Scientist",0,1,0,1,2,108
72330485,_darling_daniel,...my life story is going on... you can be part of it by following me... ;),1,0,0,0,1,300
478526328,estathak,,0,0,1,0,1,141
806142073472712704,LdnMathLab,LML is an institute for basic science in which researchers are commissioned to follow their curiosity.,0,0,1,0,1,257
2720218147,ClarkPolner,Neuro & computational social scientist. U.S. Naval reservist; NYPD Aux Police Officer; @NvidiaAI Inception Program,2,0,0,1,3,300
432425368,i_anag,,0,0,1,1,2,102
4060574419,KrayaTeleka,"Computer Science, Complex Networks, Telecom, Satellites, Arduino",0,1,0,3,4,298
809496832577568768,dostoyevsky_fan,Evolutionary computation.,0,0,0,1,1,300
16978496,kartiktrivedi,"PhDoing at @TheHellerSchool.  @ICInclusion alum. Interests: workforce policy, diversity and inclusion. Retweets ≠ Endorsements.",0,0,0,1,1,300
389411405,mujeebtweaks,"Cyber Security Researcher, Educationist",0,1,0,0,1,128
762317628715233280,AmBelaza,Spanish PhD student in UGhent: Physics in Social and Economic Systems. Interested in politics. Europeist. Spanish account: @FotonAcelerado,0,1,0,0,1,39
11406742,uskudarli,Think and play with social and semantic web...,1,0,0,0,1,300
3715765152,Hkim8Kim,"Theoretical physicist & Network scientist. Assistant research professor @Beyond_ASU Looking for universal intelligence.

I think about thinking, therefore I am.",0,0,1,2,3,300
736541403912785920,NectuntLab,"The Nectunt Lab is devoted to conduct experiments aimed at finding the governing laws of human behavior.
See also https://t.co/wMa2Fx1bdl",0,0,0,1,1,117
2202491618,EK_geog,"Postdoc fellow in @UZH_GEO & URPP DynAge; Spatiotemporal Data Modeling & Analysis, Healthy Aging, Mobility, Spatial ML & IoT; @Penn_State Alumna; Tango dancer.",2,0,1,0,3,300
3187623063,fdrachenberg,"PhD student, applying complex systems theory to immunology research.",0,0,3,0,3,62
303950570,ERIEproject,*PROJECT FINISHED - checkout @cecanexus * Developing complexity science tools to support policy making. Visit https://t.co/FE6GdPZI2J to find our tools.,0,0,2,0,2,148
704753889199976448,odi_rio,ODI Rio belongs to the @ODIHQ global Node network. We help people to create value with open data.,0,1,0,0,1,300
699296562002919424,ee699_esteva,,1,0,0,0,1,10
35636928,alexftrillo,"Latinx sociologist, Boston fan, J's father, writer, critic... Tweet about immigration, race, health, and sometimes tyranny. Opinions mine.",1,0,0,0,1,300
366678689,pakheek,Architect. Heritage Professional. Traveler. Coffee addict. Alumni @UCL_ISH. PhD Candidate @IMTLucca.  Visiting Researcher @COPE_KU,0,0,1,0,1,300
339180565,dvespinosa,"hey, those are complex systems you're talking about",0,0,4,1,5,300
2677175488,01acsap,,0,0,1,0,1,300
335490496,tradingudine,"Mi occupo di #pianificazionefinanziaria. Poca accademia tanta pratica, seguace di @nntaleb. #WealthAdvisor Telegram: https://t.co/Ekz9NyfkDN",0,0,1,0,1,300
188046229,benjbach,"Academic, Information Visualization, Networks, Time, Storytelling, Data Comics, Sketching, Augmented Reality",1,0,0,0,1,300
3873142637,m_radzimski,,1,0,0,0,1,46
59790649,mannteufel,"Interested in cybersecurity, digital media, internet freedom, Russia, Head of IT- and Cybersecurity at GER's int'l broadcaster DW. Views my own",3,0,0,0,3,300
1705151642,adamZreynolds,"Ph.D. Student in the Quantitative Computational Anthropology Lab at Emory University. I study human ecology, evolution, and complex systems.",0,0,1,0,1,12
176233506,remixeverything,Bits and pieces about the series This is Not a Conspiracy and Everything is a Remix. For infrequent email updates: http://t.co/yC3ULQonma,0,0,1,0,1,201
1393633862,MatinaDonaldson,"Assistant Professor of Biology at Harvey Mudd College. Studies ants & bees in the lab, the field, and the alternate reality of mathematics.",1,0,1,0,2,300
3721997894,legendofziemke,Undergraduate student of biology at Pomona College. Studying social insects as complex systems for the Bee Lab at Harvey Mudd College (http://t.co/t6Djn1ACWs).,0,0,1,0,1,0
1635900535,_SethBullock_,Not that Seth Bullock,0,0,2,1,3,300
44132347,stenichele,"Professor @OsloMet - Living Technology Lab https://t.co/4yyhuASfwZ (part of @OsloMetAI). My lab studies bio-inspired AI with Alife, ComplexSys & Neurosci",0,1,1,0,2,300
2176358690,was3210,"Lecturer in Digital Business | Specialism in Social Media Research | Best Selling Author Incl 20+ Peer Reviewed Outputs | Speaker with 80+ talks | BA, MSc & PhD",1,0,0,0,1,300
492069710,T2LW,Optimistic and passionate about #complexsystems #infrastructure #simulation #digitaltransformation. Further information on my LinkedIn profile.,0,0,4,0,4,300
3004174583,lnorbutas,"PhD candidate, Sociology at Utrecht University. Trust and cooperation, online networks, cryptomarkets.",1,0,0,0,1,54
3032245677,antoncrombach,"Biology (evolution), computers, and maths. Also bike, run, swim & dance.",0,0,1,0,1,275
2981675927,tuscany_lawyers,Registered UK lawyers practising in Tuscany and beyond. International legal expertise delivering practical local solutions. Real estate. Business. Start up.,0,1,0,0,1,300
3054255808,NPNHWU,"Nonlinear Photonic Nanostructures Group @ HWU, led by Fabio Biancalana.",0,0,1,0,1,300
2370433584,OyjnikIjukat,"B.S. in physics & now M.A student majoring Behavioral Science.Interests are decision making,collective bahavior,social learning,cooperation & those math models",0,0,1,0,1,300
118672655,sapta15,"Happiness is a choice...Choose Wisely.....
#BeLikeGel",0,1,2,1,4,297
312082056,angelnunhez,Physics teacher trainee. Researcher interested in Nonlinear Dynamics and Statistical Physics. Computational Fluid Dynamics engineer.,0,0,2,0,2,300
2485479097,esynetw,Interested in anything related to networks,0,2,0,1,3,300
2365745222,jacrickets,"PI at @ictpnews and former Omidyar fellow at @sfiscience. Interested in #statisticalmechanics, #quantitativebiology, #theoreticalecology. And more.",0,0,1,0,1,300
2280718796,SocPhys,"A new blog about using networks and data to understand people, culture and society",0,0,0,1,1,14
2854964191,NaghmehMomeni,@JSMF Postdoctoral Fellow @MITSloan,1,1,0,1,3,240
1118215124,XiaohanZeng,Critical Mind & Romantic Heart,1,0,0,0,1,76
120814510,RibeiroHV,I'm playing with complex systems.,3,0,3,1,7,300
11585552,pwk,"1/2 Polish, 1/2 South African, born in Milan, grownup Roman - M.Sc. Theoretical Physics. 20Y expr. in startups/IT. CEO&MD Startupbootcamp FoodTech @SbcFoodTech",0,1,0,0,1,300
864374964,D4n3in,"Engineer, almost physicist, researcher on complex systems dynamics, energy, and sustainable urban development.",0,0,1,0,1,300
2328529873,JanKlecka1,"Integrating experiments, field data and modelling in ecology",0,1,0,0,1,300
15530118,albertolluch,Associate Professor in Computer Science @DTU_Compute,2,0,1,0,3,300
225659579,dchialvo,Director. Center for Complex Systems & Brain Sciences (CEMSC3) / Universidad Nacional de San Martin (UNSAM),0,0,1,0,1,300
246820825,JPhysA,Journal of Physics A: Mathematical and Theoretical is a major journal of theoretical physics publishing 50 issues a year.,1,0,1,0,2,300
56681438,brunifrancesco,"'It is only petty men who seem normal.' https://t.co/JJRwLkIPoV @planetek dev team, reading lover. Sometimes speaker https://t.co/EFXnRiUErL",1,0,0,0,1,300
29671280,lucsteve,"mi occupavo di finanza, ora mi occupo di troppe cose. Twitto poco. Often RT is endorsement.",1,0,0,0,1,300
525291487,Mattia_Guerini,"Economist @uca_research and @GREDEG_UMR. Research fellow @MSCActions. Sport lover, serial runner. Supporter @Inter_en.",0,0,1,0,1,300
1133472504,Rock_DeNic,Computer Scientist,1,0,0,0,1,189
39499934,urbanofranca,"Instructor @HarvardMed / @BostonChildrens. Once a cosmologist, now working on health services research, pediatric access to care,& data science. Views mine etc.",0,0,1,1,2,300
33970083,IlTia,,1,0,0,0,1,300
755311687,_xarxes_,@mcatanzaro piulant sobre xarxes i sobre Networks. A Very Short Introduction Oxford University Press http://t.co/I2hr4uLQxp,0,1,0,0,1,74
755302406,_redes_,"@mcatanzaro tuiteando sobre redes y sobre Networks, A Very Short Introduction, Oxford University Press http://t.co/nMEwW8wKbD",0,1,0,0,1,100
3251358419,Giulia_Pacc,Senior Editor @NatRevMater and passionate about the crossroads between physics and materials science. Views are my own.,0,0,0,1,1,300
908426033505931265,researchersone,New publishing platform promoting autonomous #PeerReview and #OpenAccess.   Launch: September 1 2018.  Created by @HarryDCrane and @statsmartin,0,0,0,1,1,300
796150341838454785,milena_ray3,"Stay curious and never stop learning. Interested in better governance, business environment, evidence for policy, public entrepreneurship. Views mine.",0,0,1,0,1,300
796670055698284545,MasterBigDataPi,,1,0,0,0,1,300
307014955,PenelopePixel,existential data and computation in the XXI,1,0,0,0,1,300
4147762347,Graph_Analytics,"Cutting-edge theoretical analysis of complex networks, applied to real-world problems.",0,1,0,0,1,4
15703088,akleinb,"Business school professor at Tuck School at Dartmouth, scholar of social networks, father of 3 young kids, inactive tweeter",4,0,0,0,4,300
376657553,pvandercingel,Momenteel met Twitter Pauze ** I'm taking a #TwitterBrake ** paul@openeyesinstitute.org | p.van.der.cingel@windesheim.nl,0,0,0,1,1,300
5916862,brx0,Mostly harmless.,0,0,1,0,1,300
1650361093,OSorenson,"Yale professor, tennis player, not on twitter every day",1,0,0,0,1,300
1653770886,BarisBayram2045,"Founder of @EPE_Movement, Author, Philosopher, #HumanRights Defender, #GlobalGoals Advocate, Vegan, Feminist, Humanist, #GlobalCitizen & #HeForShe + #CarpeDiem",0,0,0,1,1,300
1960040071,f_bartolucci,University of Perugia (IT),1,0,0,0,1,64
1855871,arkaitz,"Lecturer @QMEECS @QMUL. Leads @QMSDS, member @QMCompLing @QMCogSci; Human Factors in NLP, Social data science, Computational social science. he/him",0,1,0,0,1,300
2981414219,seregavr,"evolutionary theory, social evolution, cliodynamics",2,1,0,0,3,300
411088326,AshBT,"#AgileCoach & #DevOps Transformation Lead for @agile_bydesign 
| Tweeting about #agile, #AI #kanban, #DevOps, #SystemsThinking #python #bball",1,0,0,0,1,300
396815240,hmdkvk,"Assistant professor @GeorgeMasonU.
#modeling and #simulation, data driven methods, machine-learning, #cybersecurity, #urban science",2,0,0,0,2,300
236480788,vattay,Quantum Technology and Complex Systems,0,0,1,1,2,300
1284357236,ErdosBaconMovie,"Kevin Bacon and Paul Erdős are separated by just a few people. This documentary becomes the handshake that joins these two worlds.
ErdosBaconMovie@gmail.com",0,0,0,1,1,229
2551012122,CiottiV,"PhD,Data scientist, Cook, food lover, AS Roma fan",0,2,0,0,2,300
46218686,mttdlllbr,Designer + UX Researcher @_Experientia | Onions are my own!,0,0,1,0,1,300
13100222,carloshotta,"Cientista na USP, pesquisa os ritmos circadianos das plantas. Entusiasta da Divulgação científica. Ele/Dele & He/Him. https://t.co/qtA8uMIBAH",0,1,0,0,1,300
48577967,mattaf30,"VCU, UVA, Florida alum. VCU Track&Field Jumper. PhD student Biomechanics at Mason. Volunteer Dog rescuer. Dogs, soccer, basketball, college football #GoGators",0,0,2,1,3,300
758748842946879488,random_descent,"chemist, computational scientist, flexitarian, cat lover, complexity explorer",0,0,1,0,1,300
2556126589,RuochengGuoASU,"Ph.D. student, DMML, ASU. Causal ML and Data Mining. Feel free to reach out (rguo12 at asu dot edu). Views are my own. Open to full-time opportunities.",0,0,0,1,1,300
29601126,KDroPhD,Researching how media impact youth ▫️Teaching about social networks ▫️Buliding media literacy programs ▫️Petting all the animals @umich @umisr @um_commstudies,4,0,0,0,4,300
1050829880278085633,emmibevensee,"Mozilla Fellow and antifascist/disinfo research. Data for good. Cat songs. PhD student. they/them/elle. IEEE, The Independent, C4SS... (A) (///) bad tweets mine",0,0,2,0,2,300
927915414151147521,a_papasavva,PhD student at UCL (CDT CyberSecurity),1,0,0,0,1,300
1218793228633137152,abrbaird,Grad student at @usc @uscannenberg. Pursuing a Master of Communication Management. Current focus: intercultural communication and social networks.,1,0,0,0,1,2
14071166,billrand,Assoc. Professor of Business Management at North Carolina State University specializing in Marketing and Computer Science.,2,0,2,0,4,260
15526602,crischicho,"#CorpAccel Initiative Lead @ImperialBiz, PhD Researcher @ImperialDyson, Prof @ucatolica. Co-Founder @jumpchile @innovacien Alum @MIT",0,0,0,1,1,300
1161312102486667264,KeithComplexity,Computer Scientist at @USC_ISI. LA enthusiast. Dog owner. I'm not sure if I walk my dogs or they walk me.,1,0,0,0,1,13
735856905013190657,Andrew_Martin53,"We specialized in providing custom web development, e-commerce, application development and maintenance.",2,0,0,0,2,300
330151669,amyxzh,"@UWCSE professor 👩🏻‍🏫 in 2020 in social 👥 computing 💻 @stanfordhci @BKCHarvard, PhD @MIT_CSAIL MPhil @Gates_Cambridge, SWE @newscred, tennis 🎾 @rutgersU",1,0,0,0,1,300
30389099,reichaos,full-time research guy || CS/computational social science phd student || He/him || ⚽🎮🇺🇸,1,0,0,0,1,300
56959912,ohohlfeld,"Professor, Chair of Computer Networks, Brandenburg University of Technology @BTU_CS Research focus: networking / internet measurement / quality of experience",0,0,0,1,1,300
1047809575976652803,DataHenOfficial,"Full Service Web Scraping & Data Extraction Services.📊🔎
Done with care to help your business grow!",2,0,0,0,2,93
76675731,matthewfay,"Digital Performance, Social Media, Web Design, CRO, SEO, SEM, UX, IA - #userexperiencemarketing",1,0,0,0,1,300
649463,lschen,,2,0,0,0,2,280
466567786,SilviaPetulante,"PhD @TilburgU_tilt
Convergence of #robotics #AI #Privacy #DataProtection #ITLaw #Regulation 
Opinions are my own (unfortunately) 
RT≠endorsement-🌈ally she/her",1,0,0,0,1,300
860834666110226432,lizettesimons,,0,0,1,0,1,300
1029404798968373252,ncri_io,,1,0,0,0,1,95
274053242,ericssonmarin,"PhD Student at ASU with research in Cybersecurity, Dark Web, Social Networks and AI.",4,1,0,0,5,300
4794500515,OTSI_CR,OTSI helps companies around the world leverage #IT to empower their business through cost-effective solutions and services. #Cloud #Bigdata and more.,1,0,0,0,1,300
3368370478,ebrahim_bagheri,"NSERC IRC in Social Media Analytics, Canada Research Chair in Software and Semantic Computing. Interested in Social Media and Networks, Software & Knowledge Eng",1,0,0,0,1,300
1090301065302544385,JenChanNCM,,1,0,0,0,1,8
19815998,manoelribeiro,"Doing my PhD: dlab ~ EPFL 🇨🇭
CS MSc & BSc: eSpeed ~ UFMG 🇧🇷
He/him",1,0,0,0,1,300
1030108127604166666,mbatikas,"Ass. Prof. at @RennesSB. @ISTO_LMU, @EU_ScienceHub & @UPFBarcelona alumni. #platforms, #privacy, #piracy, #darknet",1,0,0,0,1,300
627790728,Druitter,"PhD student @ugent and part of @IDLabResearch interested in ML, AI, DM, NE and any other combination of two letters 😅 Alumnus @LA_UPM, @AaltoUniversity",0,0,0,1,1,164
945820508066590720,BuddhiNet,"PhD student at Cornell University. Interests: network science, complex systems, statistics and mathematical aspects of data science in general.",2,0,2,1,5,31
271595164,rbelbeji,"#AI / #ML Engineer @open_bee 🐝 &
Ph.D. student @RISC Lab ENIT Tunisia",1,0,0,0,1,287
1332776653,eamanjahani,"Graduate Student at MIT, interested in economics, social networks, statistics, political economy, middle eastern and american politics. From Iran",2,0,0,0,2,300
910331145912487937,_EDRichardson,"PhD student studying social learning and problem solving @Yale via @stjohnscollege. Into networks, phil of mind/sci, statistics, and language. Also kettlebells.",1,0,0,0,1,76
275391587,tech_shrink,Columbia University Adjunct Professor and Researcher studying where psychology and technology meet,2,0,0,0,2,300
805919012219744258,IvoMuskens,,1,0,0,0,1,300
3041350021,ontofractal,Making solarpunk happen ☀️  Only the birds fly first class 🐦,0,0,1,1,2,300
3647302472,EducateAgainst,"Official HMG resource offering advice, information and practical guidance to protecting children from radicalisation and extremism.",1,0,0,0,1,300
17367248,ZacharyST,"Prof. of public policy at UCLA's Luskin School of Public Affairs. Protests, computational methods, social networks.  Coffee, books, LeBron James.",1,0,0,0,1,300
36319342,mathiasced,"Källkritik och omvärldsanalys. Föreläser, skriver, utbildar, forskar. Historiker i grund och botten. Arbetar vid Allefonti.",1,0,0,0,1,300
1562754602,NessimAitKacimi,journalist editor (Les Echos) and research associate (Edhec Risk Institute).  tweets (mostly on finance) reflect my own distorted views,1,0,0,0,1,300
954337755072430082,DominikRehse,"Head of Junior Research Group ""Digital Market Design"" @ZEW.
Initiator #AnreizeGegenCorona.",1,0,0,0,1,300
1014255732672192514,grantham_slade,#AIintel #AIstocks #AIindex #AIwomen #AIgenius #UMV #AIweapons #Drones #UMV #AI #AIexperts #AInews #AIdrones #AItechnology #AIcars #AIspy #Stentrode #Science,0,1,0,0,1,199
1479731,erigentry,Curating @covidaccel and @thecovidbase me: co-founder at @go_negative,1,0,0,0,1,300
894934654108741633,coment_io,All #Comments In One Place!  Coment helps online publishers save time by managing all comments on a single dashboard! #socialmedia,1,0,0,0,1,300
2442803160,enidmagari,"Interested in the intersection of machine intelligence, markets, complex systems, human behavior, and axiomatic foundations",0,0,1,0,1,187
3401103297,InnovisorInc,#Change #Collaboration #InternalComms #ScaleUp #Leadership thru #ONA. Coined #ThreePercentRule on #Influencers,3,0,0,0,3,300
849063509866532864,JoniWallaceML,Aerospace applied ML/AI. Fractal art lover. Searching in the random forest and boosted trees. #stopAIhype Views are my own.,1,0,0,0,1,300
984308525223432192,ashokkdeb,,1,0,0,0,1,300
2797997959,bjarkemoensted,,0,0,0,1,1,262
253698498,MicheleJPR,"President, Ignite Global Good #Communications Strategies #MediaLiteracy #HumanRights #SocialJustice #Storyteller, #PR Pro, #Actress, #USC #PublicDiplomacy",1,0,0,0,1,300
111420429,zlisto,"Associate Professor at Yale. Researching social networks, AI, and sports analytics. Fan of hip hop, politics, anime, MMA, and other random stuff.",1,0,0,0,1,300
15142553,Jieun____Shin,"Assistant Professor @UF    
Studying digital media, diffusion of information, social influence",2,0,0,0,2,136
58742862,harisankarh,Chief Scientist @ShieldSquare | Hands-on scalability R&D for billions of requests per month SaaS,1,1,0,0,2,300
576788665,yinizhang2011,PhD candidate at SJMC of UW-Madison,1,0,0,0,1,300
298841645,socbotanalytics,Social bots: Real threat or hype?!,1,0,0,0,1,300
959881970867146752,d_stoltenberg,"PhD candidate @ifkms. Digital public spheres research @SFB1265. Queer feminism, social justice, computational methods, horses, running. (she/her)",1,0,0,0,1,300
2383638403,zsavvas90,"Postdoc at Max Planck Institute for Informatics. 
Dramanaut @iDRAMALab and Research Fellow @ncri_io.
Studying (weaponized) memes and information warfare.",1,0,0,0,1,300
54184375,andrehaller,Professorship for Marketing & Communication Management and Digital Marketing at University of Applied Sciences Kufstein Tyrol,1,0,0,0,1,300
1508946960,tahoranazer,I'm a Graduate Research Assistant in DMML @ ASU.,1,0,0,0,1,19
2328493777,Gareth_Tyson,Computery person who works at Queen Mary University of London & the Alan Turing Institute.,0,1,0,0,1,300
830184831803731969,CAIS_USC,USC Center for Artificial Intelligence in Society: a joint venture of the USC Suzanne Dworak-Peck School of Social Work & the USC Viterbi School of Engineering,1,0,0,0,1,300
92415827,michae1green,Life is good! MD @Atos & Chairman @KINSHIPd. Dad to many & husband to one. #MyThoughts,1,0,0,0,1,300
924919195497664512,mehrnoom,Phd student at Information Sciences Institute  @USC,0,1,0,0,1,61
72177891,joshindig,Canadian software developer🗣 Design enthusiast👻Autodidact Emeritus🙇‍♂️,1,0,0,0,1,300
94850603,jasonjones_jjj,Computational social scientist at Stony Brook University.  I solve the world's problems by data-mining Facebook and Twitter.,1,0,0,0,1,254
755703475900678145,geniia_iakhnis,"Doctoral student in Political Science at USC. Political psychology, public opinion, social media",4,0,0,0,4,209
24267790,agarwalnitin,Maulden-Entergy Chair & Distinguished Professor @ualr. Director of Collaboratorium for Social Media and Online Behavioral Studies (COSMOS) @cosmographers,1,0,0,0,1,300
860849995,nongnonghead,bit plumber :: recovering crank :: not the drummer for hatebeak :: puppycat :: sustainavailability pest,1,0,0,0,1,300
849536703249489920,SpringerEng,"Tweeting the latest content, news and updates from all of Springer’s #engineering portfolio.",0,0,1,0,1,300
3120984989,Golovchenko_Yev,"Research assistant at @uni_copenhagen. Member of @CPH_SODAS. I write about disinformation, censorship, Russia, Ukraine and #datascience. Sometimes in Danish.",1,0,0,0,1,300
14412988,samschech,"Senior @WSJ tech reporter for Europe, Middle East and Africa. Send tips to sam.schechner@wsj.com, or DM me for my Signal/WhatsApp #.",1,0,0,0,1,300
158653891,andreweco,"User as Disruptor©, never short sell human ingenuity, glass 0.5 full, failing is learning, “τις τινι ταύτα λέγεις""",1,0,0,0,1,130
73306557,SwedeWhite,ai/ml pr @awscloud ☁️ | ex: comms @wolframresearch—reporter/host @wrkf—sociologist @lsu | opinions mine and they're awesome,0,0,0,2,2,300
747161169887039489,dgtldrconsult1,"We provide affordable technology, social media, and digital marketing services to businesses around the world.",1,0,0,0,1,88
334002162,A_Aglinskas,,1,0,0,0,1,110
26711278,joemonj,IR researcher and academic,1,0,0,0,1,244
18666099,dreamware,"Multicloud Software Engineer, Data Acquisition Engineer, Solutions Architect, Polyglot Hacker — remote by design — 

Auckland, San Francisco, Global",1,0,0,0,1,300
30981990,teamhuman_org,"Helping humans succeed. Umbrella project for @JLLDay, @Awesomics, @More_Core, @King_Of_Ragtime, @Barefootr, @CreateNewJobs. Tweets by @trutane.",2,0,0,0,2,300
793155956762902528,BioNLProc,Faculty member working in #BioNLP & medical #datascience at UKY. I tweet about my team's biomedical/health #NLProc & data mining projects & academia in general.,1,0,0,0,1,300
2724874904,SergeGoussev,"Researcher of social media in computational political science. Pythonist, cyclist, lover of psychodelic and progressive rock.",0,1,1,0,2,186
268409056,furtadobb,"Researcher @ipeaonline, @CNPq_Oficial, @sfiscience CSSS alumnus, agent-based modeler #ABM in #Python, PhD #Public #Policy. Also, a #pantser",0,0,3,0,3,300
436682744,f_spezzano,Assistant Professor at @boisestatecs,1,0,0,0,1,70
89414621,AndyBlacz,Helping 🇬🇧 UK government & SME's succeed in the digital economy #digitaleconomy #digitaltransformation #contentdesign #ecommerce #digitaldiplomacy #digitalskill,1,0,0,0,1,300
765054708431986689,WistyEL,"Interested in the commercial, cultural, personal and political impacts of computational propaganda and social network manipulation.  #StopBrexit #amwriting",1,0,0,0,1,300
752167695475322880,Mufei_Li,"SDE at AWS AI Lab Shanghai, currently interested in graph neural networks, cheminformatics and causality.",0,0,1,0,1,300
93927234,bodinebaron,"Engineer at @RANDCorporation, Director RAND Center for Applied Network Analysis and System Science. Opinions do not represent RAND. RTs not endorsements.",1,0,0,0,1,300
203001665,alexscheelmeyer,,1,0,0,0,1,300
3007949132,SofianeAbbar,"Engineer & Researcher @QCRI. Interested in {Urban and Social} Computing, politics, and ethics.",1,1,0,0,2,272
2968266731,leclercq_ub,Associate Prof. In computer science,2,1,2,0,5,300
3010045533,birdsongsocial,,2,0,0,0,2,300
16980060,geowyn,Teach and do research on business process and info system design.,1,0,0,0,1,300
25481671,floriangeigl,"#CIO / #CDO @ IBS-PPG & #PhD in #ComputerScience. #DataScience, #MachineLearning & #Python enthusiast. Loves #fitness, #selfimprovement & #goodfood!",0,0,1,0,1,135
3352250392,syndeia,Syndeia builds a digital blueprint of your system by federating #SysML #PLM #CAD #ALM #Data #Simulations #Projects.,0,0,4,0,4,300
719140764417204224,fanlens_io,Take the uncertainty out of social media management! Fanlens combines #AI with #socialmedia to create a bot that reacts exactly like your fans!,1,0,0,0,1,131
752258740435333121,conordewey3,Growth @Hugoproduct. Previously data science @Squarespace. Course Instructor @DataCamp. Frequent writer and newsletterer. 💻,0,0,1,0,1,300
2705355401,Pardo96_,PhD @scharschool Adjunct @GWtweets Research @TraCCCatGMU  || Land || Crime & Conflict || Corruption || Malabarista,1,0,0,0,1,300
53669874,vssubrah,"AI, ML, predictive analytics, forecasting  in many different domains (e.g. social media, counter-terrorism, cybersecurity). Professor at Dartmouth College.",1,0,0,0,1,260
114181340,bibken,"Open Source investigator • #OSINT • trainer • environmental crime, human rights & conflict issues • wildlife & (flying) tech",1,0,0,0,1,300
332963415,maria_hr,"At the intersection of Maths and CS #DataScience #MachineLearning #AI Senior Data Scientist @BBVAData, Phd std @UAM_Madrid and shoes lover. Personal Opinions.",1,0,0,0,1,300
20936866,AliGolensky,"Integrated marketer @chicagobooth executive ed. Lifelong learner and explorer. At the intersection of continuing education, tech, hospitality, & future of work",1,0,0,1,2,89
1732140697,Carolinavivald1,"Gestão e posicionamento de marca pessoal e empresarial.
contato: carolvivaldini@gmail.com",1,0,0,0,1,247
449323798,dataQi,"Finding life force, hidden in your data. 01010101010101010101010101010101010101010101010101010101010101010101010010101Qi01010101010101010101010101010101010101",0,0,0,1,1,64
501193066,rifec,"Digital Forensic, Penetration and Vulnerability Test, Risk Management, Data Security, Incident Response, Ethical Hacking",1,0,0,0,1,300
4635748392,wrightmarc942,Friendly social media fanatic. Thinker. Zombie maven. Problem solver. Typical twitter enthusiast.,1,0,0,0,1,300
157110062,ShirinNilizadeh,"Security and Privacy, 
Assistant Professor,
University of Texas at Arlington",0,0,0,1,1,108
234449073,rishi_mishra84,Electrical & Electronics engineer. Nature's boy. Lives to make things more awesome and magical. Find more:  http://t.co/IgS5fDsFUL https://t.co/lWLCo0d40f,1,0,0,0,1,300
2835428081,LauraK_Nelson,"scholar of social movements and culture, computational sociologist, open-source enthusiast, professor",0,0,0,1,1,300
1115432671,FoxtrotCode,Foxtrot Code is an online Codeless Development Platform and Marketplace for Splunk Search Algorithms. #algorithms  #data #foxtrotcode,1,0,0,0,1,300
428891722,BiBOARDFR,Collaborative BI solution #CollaborativeBI #BusinessIntelligence #BigData // Linkedin https://t.co/mSMvDGgnAw Facebook https://t.co/S2xbDzZh8s,1,0,0,0,1,300
842397337,UArizonaINSITE,"We are a  Research Center for Business Intelligence and Big Data Analytics at the Eller College of Management, University of Arizona",0,0,0,6,6,300
2775224202,WriterMariecor,Love ideas.  I pen some of my own.,1,0,0,0,1,300
15722759,datascig33k,DataScience Cardinal  | Azure BI/ML Consultant | Pythonista |  ♥ Predictive Analytics | Data Innovation | Spiritual | South Indian | Singapore,1,0,0,0,1,300
749992082,idibon,We help organizations understand and use their language data. #DataScience #BusinessIntelligence #TextAnalytics #SocialMedia,1,0,0,0,1,300
2693663232,crimny,"Criminology, Demography, & fun methods.",2,0,0,0,2,275
3104595960,quirkies_app,A game to teach kids about evolution,0,0,0,1,1,67
30924802,JeffreyPJacobs,Between Bourbon & Cigar Pairings. Former Brand Guy. https://t.co/wDVKA1kD45. Blog at @PromoCorner. Enthusiastically Bad Golfer.  Find me on @Yelp #YelpElite,1,0,0,0,1,300
20954842,prasadvrao,Machine Learning at  Goldman Sachs.  Parent of 2 11yrolds (now 14).,0,0,1,0,1,300
39470384,arnimb,Social Web and #LinkedData geek since 1980,1,0,0,0,1,300
3248014564,lavieenval,Food & drink obsessive + urban mama who plays for work.,1,0,0,0,1,300
1102123339,jh_edill20,,1,0,0,0,1,44
266711263,spyrosas,Ph.D. Math Statistics,1,0,0,0,1,300
2401887103,DamianMingle,Chief Data Scientist | Speaker | Author,1,0,0,0,1,300
1272237132,ARehor,"There are more things in heaven and earth, Horatio, Than are dreamt of in your philosophy",1,0,0,0,1,300
3130702851,PhotoFindApp,"A compass for your photos. Navigate to the exact spot a geotagged photo was taken. Works with photos from your library, or sent from someone else.",1,0,0,0,1,110
1667766445,keylinker,"at NAVER, computer vision/deep learning",1,0,0,0,1,300
3304996807,shambhu51280493,I am self employed man.,1,0,0,0,1,300
34270128,riccardotorlone,"Big data, poetry, and art lover. Professor @ Roma Tre University.",1,0,0,0,1,300
2784123889,rgaiacs,Former Executive Council member of @thecarpentries. Former Community Officer at @SoftwareSaved. #openscience #opensource #python #rstats,0,0,1,0,1,300
2616364759,DarkenTre,"#Gamer #CardPlayer  #Skoundrəl  save the princess save the world,  collecting gold coins mushrooms and highlights,  %99 standing gamer  take pride in ur #habit",1,0,0,0,1,300
111046668,HarnhamData,"📈 We are the largest specialist data and analytics recruitment consultancy in the world, with offices in the UK, Europe, and the US. We💖#Data & #Analytics.",1,0,0,0,1,300
2584769473,KimHoots,Program Manager for @Hootsuite's Higher Education Program. Helps educators learn & teach social media. Tweet me to learn more! Opinions are my own.,1,0,0,0,1,300
3195723796,PassionResearch,"Psychologist, assist. prof. @unileipzig, Early Career Research Fellow @Foundation_JF, Motivation & emotions in learning & work, experience sampling,open science",0,0,1,0,1,300
191029020,v_vashishta,"Blunt talk about machine learning, biases, infosec.

Saturn Cloud Partner",0,0,1,0,1,300
167184466,makrehchi,"I am a computer scientist working on AI, Machine Learning, NLP, and social computing. I am also interested in moral and philosophica aspects of AI and technolog",1,0,0,0,1,300
1247787415,WotkynsTheatre,All the World's a Stage including the classroom.  Respect the art.  Respect the student.,0,0,1,0,1,300
3084160268,howaito89silver,"Maine Coon name is White, I like bikes and majestic nature. Mail is prohibited!",1,0,0,0,1,300
3254571964,vadyushamerkus1,,3,0,0,0,3,281
1192867008,elnamortensen1,"Freelancer. Literature, culture, globalization, cultural participation, creativity and innovation, education.",0,0,1,0,1,300
454109663,Orca_Wise,The OrcaWise platform enables sales teams to Predict Buyers and Create Digital Selling Strategies that further drive sales productivity.,1,0,0,0,1,300
2828839262,EdinsonUriarte,"I am interested in social media, social networks, marketing online, e-commerce and IoT.",1,0,0,0,1,300
492052657,LynneMaher1,Passionate about innovating to improve patient experience and health service delivery.,0,0,2,0,2,300
434728275,GhAlraisi,#SocialMedia #التواصل_الإجتماعي,1,0,0,0,1,300
400383768,markdavidbecker,"Digital Marketing Strategist, Social Media Marketing, Content Marketing, B2B Marketer, SEO, Strategy for blending online and offline media. Love playing #tennis",1,0,0,0,1,300
285731422,Raquelfmh,"ICT and #Education, #EdTech, MOOCs, Innovation, Social initiatives, Digital marketing and Entrepreneurship. @Googleanalytics & @InnoEnergyEU",1,0,0,0,1,300
3408105340,capuccinosmedia,I'm the CEO nice to meet you/ Digital Marketing / Social Media / Community Manager / Web Design / Urban / Events/ Entertainment / E-Commerce / E-Learning,1,0,0,0,1,300
1898947946,3cagency,Writer. Ideas/Growth geek. Mental-health advocate. https://t.co/bDpzAdfFJK founder. #indie #authorpreneur #amwriting #content #copywriter,1,0,0,0,1,300
41174817,markomanka,"Medical Doctor, researcher, entrepreneur, philanthropist... or whatever you think may best apply. Interested in complexity, real world challenges, ...people.",0,1,0,0,1,300
2483750641,zaksys,"Tech, design, software, content, social media, marketing, web, print -- you name it, we activate it for you! Our solutions for your business.",1,0,0,0,1,300
43348456,medlit,"Interested in my West Wellington community, food security and media and digital literacy -- recently retired",1,0,0,0,1,300
2903206375,PolishedMM,POLISHED. is a social media management company working in the heart of Denver. We work to develop and utilize online social networks.,2,0,0,0,2,300
2398166402,MuhammadRazaAl9,"We can reach those who have not been reached, include those who have not yet been included and listen those who have not been heard.",0,0,1,0,1,300
95136887,toogletoms,Dream | Believe !,1,0,0,0,1,300
2827293097,o44social,"A leader in digital marketing automation & communications. We provide intelligent solutions that grow business's quickly, affordably, & effortlessly.",5,0,0,0,5,300
3394362107,sociabletips,"Diy #socialmediamarketing for #retailers and #smallbusiness. Simple, straight-forward instruction and how-to's on marketing your products and services yourself.",1,0,0,0,1,300
2503752453,WShobed,I'm lyk an egg strong outside soft inside but not unbreakable so easily,1,0,0,0,1,300
1238987190,Forbes_Bahle,| Creative|Outspoken I Next Fitness Model & Trainer.I IG:bahleforbes,1,0,0,0,1,300
2982276658,chillpuckMLB,"#Baseball & Cold Beer - News, Stats, Scores, #fantasybaseball Funny stuff.",1,0,0,0,1,300
3003912838,kevin_stolla,"Quotes, Affiliate marketing, Motivation, Fitness, Investing, Business and I'm an ape man.",1,0,0,0,1,300
2782326391,ChLegrandCPE,Dircom Rel entreprise @CPELyon Vice President of @EUPRIO basée à #Lyon # #edtech #digital #highereducation #chemistry #digitalsciences - Compte personnel,1,0,0,0,1,300
377891736,PRampioni,"Inquiring, learing and amazed  - facilitator and project designer",1,0,0,0,1,300
373127923,sumrando,Privacy and net freedom are human rights. Promoting cybersecurity for a global impact. #VPN #ICT4D #censorship #privacy #netfreedom #pressfreedom #KeepItOn,1,0,0,0,1,300
176372120,SEO_Houstn_Blog,"We are Specialized in Industrial marketing , SEO, Website design, Social media strategies, Web content writing, B2B marketing agency, PPC Advertising",1,0,0,0,1,300
323445084,GoulsbraWendy,"Concerned with mental health, feminism, child development. Opinionated, a bit of a ranter :)",1,0,0,0,1,300
23763986,basel777,#Nazarene. I/O #Psychologist. Wanna-be #Survivalist. #HR #Analyst at @SanfordHealth. @SanfordCareers. #FamilyMan. #Bigdata Nut. #iopsych,1,0,0,0,1,300
268409161,vivjim,"#Sustainability consultant, science&innov researcher @OxfordSBS, social thinker, #ocean lover, #neuroscience junkie. ELEEP @AtlanticCouncil. Views my own.",0,0,0,1,1,300
1435909322,Nuurul_Basar,Male,1,0,0,0,1,300
259382514,TheWorldWatches,Project Manager | #SocialMedia | #BrandManager | Communication | Lover of #coffee,1,0,0,0,1,300
38111441,RHGIS,"GIS professional / PhD student at the University of Arizona. Topics: geography, GIS, urban planning, policy, demographics. Reviewing rants of all perspectives.",1,0,0,0,1,300
2612088308,heateor,Best Social Tools to Boost User Engagement at your #WordPress Website. Used by 150000+ websites. TRY NOW,1,0,0,0,1,300
2876226376,tthonet,"Research scientist at @naverlabseurope. Interested in Information Retrieval, Recommendation, Machine Learning, NLProc. Views are my own.",3,0,0,0,3,300
875146320,Persephone_Sun,"Pluviophile. OBM. Adore my husband. Love my family. 'She's not fragile like a flower, she's fragile like a bomb' #slowlygettingcoveredintattoos #sydney",1,0,0,0,1,300
1287467406,lyokana59,"Educator, Creative Thinker, Artist, Mother",0,0,1,0,1,300
36534377,chrisallsop,"Copywriter and marketing strategist for financial and alternative health publishers: Your company has a lot to offer. I make sure your prospects know it, too.",1,0,0,0,1,300
3235320836,TenpennyMktg,"Customizable Marketing and Design Services for Your New or Established Businesses, Brands, and Ideas.",1,0,0,0,1,300
17097162,rankontop,We help businesses get online and maximize returns.,1,0,0,0,1,300
3018883984,LTSCanada,LTS Consulting Inc. is a national management consulting firm that helps organizations achieve their maximum efficiency and effectiveness.,0,0,1,0,1,300
242361761,mrnking,"Lecturer in Systems Engineering, the Wolfson School, Loughborough University, UK. #systemsthinking #complexity #IoT #AI #evaluation Views expressed are my own.",0,0,2,0,2,300
422617988,coideos,"So di non sapere. Amo la conoscenza. Faccio #innovazione attraverso la filosofia, l'interazione, l'empatia e l'usabilità. #contract #furniture #serendipity",1,0,0,0,1,300
1920897362,AgeCheq,Cloud based privacy monitoring and compliance service for mobile games and apps.,1,0,0,0,1,300
126350999,xguilera,"Understanding internet & becoming friendly. Trying to learn & share about #marketing, #education, #innovation, #social #trends, #entrepreneurship, new #jobs ...",1,0,0,0,1,300
541187490,ClayFerrer,We are mobile web development and mobile marketing company. The combination provides you a powerful engagement platform.,1,0,0,0,1,107
2827704953,damonoude,Don't sink the boat you built to keep afloat. Startup founder @picklebet Design - Brand - Product - Growth,1,0,0,0,1,300
262612993,EleniTomai,"Engineer, GIScientist, NTUA Research Assistant, works on spatial semantics and geo-ontologies",1,0,0,0,1,164
1173709519,Holly_Brasher,"UNC PhD, using #BigData and #tinydata to study cities as complex systems. Cities, civic tech, politics.

""It's a hard world for the small things.""",0,0,1,0,1,300
3012861011,chttrbckcmms,"Digital campaign providers, social media managers, and growers of your online footprint.",1,0,0,0,1,300
200079342,BizTechGHS,,1,0,0,0,1,300
203636997,Gibbernak,Mitigating sustainable business intelligence and development design | #Digital #SDG #innovation #Circulareconomy #zbx #DKgreen #funding #softmoney,1,0,0,0,1,300
1978884206,WebLeap,"Specialist in Web Design, Development, Web Consultancy, Apps & Mobile Solutions, Commercial Photography, SEO & Online Marketing, Web Hosting & Maintenance",1,0,0,0,1,300
3136478107,dishon_robin,DJ,1,0,0,0,1,300
2417630238,StuckonSW,"blogger, care mgr; #socialwork, #mentalhealth, & complex care.  #macrosw -ish adjunct at @UBSSW. #SocialMedia, #HealthIT & any tech for change. #swtech #HITsm",1,0,0,0,1,300
3182263274,HVth85,,1,0,0,0,1,300
528983396,aadamzaidi,"Lead Digital Consultant. Passionate about Business Strategy, Startups, and our Social-Digital World.",1,0,0,0,1,300
3315698943,SnapFitOfficial,"Dedicated in helping fashion e-commerce stores attain a better customer shopping experience,higher buy-rate, and stronger conversion rates!!#SnapFit #Love #Grow",1,0,0,0,1,300
19292808,DavidPaulStocks,Director of Product Strategy at Mirum | Ex-WPP Fellow | Industrial Designer at heart |,1,0,0,0,1,300
2551871,NikkiDowns,"Content strategist, content marketer, mom of two boys, unapologetic coffee snob, #SanFrancisco native. She/her #contentstrategy #contentmarketing",1,0,0,0,1,300
137961649,oygo,"brands. technology. new ideas.  

We are a team of brand consultants, designers and developers working hard to improve brand communication a bit everyday.",1,0,0,0,1,300
85773901,maudguenot,#Learning #digital #Innovation #Diversity #autodidaxie #entreprenariat #social #opensource #MOOC #ess,1,0,0,0,1,300
162411720,CheukWaiTAI,"Electron microscopist & Physicist.
Group Leader, Lecturer & EM Facility Manager @Stockholm_Uni;
View on my own
🔬⚛️👨‍🔬⌨️🏸🏀🚴🎧🍻📷",0,0,1,0,1,300
3206798213,hashtagambi,"#AMBITIOUS is a podcast hosted by Andrew Leong to share business, marketing and startup strategies, tactics and stories with you.",1,0,0,0,1,300
487905824,DianaInMotion,Social entrepreneur w/ interests in international project management and healthcare. Globe trotter & salsa dancing aficionada.,1,0,0,0,1,300
843122288,ValeBranci,Architect | energy and sustainability consultant | Tweeting in a personal capacity | Views are personal,0,0,1,0,1,300
2285550637,LakeheadPDE,Lakehead University  Faculty of Education Professional Development for Teachers.,1,0,0,0,1,300
1069689049,wbauer7,"Learner, Educator, Technologist",1,0,0,0,1,107
74200847,muthu4all,#bigdata #SMAC #consultant #dataScientist #machineLearning #cloud #DataScience,1,0,0,0,1,300
2748555368,Compass_Litho,"We produce Promotional items for you to give to your customers so they think of you. We also produce banners, mugs, pens, etc. for use at Events and Trade Shows",1,0,0,0,1,300
53345746,leifmergener,"Into sales, marketing, diy, sports and the simple joys in life / from Cologne, Germany / Country Manager @ Qualifio",1,0,0,0,1,300
545701392,Stultzmatt,"Corporate relations and communication specialist @waynesburgu | Social media and public relations for nonprofit arts, small businesses and schools | Tech geek",1,0,0,0,1,300
1474926380,katrobb21,"Educational technologist & PhD researcher @leedsuniversity. Research interests: Chatbots, Robots, & Autonomous Systems",1,0,0,0,1,300
2587533926,MyOfficeSupport,"Virtual Assistant & Problem Solver - My Office Support, One less thing to worry about!",1,0,0,0,1,300
154578083,LynFTan,"Personal Finance Writer. Building a #ContentMarketing Empire in my free time. Interests: #Currentaffairs, #Digitaltrends , #Branding & #Marketing",1,0,0,0,1,300
378816792,violapinzi,"Social innovation, education, knowledge management and technology - People/IT gap minder - Digital Citizenship Team @ European Schoolnet [Own views]",1,0,0,0,1,277
2190466679,jalonpa,"Social change, environmental change, change everything, sustainability, organization, learning, local in global. Tweets Eng./Finn.",0,0,1,0,1,300
88609861,dafloog,Co-founder @goplayapp | Champion of awkward silences | 3D Artist @NickelodeonTV | #climbing #canyons #golf,1,0,0,0,1,300
717801078,PercepticaA,Perceptica is a media analytics agency. We specialize in #socialmedia.,3,0,0,0,3,275
2230192634,TonyisTyping,Co-founder @ DevFlight (W19),1,0,0,0,1,300
2299262561,562_carmo,,0,0,0,1,1,300
2803983127,bernardmno,African start-up Evangelist | Featured on Lions Den Kenya & East Africa Business Times|| GSEA world Finalist|| Co-Founder  @onesha_ke ||https://t.co/sEYj8yBgBp,1,0,0,0,1,300
778866908,MarketingRuiz,"Create & Deliver Your Brand, Everywhere. Email, Social Media Ads, Copy Writer, Results.

Colorado life, 2 wheels & a 4x4, Tigers baseball and wanna be foodie!",1,0,0,0,1,220
9938612,digikaro,"Communications & Data @UNICEF. Interested in the intersection of communications, design, analysis, and policy. All views are mine.",1,0,0,0,1,300
3221269931,PTsecurity_UK,"We find, fix and protect against vulnerabilities using cybersecurity research and cutting edge technology",1,0,0,0,1,300
25919915,jimmcdgll,,1,0,0,0,1,300
2827266728,DAS_SUPERFIST,noise visionaries,0,0,1,0,1,300
273338842,Randall_JAC,"Tattooed veggie clinical psy in CAMHS. Systemic, cognitive analytic, politics #SurvivingClinicalPsychology https://t.co/PqEFsvaV5n Tweeting in personal capacity.",1,0,0,0,1,300
577404529,et_ltd,Delivering innovative and cost-effective technology solutions.,1,0,0,0,1,300
96779457,SofiaAnysiadou,"Worldwise Learning Centre Manager @UCLan Interested in new technologies in #language learning, e-assessment social media in HE, #edtech @WorldwiseCentre",1,0,0,0,1,300
434417084,riogain,Twitly sustenance: democracy /human rights /open source /marine /sustainability /lgbt rights /Gaeilge,1,0,0,0,1,300
2292163718,nat_chriss,Web Consultant | Web design/development | WordPress | Digital Marketing -------  'Time goes by before you know it... Live every moment! Enjoy every second!' ❤❤,1,0,0,0,1,300
1264237807,Umut1Eser,"Head of Machine Learning Research at @CellarityBio

LinkedIn: https://t.co/Kjb6hZtmLg",0,0,1,0,1,300
819346081,DECAYSPEAKS,"Studnt, travel enthu, high-ker, learning, MICAn",1,0,0,0,1,270
3164788608,SocialLuci,"""The power of social media is that it forces necessary changes"" Erik Qualman 
Working with @Spredfast + @LithiumTech helping our customers drive positive change",1,0,0,0,1,121
2833125492,MichaelTheberge,Model,1,0,0,0,1,300
124007320,k_maksymowicz,Instructor & PhD Candidate @DrexelUniv. Senior Analyst @W2O. RT≠endorsement,1,0,0,0,1,300
248578135,astridslegten,"traveler | yogi | loves old music, old art and old stories | has a jar of confetti in the kitchen | doesn't miss an opportunity to make a pivot table",0,1,0,0,1,100
19502638,cnchapman,"Quant UX Researcher @ Google. Coauthor, R for Marketing Research and Analytics, https://t.co/cvlu90CXMD Opinions all mine.",0,0,1,0,1,300
84108585,gardenfelder,"Building knowledge gardens, #opensource #openscience #citizenscience #openaccess #opendata #opentrials #AI #machinelearning",0,0,1,0,1,300
1362087595,VeriUsTech,VeriUs Teknoloji is an university spin-off IT company which develops cutting edge text and social network analytics technology.,2,0,0,0,2,300
100940503,rhlvenugopal,"PhD Scholar👨‍🔬
Center for Consciousness Studies
NIMHANS🏥 Working memory🧠 tACS⚡ Schizophrenia😵 Consciousness🔮 Sleep💤EEG♒ Teaching 👨‍🏫 Rubik's cuber⏹️",0,0,1,1,2,300
569371485,SyedZaidRashid,"Life will seldom play your song, but you have to keep dancing.",1,0,0,0,1,300
3216428061,ICS_SWO_ELP,IT and Cybersecurity Consulting,1,0,0,0,1,144
563645661,ClaraNardiello,#Digital Strategist. #SocialMedia Specialist. #Design Lover.,1,0,0,0,1,262
5012811,gaylemoconnor,Dynamic & energetic marketing consultant. I serve legal technology vendors as well as solos & small to midsize law firms.,1,0,0,0,1,300
1714206488,PropertyShowDay,"Art, Interior Design, Coffee, Travel, Health, Nature, Wildlife #Act4SDGs #TravelBugSA #MeetOurSouthAfrica Instagram @GailMingard",1,0,0,0,1,300
737477204,BraveBosom,"Co-Founder, The Light Collective
Security Researcher
Community Data Organizer 
@stanfordmedx Alum  
#BRCA Mutant

https://t.co/eg3Jcnpo9w",1,0,0,0,1,300
2954263969,PrudyjoLybeck,"I am a special education teacher who believes everyone, no matter age or ability,  is able to learn!",1,0,0,0,1,300
1633220546,CSARNAustralia,City Security and Resilience Networks (CSARN) Australia is an activity of the Torrens Resilience Institute strengthening organisations' security and resilience.,1,1,1,0,3,300
142380031,tenacity79,Cape Town fanatic and data nerd. Views expressed here are my own. #BeTheChange,1,0,0,0,1,300
2546820974,StephanBuettgen,"""Openess"" Advocate but sometimes desperate 😊",0,0,1,0,1,259
3140719674,neurealai,A limitless ability to see the future. #Blockchain #AI #DAO Please join us! https://t.co/NrWr8kWTB2,0,0,1,0,1,300
2948932869,Jasmin_B13,MA Literature Student at University Konstanz - Digital Humanities / Early Modern and Contemporary British and American Studies / (Video) Game Studies,1,0,0,0,1,300
89708234,Sobeub,Designer,1,0,0,0,1,300
95346067,ACM_AdityaMehta,#Startup #Entrepreneur. #ManagingDirector of @edgytal. #MBA from @LBS and #DigitalMarketing connoisseur.,1,0,0,0,1,300
34613879,sselisker,"Assoc. Prof of English @UArizona. U.S. lit & soc sci. Currently researching: fictional social networks, privacy, creativity. suhLISKer, he, views mine.",1,0,0,0,1,300
417950798,MarinaPalmulli,"Changing direction, not destination Follow me just 'cause you're interested. Born analogic, grown digital addicted",1,0,0,0,1,300
78379372,oleandresen,"Senior Director, Product Management @ Confirmit. Technology, Customer Experience, Market Research and other things that interest me. Views expressed are my own.",1,0,0,0,1,300
465897136,ElishaWolf,I love #infographics #dataviz with special interest in data journalism.,1,0,0,0,1,117
182788693,BostjanKozuh,"Believer in value of BI and data visualization, multi-domain knowledge composer and explorer of life.",1,0,0,0,1,300
3152284437,RobertPennant,"OPSEU member, bilingual administrative professional, interested in Google Analytics, writer, copyeditor,  trivia expert,  cyclist,  karaoke singer",1,0,0,0,1,171
3131735176,vhl_brown,A portal for interdisciplinary digital projects in Italian Studies at Brown University. A platform for the encoding & annotations of a mini-corpus of texts.,1,0,0,0,1,241
727152174,Mathis_DHM,"GM, Growth & Innovation @ Comcast NBCUniversal",1,0,0,0,1,300
576950793,alechocron22,"Economics, Marketing, and Social Media • FIU • From Caracas- Venezuela • LinkedIn: Alexandra Chocron",1,0,0,0,1,190
3091149946,light_castle,Light Castle transforms old and new world data into business value. #datascience #NLP #textanalytics,1,0,0,0,1,148
153996258,mathew_irl,Engineer at @evenfinancial,0,0,1,0,1,300
181305600,Margaux67100,Chargée de #communication et #marketing dans une foncière immobilière parisienne depuis septembre 2014.,1,0,0,0,1,300
17096096,strativariously,I have a deep interest in customer and competitive strategy. For me it’s about an organisation’s purpose as well as ability to compete.,2,0,0,0,2,300
119624357,hashtagMILA,helping startups run better w busdev + org psych. also impact investing/ corp gov junkie + all things involving modern cities + #FutureOfWork #opendata,1,0,0,0,1,300
8195862,harshana,Research Fellow - University of Oxford,0,0,1,0,1,300
395418726,BledsoeTweets,Social Media Chick for @TheHickoryTav,1,0,0,0,1,300
134815166,alfauzy,Solution Architect. Worked in small startups & large enterprises. I love how tech shapes businesses and improves lives. Fueled by passion & coffee,0,1,0,0,1,300
1259138874,SocialAsBigData,Applying Big Data techniques to social media data can deliver amazing results. To provide examples of this is the focus of this Twitter account.,2,0,0,0,2,300
130803295,pepperliu,"follower of Jesus Christ / Machine Learning PhD/ 
/interested in coding, math and psychology",0,0,1,0,1,300
38863668,BlendHRM,"A fresh approach to RPO...
We don't sip the kool aid, we make it.",1,0,0,0,1,300
268302257,justonedb,"The Database for Big Data Analytics.
#BigData #Data #Analytics #IoT #M2M #InternetOfThings #EDW #EDM #PostgreSQL",0,0,1,0,1,300
161512724,Tatiana_Dal,"⭐⭐⭐Market Researcher⭐⭐⭐   
#marketing #socialmedia #marketresearch #consumerbehaviour",1,0,0,0,1,300
513293383,mySocializerHub,#MarketingNews #SocialMedia #ContentMarketing #DigitalMarketing #DigitalTrends #DigitalLeadership #SocializerHub #ArtificialIntelligence #DigitalTransformation,1,0,0,0,1,300
70418992,itsridhar,#Qentelli. Conversations. Transformations. Automation.,0,0,1,0,1,300
135088721,Tacitia,,0,0,1,0,1,297
2374887246,GetDasheroo,Track your important #KPIs #businessanalytics #webanalytics #marketing #socialmedia #SMM #sales in one great-looking free #businessdashboard!,1,0,0,0,1,300
435048087,STBW_SEO,Simply the Best Writing is an online marketing company specializing in professional blogging and local social media. Visit our website for more information.,1,0,0,0,1,300
1323204296,huntersearchltd,"Global Search & People Consultancy. CEO + Chair @workbasehr, Snr. Associate @GetTheGenUK @MerlinConsult; IBL @ldavidmarquet; Edi, Sco., EU.
RT =/= endorsements",1,0,0,0,1,300
74518862,hzlnt7,,1,0,0,0,1,300
526490711,CalypsoFugit,"BI Analyst. Econ Master. Traveler. Climate Change Fighter. Sports Nut, but Baseball Fanatic. Researcher. Data Junkie. Esposa. Mama.",1,0,0,0,1,300
143035972,biotechengineer,Life's untold adventurer & A Modern Nomad,0,1,0,0,1,300
14359736,brox,Much ado about something,1,0,0,0,1,300
3087209423,startSmartSM,A hub for all your Social Media Needs - Courses available Online (Worldwide) and Classroom based (Midlands). Twitter/FB/G+/LinkedIn and more,1,0,0,0,1,234
3016959235,frekorder,,1,0,0,0,1,300
2604069066,thehotelgenius,"Twice awarded all-in-one solution for hotels! Hotel-optimized Website Builder, Mobile App & Booking Engine  #startup #digitalmarketing #technology",2,0,0,0,2,300
16666746,RojoVillegas,Responsable Transformación digital en Comfama,2,0,0,0,2,300
1922967420,AgneseElsi,// ADV Strategist presso HT&T //  Instagram: 11agnese  LInkedin: Agnese Elsi,1,0,0,0,1,47
1978775334,clear_europe,"Media trainers, content creators, communication advisers. How can we help you communicate better?",1,0,0,0,1,300
1026064590,bennylove79,"Digital, rocking funster based out of Dubai. I believe in honesty and transparency in everything I do! Have fun whatever you do... insta http://t.co/Z2bTktGVI3",1,0,0,0,1,300
355642935,flopes_patri,Invited Scientist. DHLab. IHC NOVA Lisboa - DH Lab.  #H2020 #GIS #digitalhumanities #culturalheritage #spatialhumanities http://t.co/zoTElsnuej,0,0,1,0,1,300
23341395,hedgefair,Deep Learning Algorithms for Financial Markets ( @qumenta ),0,0,1,0,1,300
478863497,LisaMBritton,Enterprise CSM @Sysomos; living by the motto Keep Calm and Carry On,1,0,0,0,1,300
2863241603,JindrichJurek,,1,0,0,0,1,300
6763242,jptaravella,Digital Transformation - Tweets my own,1,0,0,0,1,300
158279718,Digitalfire_CT,"Digital Fire is an e-mail marketing specialist based in Cape Town and a division of the Spencer Boyd Associates New Media Group, London.",1,0,0,0,1,300
202234075,MikiColla,,1,0,0,0,1,300
142422354,kathybmendoza,,1,0,0,0,1,300
175911300,edwardllorca,"a Dad, Husband, Photographer, & All around good guy.",1,0,0,0,1,300
179901561,monArslan,Lecturer and social media advocate. World Economic Forum Global Shaper and wd lots of passion for humanity 🦋 #Rotary #UOH #Highereducation,1,0,0,0,1,300
2527660260,GDR_pr,"Experienced agency with a track record second to none for PR, Content and Digital Marketing. Get in touch and see what we can do for you: info@gdrpr.co.uk",1,0,0,0,1,300
125316770,SoftwareReport,"Inventors & Copyright holders of #SocialMedia, (C) 1992. 'Your Tweet is the Message!'. From the 1st interactive journal publishers. Est. 1992 @CSELimited",1,0,0,0,1,300
1146957992,zach_guo,"nlp, data-vis, edtech",0,0,1,0,1,67
53500136,infoparadox,Author of The Information Paradox & a globally recognized thought leader in the field of creating & sustaining value from digitally-enabled business change.,0,0,1,0,1,300
69288359,katinamichael,Director Society Policy Engineering Collective. Prof@ASU. Editor IEEE Transactions in Tech & Society @IEEESSIT. Thinking about the future. https://t.co/A4Zrdq6ZSa,0,0,1,0,1,300
59262847,iwonabb,"Machine learning software engineer at Facebook. Opinions stated here are my own, not those of my company.",1,0,0,0,1,300
306246719,hood_math,"Follow the Hood College Mathematics Department on twitter to find out about department events, job opportunities, and mathematics news!",1,0,0,0,1,300
2964626853,dhardmanca,"Tweeting about #AIOps #ITOps #APM, #DevOps, user experience, analytics, technology and random things I find interesting!",0,0,1,0,1,300
152030226,gisellecory,"Exec Director @DataKindUK :::: data science, public policy, #feminism and #dataforgood",0,0,1,0,1,300
34259952,joseborbolla,#datascience #networks #organizationaldesign #education #complexity,0,0,1,0,1,300
2577611760,AllayJake,"Account Executive  @Allay by Day. University of Arizona fanatic #Beardown, San Franciscan by Night.",1,0,0,0,1,300
2373416539,MaryParraBE,"Marketing, Social media, technology. Advocate of human rights and sustainable development! tweets in EN, FR & ES",2,0,0,0,2,300
77544540,telecomattorney,"General Counsel & Corporate Secretary at BT Federal, Inc. CIPM, CIPP/E, CIPP/US. No legal advice; RT/link ≠endorsement.",1,0,0,0,1,300
1426191079,Agora_Research,Audience analysis for research communication.  #DataScience #DataAnalysis,1,0,0,0,1,300
2887315522,AppSharePa,"SharePa App helps you schedule your content to Facebook, Twitter, LinkedIn and other social networks.",1,0,0,0,1,1
2512677432,dfdigitalhealth,PhD researcher Digi Health Sci|big data|smart ex_sci|sweet design|#exercise #activity #health #quantifiedself #micoach #nikeplus #t2dm #igt,1,0,0,0,1,234
103620975,sawlag,,0,0,1,0,1,300
89661685,niksen75,Really just here for the comments. Tweeting and re-tweeting all over the place.,1,0,0,0,1,300
18702080,wwwilson,"Machine Learning, Cloud, Big Data, Open Data, Data Science, Mobile, Analytics, Artificial Intelligence, Teaching. IEEE Toledo Chair. Opinions are my own.",1,0,0,0,1,300
1918262005,InstantPayWorld,WorldwideBusinessOpportunity http://t.co/1GCqJzkYCT @InstantPayWorld  #VideoConferencing #Connect,1,0,0,0,1,300
772109846,ValuecentricIQ,The heathcare industry information portal,1,0,0,0,1,300
1620461342,Dan_SocialBiz,New IBMer and UCONN Alum interested in marketing and Social Business. All opinions are my own,2,0,0,0,2,300
1115378419,NancyLundborg,"Marketing Technologist & Strategist, All Things #Salesforce, #TrailheadRanger, Consultant, Writer, Artist, Mom, Wife, Avid Learner, #WIT, #AvsFan",0,0,0,1,1,300
2203891140,Textras,🎧🕶️ less noise. No 🙅‍♂️'🔴' FOMO. Beta testing https://t.co/IRNWGmCd3g 👉 #DoGood,2,0,0,0,2,300
518595037,coherentmedia,Communications solutions for your world.  Tweets by Norman Smit.,1,0,0,0,1,300
2584515876,theChrisMercer,East Coaster living on the West Coast. Sports Fanatic minus Golf on TV.  Believe people can face any fear if only for 60 second.  Sr. AE for RingCentral.,1,0,0,0,1,300
3043651559,UnchartedSoft,Tough Problems Solved Visually,0,0,1,0,1,124
2600173543,planetdgtl,"Digital Planet is an interdisciplinary research initiative @IBGC_Fletcher, dedicated to understanding the impact of digital innovation on the world",1,0,0,0,1,300
2260660963,OracleMidwestCX,"Delivering an exceptional Customer Experience (CX) is now more important than ever. We help businesses adapt, embrace, and innovate.",1,0,0,0,1,300
537144417,Sound_PR,"Boutique-like | Milan-based PR firm | Member of the #PRGN. 
Fond of I&CT, fashion, 
extreme and outdoor sports.",1,0,0,0,1,300
64190148,HimmiC,"CRM consultant with focus on Tech disrupting Sales, Marketing & Service. Views are mine.",1,0,0,0,1,300
2849380982,mswattsred,"Tech-Savvy, I can do ANYTHING that I CHOOSE to do, Educator-Extraordinaire... I enjoy sharing resources to help others!",2,0,0,0,2,300
1517923556,EJPHC,"Edward Jenner Public Health Consultants, LTD. is a Canadian firm specialized in all things #publichealth related. Visit our site for more info. RT ≠ endorsement",1,0,0,0,1,291
3049891155,tools_daily,"Find every day a new #free online #tool which helps you #blogging, #posting, growing your #community or selling your products!",4,0,0,0,4,289
2988437415,ExpanseSocial,We offer short-term and long-term management of social networks and will work with you to create your bespoke social media strategy | info@expansesocial.com,4,0,0,0,4,277
722982385,DLDolliver,Cyber criminologist and policing scholar @UofAlabama. Director of the Joint Electronic Crimes Task Force (#JECTF). @Northeastern Ph.D. #LetsGoCanes!,1,0,0,0,1,300
32513975,vyerramilli,Surfing the waves of technium,0,0,1,0,1,300
240322056,Altometrics,"Intelligence Amplification &
Data Visualization",0,0,1,0,1,300
34270429,kristinaflorea,#Engineer #BigData #DevOps #Cloud #GoT #ML #AI All tweets and opinions are my own.,0,0,0,1,1,300
2805522666,OptiHub,"Digital Marketing, Website Development, Video Content & Infographic Services Agency based in North London. Get in touch to start your journey.",1,0,0,0,1,129
583819967,NassimaKara,"Vegetarian, interested in technology and innovation. The postings on this site are my own and don't represent IBM's positions, strategies or opinions.",1,0,0,0,1,300
22634780,reckonerofsand,"Technology, complexity and disruption. Also food and football. In no particular order, though preferably separately",1,0,0,0,1,300
3507481,rassami,"Connector, communicator and content producer for tech startups and the creative industries. Co-founder of 2Pears, creators of MME 4.5, Music 4.5 & TechPitch 4.5",0,0,1,0,1,300
15006606,RahulKapil,Come to observe. Stay to play.,1,0,0,0,1,300
261234137,jfrgagne,"Interested in ICT, STS, CSR, AI, Green techs & Economics. I also love Space, Anthropology, World Peace & Bball. Tweets=mine FR-EN",1,0,0,0,1,300
17159147,UTiSchool,"Official Twitter account for The University of Texas at Austin, School of Information",1,0,0,0,1,300
1510711494,FINESCE,Future Internet Smart Utility Services,1,0,0,0,1,300
1051092151,steph_baltus,"Data Sr. Software engineer @algolia, ex @JobTeaser @leboncoin, I tweet mainly about #Data #DataProcessing #DataStorage #Java #Python #Golang",0,0,1,0,1,300
420230080,roistr,Semantic Relevance Engine at Roistr. http://t.co/qTBtoMMIHu,1,0,0,0,1,158
250250950,Janire_com,I love coffee and funny socks.  I write about #marketing #communication and my universe. Let's share our thoughts.,1,0,0,0,1,300
40962216,claudionanni,,1,0,0,0,1,300
795507,offwitz,"changing with the years, optimistic & curious",1,0,0,0,1,300
22515053,mariopaps,Giornalista medico-scientifico e scrittore. Editorialista del Mattino. Direttore di URBES. Vicepresidente di WHIN. Catone il censore. Nato a Roma l'1/6/1954,1,0,0,0,1,300
1662018511,BusinessSoluces,#b2b #b2c #business #marketing #communication #innovation,1,0,0,0,1,300
17901310,ThomasODuffy,"Taking Over The World The Fun Way: Future Reconaissance, Digital Strategy, Multimodal Learning, Life Tweaking, Inner Adventuring",1,0,0,0,1,300
322657116,TParadjanin,,1,0,0,0,1,300
218767331,jawad_a,"Data Analytics and Visualization Consultant at VizFront Analytics. MSc. IT Management (SU), BSc. Business Information Technology (CU).",1,0,0,0,1,252
9192272,monrodriguez,"Researcher & Lecturer. 
Governance of Communicative Space-Times. Expect Tech, Signs, Politics and Follies. Resistance against the Empire.",1,0,0,0,1,300
2991814547,linkfluenceUK,"We've moved. To keep receiving updates, please follow us at -  https://t.co/Bw8Vha5cDf",2,0,0,0,2,300
22129812,denglishtsl,"President, TSL Marketing - Global integrated and channel marketing solutions",1,0,0,0,1,300
88711002,ITAM_Practice,"Passion for People, Process, and Technology!  
My opinions are my own.  We aim to protect the triple bottom line - one process improvement at a time!",1,0,0,0,1,300
611855631,AnnDruce,"I help create clear, relevant communication to reach your target market. Ask me about content marketing.",1,0,0,0,1,300
452505947,RossellaRuggeri,Italian born. Advertising & Marketing Graduate @UniversityLeeds. Digital Manager @Loreal - Social Media Enthusiast.,2,0,0,0,2,300
2178890953,FSOresearch,FSO Research & Information provides business and due diligence research services. Tweets are about research resources and information and privacy policy.,2,0,0,0,2,300
1953795199,iCreateworld4u,"Social Keeda, Start Up, Service:SMM, ORM, Website, Applications, Events.   Contact: reachus@icreateworld.in",1,0,0,0,1,300
2752362081,BlackFuseUK,Dynamically Fusing Business Strategy with all things #Digital & #Social. #Standout #Fuse #accessibility,1,0,0,0,1,300
19903208,PaullieG,Head of Research & Insight @wearesocial,1,0,0,0,1,300
2226491790,ur_digvijay,Three man can keep a secret if two of them are dead,0,0,1,0,1,300
69286539,srocheleau,"Prof à l'UdeS, je m'intéresse à l'analyse des médias, à la circulation de l'information et aux méthodes numériques.",1,0,0,0,1,300
75734047,JulianWoodhouse,"IT worker, Derives happiness from databases, maths, logic, SQL. Caffeine addict + cat slave (Opinions are my own, not my employers)",1,0,0,0,1,300
161008855,weakwire,"Software developer, Gold Olympic, illusionist, founder @pollfish",1,0,0,0,1,300
171276321,jake_wallis,"Researching networks, communications media, politics and the public sphere https://t.co/I15ggGrf1O

RTs ≠ endorsements",2,0,0,0,2,300
22373301,cristinavas,Lecturer Digital Health @SalfordUni #ServiceDevelopment #Research: #digitalhealth #engagement #socialcapital #socialmedia♥#coffee #cheese Initiator @GMKINet,0,0,0,1,1,300
24621862,harrymvr,"PhD student in CS, Boston University. Mainly interested in Data mining and machine learning",1,0,0,0,1,300
278464848,SM_Factory,Expert reconnu en inbound marketing.,1,0,0,0,1,74
563825659,Eliana_Raad,"Ph.D. in Computer Science (Cybersecurity, Data Analysis). I ♡ Socia Media, Business Intelligence and Traveling!",1,0,0,0,1,178
369602514,Anjie_Rosga,"Evaluator, trainer and facilitator for orgs devoted to progressive, systems-level social change. Tweets do not imply endorsement; all views my own.",0,0,1,0,1,300
77117460,V_C_G,"Boutique software development firm is focused on building specialized Internet + Mobile  applications. 
We win awards for our clients. Ready to Launch?",1,0,0,0,1,300
1484478186,amida_tech,Data to the people.,0,0,1,0,1,300
2983095820,kflasinski,"I teach journalism and social media. I research London's organizations in social network sites. Dep. of Media and Comm., U. of Szczecin / research in London",1,0,0,0,1,128
306815528,DrDeniseVultee,"Lecturer, Department of Communication, Wayne State University",1,0,0,0,1,300
2347572252,IMSReport,Gain insight with prescriptive analysis of media spend and frequency for DRTV and Retail industries in the US and AUS! http://t.co/gGd2YtedAE,1,0,0,0,1,300
2173478716,Marketing_Jamy,EU & IoT Marketing Lead at the Eclipse Foundation GmbH. Passionate about Marketing and all around #IoT. Opinions expressed are my own 🥰,0,0,2,0,2,300
2993638287,JustHeatherBree,"Data scientist, web developer.",1,0,0,0,1,300
2615862902,Chemtech2020,Interested in Bioinformatics N Cheminformatics Software Development Tools. Social Media Enthusiast.Techfreak. Digital Marketing. Data Visualization.,1,0,0,0,1,300
359172762,DGPerryman,"Leadership development, Meeting Apps.  Join my facebook group at http://t.co/S3mvQ1vVIp http://t.co/7kcPqG1FM2",2,0,0,0,2,300
279783715,jerodclabaugh,Evolutionary Biologist & Head of Product @catalyticdata - Building software for the brightest minds.,1,0,0,0,1,249
2531991480,NMithrush,"Growth & Marketing Professional
Co-Founder, Moon Shot Consulting Group",1,0,0,0,1,300
70636484,isabelontoso,Branding 3.0 Marketing y Comunicación. Madre de tres hijos. En estado permanente de aprendizaje y disfrutando del camino.,1,0,0,0,1,300
47764714,pedropombo,"Digital guy at Accenture. Opinions are my own. Love all things digital, producing electronic music, cycling, and chess. Father of three.",1,0,0,0,1,300
172819835,lcismee,She/her. Communications strategist and mezcal enthusiast. Will travel for food. Views own. Cover photo: Aaron Durand.,1,0,0,0,1,300
11401032,aspgems,"We help your business into the digital age by developing all kinds of applications, such as management tools, big data and social networks.",1,0,0,0,1,300
2385235196,ExeterQStep,The University of Exeter Q-Step Centre | #DataAnalysis training for the #SocialScience   https://t.co/BEIl9ZF6xC,1,0,0,0,1,300
16120644,Webtorials,"IT Knowledge for IT Professionals. Syndicated Research, Analysis, Reports, Surveys, Content Development. Covering innovative tech providers. 30,000 subscribers.",1,0,0,0,1,300
2770173248,Internautmedia,"Online Exorcist, Demon Mediaologist & Master of the Digital Arts of Social. It Ain't What You Say - It's How You Say It.",1,0,0,0,1,300
39026109,oscaroboto,"Data Science, Data Engineering, Machine Learning, Deep Learning, AI, Spark",1,0,0,0,1,300
624819458,atul_kedar,"Technologist. Current interests - #bigdata, Semantic Web, Linked data, #mongodb, #machinelearning, content management, data analytics and amateur photographer.",1,0,0,0,1,300
1106710388,ToddRLloyd,"Major Accounts @cloudera, a big data industry leader in open source technology - father, runner, A's & Sharks fan.",1,0,0,0,1,300
179009024,NikolajEhlers,"Nuclear notes on MEDIA - social as antisocial, RUNNING - fast as slow, MUSIC that rocks - attitude wise, not limited by genre - Retweet a lot..",1,0,0,0,1,300
102345161,zehnzehen,All about #Journalism  #Algorithms #Automation @BKCHarvard Affiliate; #Nieman Fellow '19; team lead @br_data; #SlowJournalism with @butterland_team,1,0,0,0,1,300
2594911428,tzunami_bomber,#physicist #developer,0,1,0,0,1,300
15656197,bver_en,"Neural nets in speech recog., NLP, evolutionary computing, ML in general. 3D print. C++, Ruby, JS, CUDA. OpenSCAD.

@twilio (formerly @ytica). Opinions my own.",1,0,0,0,1,300
2984831203,DataDynamicsLab,,1,0,0,0,1,15
110757525,danilodelara,"Digital Designer & Developer  

#GraphicDesign #WebDesign #MobileDesign
#aspNet #cSharp #php #java #html5 
#mobile #marketing #UI #UX #SEO #SEM",1,0,0,0,1,300
36054494,henrytimms,Leading @LincolnCenter; championing #GivingTuesday; thinking #newpower - “New Power” from @PenguinRandom out now https://t.co/PmdiFAxIBE,0,0,1,0,1,300
94300392,arshiwasique,,1,0,0,0,1,300
80653733,normanhh3,I genuinely enjoy the challenge of solving problems through the application of software engineering methodologies and practices to provide value to users.,0,0,1,0,1,300
443003108,cseminar2011,PhD @unccharlotte 2015. Currently Adjunct Asst Prof of CompSci @DavidsonCollege. Recommender Sys and CompSci Ed researcher. Former IBM Project Executive.,0,0,0,1,1,300
34698396,juandavidcruzgo,,0,0,1,0,1,300
15046368,iyadb,AgilePM® | Digital transformation |  IT Manager.,1,0,0,0,1,300
66488983,roudrhiri,"Entrepreneur, Investor, Technologist and Growth Acceleration Strategist",0,0,0,1,1,300
34339576,MichaelCAJansen,"CEO @Cityzenith5D. Architect, urbanist, entrepreneur, public speaker, global citizen. Journeying on a mission to transform life in cities around the world.",1,0,0,0,1,300
2945022449,twittoolsapp,"A selection of Twitter tools which include finding people you follow who don't follow you back, or inactive users. Visit http://t.co/sFwGMVp6Co",3,0,0,0,3,300
15458345,Tex_Brieger,Director of Distance Education at Gannon University,1,0,0,0,1,300
1220921,lilzeon,"Founder @REUPagency, home of creative misfits | Paris | Amsterdam | London | Tokyo.

Art is long",1,0,0,0,1,300
1615474831,stucflo,"I help new entrepreneurs and small businesses build their online presence through website services, podcasting, and improving their SEO efforts.",1,0,0,0,1,300
1155483128,socialIT4all,#socialIT is propelling #CIO’s #ITpros #ITSM #ITIL & #ITDepts everywhere into the ERA OF SOCIALLY DRIVEN #IT #Mgmt. Get your #Tech on in 2015!,0,0,1,0,1,300
259141162,excapite,ex capite a Designer,0,0,1,0,1,300
362722386,caitmariebee,"Market Research Associate @ Katana - Former Athlete, Fitness Enthusiast, Hard Worker, Accepting of Challenges, Ready for Anything, Bring it on Life! #GoGetter",1,0,0,0,1,300
226279515,ABA_Advertising,AB&A Advertising | We Speak Human,1,0,0,0,1,300
15414384,EmilyCBaxter,"Qualified coach, business and technology marketer, fan of tea and conversation. English sounding Aussie. Views are mine. Now at Pexip.",1,0,0,0,1,300
1862535978,awayforabit,"Adviser, coach & writer on managing online legacies & preserving digital memories. Remembering DB, always. Share your memories & ideas with @awayforabit.",4,0,0,0,4,300
22353327,thevarnish,Digital workplaces and intranets. Knowledge management and making technology do the work. Good food is my favorite. I drink and I know things.,1,0,0,0,1,300
729295687,MstUs,"Providing solutions globally in Data, Security, and Maritime! Integrating Technology, Providing Solutions",1,0,0,0,1,300
2857158023,s7sombrero7,eCommerce + Social media marketing + Tecnología y diseño,2,0,0,0,2,118
46805439,submitedge,"We are one of the Most reputed #Online & Local Business #Branding | #SEO | #SMO Company; Tweeting insights, latest offers, #service features, strategies & more!",1,0,0,0,1,300
223235565,muninJLM,"CEO @MadeinJLM | Fellow, Facebook Community Leadership Program #FCLP | WeWork Creator Awards | Forbes #Under30 | https://t.co/8iySAgcVUh",1,0,0,0,1,300
282847552,sifisof,Relentless Innovation.,1,0,0,0,1,300
1724294304,jay_raval5,Got Million Things to Do★,1,0,0,0,1,300
19511192,gdouglassjaimes,"Ast. Prof of Environmental Analysis focused on urban health equity, through geospatial and qualitative analysis to understand the dynamics of health inequality.",1,0,0,0,1,300
2549153414,Sakkaamarin,"Compassionate, religious aligned, programing program, innovative thinking in Society, truth loving, integrity MBA; A PEOPLE.",1,0,0,0,1,295
2872257299,paulcdjo,"Mainly science: statistics, genetics, evolution, ecology. @UCU member. 🏴󠁧󠁢󠁳󠁣󠁴󠁿🇹🇿",0,0,0,1,1,300
17296455,rvailleux,"Organisational Coach enabling more effective teams #retail
Former coFounder @Hop_Cube (now a Greenflex company #sustainability #data)",0,0,1,0,1,300
1008153102,HemantSurale,"HCI Ph.D. Student @UWaterloo | @Snap Fellow | Prev: @Snap, @MSFTResearch, @focalsbynorth, @NetApp, and @Oracle.",0,0,1,0,1,300
1198888650,EsauVT,Computational Linguistics - Natural Language Processing/Understanding #NLP #NLU @LyR_UAMC @uamcuajimalpa & #baker,0,0,0,1,1,300
636327724,techresistant,Unix user. I help people communicate effectively.,1,0,0,0,1,300
493552776,LAGasieniec,"Born in late sixties, have lived since then with all the consequences ...",0,0,0,1,1,300
145139440,gsandahl,Co-founder and CTO of Unomaly.,0,0,1,0,1,300
2752721082,socgracesmedia,"I do social media voodoo & teach others to do it, too...throw in some branding & a dash of digital marketing = pure magic!",1,0,0,0,1,300
36807370,ielmerehbi,"#SyntheticApertureRadar (#SAR) Engineer @Iceyefi , Marine #Geophysicist (MSc) & #DataAnalyst. #RemoteSensing #Geophysics #Python.",1,0,0,0,1,300
15977008,AngelosTzelepis,"Data Architecture & Visualization. Shopify websites. Ebooks. Homebrew, cooking, cycling, rowing, lifting.",1,0,0,0,1,300
386283359,KhryzGutierrez,,1,0,0,0,1,300
381721455,Classemapping,"To teach and to learn in 21 st century: Digital, Blended Learning, MOOC, Visual Thinking, Multiple Intelligences, EdTech. Teacher, trainer, strategic monitoring",1,0,0,0,1,300
132947557,spirinus,Delivering digital transformations with AI @tryGigster. Crazy Entrepreneur. Data Scientist. Athlete. Alumni @IllinoisCS @Phystech @Facebook.,1,0,0,0,1,300
144150889,Cetrulin,"Data Scientist @CeADARIreland. ex-@DeloitteIreland. #ArtificialIntelligence 
4yr part-time PhD Candidate @UC3M. #MachineLearning,  #Coffee, #Coding & #Traveling",1,0,0,0,1,300
2371783172,CloserGroup,"A Data Science company specialized in Business Intelligence, Advanced Analytics & Artificial Intelligence 
#ToChallengeComplexity #DataScience #AI #BI",1,0,0,0,1,300
70582478,catgildea,Tech News / #womenintech /PADI Certified/ Travel Is my Passion/ #MBA / #Changing the way we think https://t.co/30AOQ278Jj,0,0,1,0,1,300
724499413,OnurOzuduru,"Leave the machines alone, they can do it! #ComputerScienceJunkie #Learner #Dreamer #SlaveOfMyCuriosity #MathLover #Human #WantToBecomeAMachineTrainer #Somebody",0,1,0,0,1,300
2929071817,seo2015website,,1,0,0,0,1,160
2519007301,anbuteau,"Helping people and organizations grow @pnrconsulting
Current 🤔: Large system change, complex systems
Always 🤔: Strategy, BizOps, jazz, 🥩, fitness & hockey",0,0,1,0,1,300
18930886,rastin,"I make apps for science - software architect, founder of @rmdstudio @anahitapolis and @BanuScience into #OpenScience #OpenAccess #CitizenScience #OpenSource",1,0,0,0,1,300
139620847,ishaghosh,"Book worm, Theater Buff, Communications Analyst, Student at Rutgers MCIS",1,0,0,0,1,142
249260397,brad262run,"Tweets about this, that, and coffee ☕️ runner🏃‍♂️ cyclist 🚴‍♂️ traveler🌏🌍🌎",0,0,1,0,1,300
1350923360,rab7599,"GIS, All things Spatial. Interests include maps, history, science and the data visualization as they relate to maps and Geography. Views are my own.",0,0,0,1,1,300
14061352,GeorgePotts,President & Founder of Fifth Influence - Ad Geek - Servant Leader - Duquesne Bball Fan - Most Talkative Gateway Sr. Class 1989 - Voting for @JoeBiden!,1,0,0,0,1,300
145359185,AhmadElTannir,,0,0,1,0,1,143
76349393,nrglassman,"Assistant director for informatics at the D. Samuel Gottesman Library, Albert Einstein College of Medicine. (don't let the pointy ears fool you)",1,0,0,0,1,277
15188764,joannahicks,"so much good stuff: art, knowledge management, travel, information management, cats, agile, books, digital, community",1,0,0,0,1,300
308465213,stpapoutsos,"Convergent marketer-technologist. Fluent in #digitalstrategy, #analytics & international #bizdev. CS teacher & #edtech expert. Deputy Program Manager at HIO.",1,0,0,0,1,278
18354981,ellentos,"Researcher at Norut - a research institute in the arctic,  #SeriousGames, #exergames for Elderly and #eHealth; some tweets will be in Norwegian",3,0,0,0,3,300
338493070,DustinBrown12,Dallas based customer experience expert. I am on a mission to help brands and others be more effective. Excited to be of service.,1,0,0,0,1,300
2742557780,bournecleaning,Your affordable & friendly cleaning company.Domestic & Commercial £10 per hour. Call 01202 5164466 for all enquiries or book your clean online today.,1,0,0,0,1,222
1106465318,GuidoRamini,"30 years old, graduated in Multimedia Communication and Journalism, video maker and photographer.. I like to travel and cooking. I love culture, arts and music",1,0,0,0,1,300
2858178181,ITBMediaOnline,We love to help our clients create a growing marking system both on and offline.  Follow me @nancyadkins,1,0,0,0,1,192
140354123,FilipHunek,| Senior Digital Business Consultant at ACTUM Digital | Ph.D. Candidate at Faculty of Social Sciences in Prague  |  Visual communication and everyday enthusiast,1,0,0,0,1,300
2285820662,SelenamTurner,Web and Graphic Designer | Globe Trotter 🌏 | Football enthusiast 🏈 | #digitalmarketing #webdesign #uxdesign,1,0,0,0,1,300
2802964771,KenJRock,#Passion for #Entrepreneurship #Business #Sales #IoT #M2M #Fitness #Cloud #NBA #BigData #Cybersecurity #Cloud #Leadership #Salestips #SocialMedia #Technology,1,0,0,0,1,300
220426464,mtrgina,"#Data #analysis #entrepreneur, founder of #BellaDati. I believe in human touch enabled #enterprise #agile data platforms# for #cloud and #mobile devices .",1,0,0,0,1,157
262476988,samolkhoeurn,"used to be a child and now a man, and will be old !",0,1,0,0,1,300
819029120,PanuHeimonen,,1,0,0,0,1,300
27915665,RobinZucker,"svp mktg, WORLDZ (bringing together influential business and cultural leaders), led mktg @playboy, started social mktg @yahoo, mom, traveler, up for what's next",1,0,0,0,1,300
40839245,recruitsolution,"Director at Hays UKI & EMEA for technology and James Harvard @teenturn Director. Dad of 3, playing football for AFC Drumcondra and supporting Luton Town FC",1,0,0,0,1,300
28032255,Savvy_Web,Find us on FB http://t.co/rUM04qEIgD We focus on creating beautifully designed and effective websites to match the requirements of our clients.,1,0,0,0,1,300
196007170,cvsekhar,"I don't know anything, still learning. Interests robots, distributed systems, machine learning",0,0,1,0,1,300
14611922,rjpalmer,"Generally decent chap, interested in global digital strategy, coffee, and craft beer.",1,0,0,0,1,300
897437593,kbrunner1,,0,1,0,0,1,300
123378347,Colab_AUT,Colab is the collaboratory for #Design & #CreativeTechnologies at the Auckland University of Technology @AUTuni,1,0,0,0,1,300
540626694,everyxs,,0,0,0,1,1,58
2858513438,LeonChleon,Providing Organizations with expectional customer experiences by delivering technology through engineering excellence and integrity!,0,2,0,0,2,300
2881297988,therealhingley,"#SMB fan, I want to help you grow! Married to @janinepopick #Marketing #SMM #SocialMediaMarketing #ilovewine",4,0,0,0,4,300
2247046980,charlNge,#Art #Medias #Socialmedia #Running,1,0,0,0,1,300
1535807893,aligorithmic,"""... all others bring data""!",1,0,0,1,2,300
21867403,caosorio,"Logistics and Supply Chain Management, Humanitarian Logistics, Applied Operations Research and Analytics, Computational Sociology",0,0,0,1,1,300
275407652,alibakhshi94,,1,0,0,0,1,300
121191600,JohannJBBeukes,#DataScience #MachineLearning #AI #PredictiveAnalytics #PlantBasedDiet #MartialArts #Fitness #Levatas https://t.co/PstVUm2TjG,0,0,1,0,1,300
2748636846,troopsocial,We help local businesses and online entrepreneurs turn their ''vanilla'' social media accounts into profitable lead generation channels.,1,0,0,0,1,300
1693770000,ImpactSocialMe1,Impact Social Media is a Kansas City based digital marketing agency. We’re a full service advertising firm offering digital marketing services for B2B and B2C.,1,0,0,0,1,300
273992943,hashtagify,We help you find the best Twitter & Instagram hashtags and users for your needs.,1,0,0,0,1,300
290692353,kbio79,Barça fan,1,0,0,0,1,300
1329115694,masarweh32,"MD, Views are my own.Pathology enthusiast & research lover. Fan of #surgical_path. #pathology #anatomical_pathology #Clinical_pathology #histopathology",1,0,0,0,1,300
338941617,LussierY,"#Physician, #Scientist & #Entrepreneur #globalgoals, transforming #health with #PrecisionMedicine, #Genomics & practice-based evidence, #quantifiedself #BigData",0,0,0,1,1,300
2600410856,buzzbold,"We help mission-based orgs grow relationships, revenue, & capacity with digital systems & engagement strategy.  Tweets from @sleystl and guests.",1,0,0,0,1,246
17067017,marnovo,"VP of Product & Operations @sourcedtech⠀|⠀AI, product, tech, biz, finance⠀|⠀fisherVB, GS, S&P, IE, USP et al. alumni⠀|⠀mentī quōlibet īre licet",1,0,0,0,1,300
194190511,RickBoerebach,"Digitaal Rechercheur @HuntedNL S04▪Onderzoeker MTI/TDO (#TeamDascha)▪Digital Forensics , WebDev & CyberSec▪Co-Founder of @eFabriekBV ▪ @ZEEFcom ▪ @NetworkTables",1,0,0,0,1,300
42741784,rmehtaus,#CIO at Visteon (Nasdaq:VC) CIO 100 Honoree - https://t.co/kQYpcegZx3. Computerworld Premier 100 IT leader.#datascience #iot #bigdata,1,0,0,0,1,300
2726477973,Jamjuicemdia,Specialists in digital marketing and design. We help our clients get their message across in the digital world using a variety of strategies.,1,0,0,0,1,300
19770043,jmbronoel,"Software exec, husband, father of 3",1,0,0,0,1,300
323283992,RSEHeadhunter,"Headhunter. CV Writer. ""Glitter Shitting Unicorn""",1,0,0,0,1,300
2876570077,maggiejlpearce,Co-founder of USgeocoder: location intelligence technology providing geocoding and district matching services. Looking for business partners.,1,0,0,0,1,158
2876541730,DataVizAI,Tweets about Cool stuff related to #DataViz #PixelArt #AI #MachineLearning & #DataScience,1,0,0,0,1,300
2851427561,RiverbedLimited,Riverbed is a solutions provider working closely with Microsoft tools and frameworks to deliver timely and much needed solutions to your business.,1,0,0,0,1,215
2284050692,andy007adams,Security and More,1,0,0,0,1,300
2873535341,mar_socialmedia,| #Entrepreneur | #SocialMediaExpert | #SocialMediaMarketer | #BusinessOwner | #InternetMarketer | #SocialMediaJobs |,1,0,0,0,1,300
704693905,SSagrati,"Building Strategic Partnership, Alliance Marketing Manager, love my daughter Alessandra, tweets are my own",1,0,0,0,1,300
21629745,CMPLYTom,"CEO, CMP.LY - Transparent communications by brands and their advocates to build trust, improve engagement and evaluate ROI.",1,0,0,0,1,300
126344511,pat31415,"Interested in consciousness, python code and data.",0,0,1,0,1,300
37283473,jaiderog,"Seguidor del dataísmo. Trabajando en inteligencia estratégica, gestión del conocimiento y un poco de minería de datos. Me encarreta la ciencia abierta",1,0,0,0,1,300
2242044090,AudreyMatty,"Founder @Phoensight  Lovin' my lil' un, #OSS & #OpenGov advocate, physicist & economist. Lover of life, nature, music and good food.
#OpenPolicyDesign",0,0,1,0,1,300
75286451,EZieglerSch,Curieuse des usages des nouvelles technologies liées aux données #analytique #bigdata #IoT #AI #RGPD #marketing #politique Mes tweets sont mes choix.,0,1,0,0,1,300
156212837,jangojarango,"private account of me, formerly PhD Student @TheOfficialMRL, @HorizonCDT; founding member of @otelos vdf. loves puns, music, and figuring things out.",0,0,2,0,2,300
114104424,JMHelbling,"Visual Designer/Researcher/Consultant. In summary: I connect dots (social network analysis), and tweet about design, technology, society and all of the above.",0,0,1,0,1,300
2808820167,bitbits_,Digital memory of #TechNews: #BigData #DataScience #IoT #Cloud #3D #Videogames #VFX #Animation. English and spanish RT's.,2,0,0,0,2,300
39449923,bharatsg,Commoner; Web fella working at IBM. (All opinions posted are of own.),1,0,0,0,1,300
1921143163,Joyce_xinranLiu,"CPG marketer, digital marketing analyst, passionate about film, cooking and travel",1,0,0,0,1,300
128075860,DgtlMrktgWhiz,#DigitalMarketing | #MarketingAutomation | #DemandGeneration |  These are my personal thoughts and opinions,1,0,0,0,1,300
15581480,DCorney,"Data scientist, interested in text analysis, social networks, AI, ML, NLP... and now fact-checking @FullFact (personal account)",1,0,0,0,1,300
2842902113,sarah__iams,Applied mathematician. Newspaper reader.,0,0,0,1,1,297
32386320,fabiorojas,Sociology prof @ Indiana & Contexts mag editor. https://t.co/rIXWVGRYhF Buy my books! https://t.co/vqhljrJQ46…,1,0,0,0,1,300
1284346260,EmmanuelYera,Director of Product Engineering @primer_ai | Previously: Data Scientist @quid | Studied CS @SJSU/@SFSU & Bioinformatics @UCSF,0,1,0,0,1,300
53949806,parapontisj,"A Data Explorer: 
Data is the final frontier to expand our knowledge. To explore new datasets, to seek out new insights & boldly go where no man has gone before",0,0,1,0,1,300
367370294,petitelibrarian,"Florida State University Humanities Librarian for Classics, English, Philosophy and Religion.",2,0,0,0,2,300
20231255,DataAficionado,"Data Analyst, former Microsoft Data Platform MVP, speaker, geek, skydiver, private pilot, a little crazy.. that's me :)",1,0,0,0,1,300
65305100,gunjsurbhi,"Strategic Designer-Product innovation-UX  | Life-long learner | Current interests: Systems thinking, Transition design and Sustainable futures.",0,0,1,0,1,300
22902932,roserrr,"Lecturer in Digital Social Sciences at Cardiff University School of Social Sciences. Interested in digital social life, social interaction and emotions",1,0,0,0,1,300
498942211,hammamc,,1,0,0,0,1,300
1205238193,HamptonConsult,"We work with local companies to jumpstart their online marketing! We also specialize in Website design. Located in Pottsville, Pa. Call Today! 570-516-5766",1,0,0,0,1,300
410991743,rushedKanawati,"Silence is one of three: a knife, a star frame, or growth of a tree. (M. Darwich)",0,5,2,1,8,185
71296111,jeremiahkjones,"Co-founder: Sentius, Madra, Techuity, Stretto | tech/data/economics nerd | author | pianist | husband & father",0,0,1,0,1,300
2797652043,CaSMaResearch,"ESRC-funded project based at @HorizonDER, researching citizen centric approaches to social media analysis (#CaSMa). Tweets by @arkoene, [CJC], [EPV] & [RS].",1,0,0,0,1,300
543608814,scorritori,"Monitoring #socialmedia trends and their impacts on the #financial industry space, specifically in #transaction account applications for @cbsiservices.",1,0,0,0,1,300
75234745,wimvanleuven,"Data engineer, Co-organizer https://t.co/lfa7gjYad7, Technology Leader, Hands-on, Ronin for Hire",0,0,1,0,1,300
162092824,minibota,,1,0,0,0,1,300
247734722,Twinqel,"Interested in the meeting of: science & society; (Information)technology & everyday life; brain, mind & body; politics & economy; digital stuff & education",0,1,0,0,1,300
166671772,Steve0verton,Technology Consultant Helping Organizations Combat #Fraud and #FinancialCrime Efficiently and Maintain #Regulatory BSA #Compliance. Stay the Course.,1,0,0,0,1,300
21015156,sbelak,Philosopher-hacker. Sometimes theatre director. Making myself obsolete at @Metabase,0,0,1,0,1,300
2846717361,RotmanCapstone,"Using models, data-based decision-making skills, and live cases from real companies to teach MBAs how to solve real-life business problems",1,0,0,0,1,226
1658766360,apptheneum,A new concept in science publishing - apptheneum: A content discovery engine and cross discipline publishing platform for STEM based fields.,2,0,0,0,2,300
41826526,pshiralk,,1,0,0,0,1,300
91136680,prajdhan,"Researcher @PIK_Climate interested on #ecosystemservices, #foodsecurity #SDGs, #climatechange impacts/mitigation/adaptation
RT ≠ endorsement",0,0,0,1,1,300
17447187,profdavidhudson,Politics. Development. Public engagement. Leadership. Migration. Running. @unibirmingham @iddbirmingham @CoSS_Birmingham @DLProg @DevEngageLab,1,0,0,0,1,300
574406795,LuisGmoyano,"Researcher at CONICET/FCEN, interested in networks and data science",2,0,0,0,2,300
168249508,thejsalvatore,Research is what I'm doing when I don't know what I'm doing. Commercial #data scientist (@ideafinancial) & educator (@FIU/@UnivMiami). Lifelong learner. #VFL,1,0,0,0,1,300
164014494,tanototo,I was born.,1,0,0,0,1,300
7455102,oschneid,"Assistant Professor, University of Waterloo. HCI, haptics, multisensory computing, design. Member of @uwhci, @WaterlooEng. he/him, they/them",0,0,1,0,1,300
1246333579,sjpiatek,"#DigitalStrategy, PhD researcher and lecturer @CIMethods, @warwickuni interested in #SocialListening, #FakeNews and #Disinformation narratives",1,0,0,0,1,300
481116797,MrGeekOfficial,"Technology, News, Social Media, Tips & Insight",2,0,0,0,2,300
17845089,rlabelle,"Consultant, African Development Bank (AFDB), Innovation Lab.  Tech, innovation, digital econ, trade, jobs,youth, startups,@58 countries. Tweets R mine only.",1,0,0,0,1,300
16471063,orekdm,"Systems Generalist, Independent Librarian, Blue Team Maven, Low-Tech Futurist, Gamer",1,0,0,0,1,300
114626870,jc_robinson,CEO and Software Engineer at Next Mountain,1,0,0,0,1,300
28249740,d4tocchini,Founder @thegrid ★ Creator https://t.co/vtRyMNW5vW,1,0,0,0,1,300
121552443,pawelpankiewicz,"Curious by nature and life loving by choice. Half IronMan and a Compressive Sensing Ph.D., fellow.",1,0,0,0,1,300
2839587229,Fleetelligence,"Big Data = Big Money and Big Safety for fleets in Oil & Gas, Transportation and Construction. Operations Analyst, High Risk Trainer and Fleet Technology Broker.",0,0,1,0,1,300
165027072,bartsmeets86,dataroots co-founder | entrepreneur | passionate on anything data science & data engineering | dad | mountaineer | trail runner,1,0,0,0,1,108
95509514,ScoAnderson,Helping enterprises tell stories with data intelligence. Interested in active pursuits of the mind & body.,1,0,0,0,1,300
2464576417,ddk_world,"Building innovative products & stories using data. We collaborate, create and deliver",0,0,1,0,1,300
345739077,JoeBBayer,average Joe Prof @OhioState □ social tech □ social nets □ mobile things,2,0,0,1,3,300
2464828177,keeghin,"VP of ML @itsarthurai, adjunct professor @Georgetown, co-founder @CamlisOrg.  alum @wlunews, @UTAustin, @sfiscience.  monoids, fixies, yes and.",0,0,1,0,1,300
447381185,LivanAlonso,"Data Scientist at @NavPortData interested in Oil Industry, ,Healthcare, Data Science, Computer Science & Mathematics. Love skiing, soccer http://t.co/jLuEqIVVqH",0,0,1,0,1,300
17991067,dougspadotto,"Works with IT, loves big and open data. Cooks, reads, travels, writes sometimes.",1,0,0,0,1,300
529726983,MathsManual,"The authors of this book started at 6, 9 and 10 years old. It makes Maths fun and easy for all http://t.co/CMb7hmVBHz and SOLD OUT on http://t.co/FS90NXQ4b9!",1,0,0,0,1,300
2442808350,ChrisPallack,"Chief Digital Officer @SmartCityNtwks @SmartCityTelecm @AppBurst. #Digital, #Technology, Network Strategist / Photography Enthusiast.",1,0,0,0,1,300
18717699,AshishB0,Digital evangelist|Aspiring writer|Cricket enthusiast|RTs are not endorsements,2,0,0,0,2,300
96601887,drtahirrashid,"Senior Lecturer in Digital Marketing at Salford Business School, University of Salford UK",1,0,0,0,1,300
526231573,SabineBendixen,"Enthusiastic #Agile & #DevOps Enabler @getNextIT Coach, author, speaker, lecturer, community manager @InDevOps_Titan",1,0,0,0,1,300
1146708877,ATALLC,"The #FullStack #DataScience Company - Integrated, Enterprise-scale Data Science for Sensemaking. Unifying Infrastructure, Data & Analytics #Design #Build #Learn",0,0,1,0,1,300
626645206,LuxLudo,Lexical Data Manager @reportlinker // #openaccess #opendata #linkeddata #semanticweb,1,0,0,0,1,300
2754884053,Inferences_om,"Inférences est un cabinet d'études expert en analyse sémantique. Il a créé Opinion Miner®, sa solution d'analyse semi-automatique.",1,0,0,0,1,300
17140856,Sobaka,"PhD in Futures Studies, Digital Innovation, Global Security,  Information War, Global Governance & Africa's Rise",1,0,0,0,1,300
91492875,Ahmad_Yo,"I’m an assistant professor. I have a Ph.D in CS from UC. I like social media, research on AI and machine learning.",1,0,0,0,1,300
1665025656,_LinnaGao,neuroscientist turned marketeer--interested in all things puppy or piano related. Opinions are my own,1,0,0,0,1,300
137994769,adtsakal,Research Associate at @turinginst,1,0,0,0,1,231
100973128,nooraalanne,Growth director @Medialiitto & Exec. Director @mediasaatio. PhD on media & platforms @AaltoUniversity & @UCBerkeley. Tweets related to media in Fin & En,1,0,0,0,1,300
522161550,colinmolter,"Chief Data Science @AXAinBelgium, entreprenor, science/tech lover
0x221Ba017e0B2ba88cA7C0D92d5106bE4741d2DeA",1,0,0,0,1,300
1887310218,dnrz33,"daytime office asshole for living. nighttime cyber security, programming, blockchain, information systems. nowadays i also tweet about middle east conflict",1,0,0,0,1,300
2576820571,AlgotSearch,Algot Search is an executive search firm specializing in #trading & #technology #quants #developers #traders #jobs         Get in touch - info@algotsearch.com!,0,0,1,0,1,39
1400132136,SanjeevK_,#Innovation | #Analytics & #BI Evangelist | Author | #DeepLearning | #ArtificialIntelligence | #AI | #MachineLearning | Data Scientist | Entrepreneur,1,0,0,0,1,300
195486777,tonistubin,Tech communications professional who just loves a good story - especially if there's some serious data involved.,1,0,0,0,1,300
115625173,infelag,Corporate Media & Content Marketing Agentur | die Spezialsten für Content von Analog bis Digital,1,0,0,0,1,300
1425936180,tugboatdigital,"Empowering businesses to grow and thrive, online",1,0,0,0,1,245
381347604,techDarshan,"Director, Product, Platform and Ad Tech Management @official_sph. Technologist at heart, passionate about building innovative products in Media and AdTech.",1,0,0,0,1,300
63064658,emma_church,Consultant @ a data science consultancy.  Passionate about transforming the power of data into meaningful insights for my clients. Devoted mum of two!,1,0,0,0,1,251
532511589,TheNikkiJones,"Promoter of #retailer, shopper, #CPG industry news. Follower of social media, #CX, #marketing strategy, insights, & the Oxford comma.",1,0,0,0,1,300
2811235268,DataCracyToday,"DataCracy is a social network to quickly share data driven arguments. Through simple plots.
Request an invitation on http://t.co/g8MSu9bFuV",1,0,0,0,1,300
178248818,mkajava,#MachineLearning. #CloudArchitecture. #API. #OpenData. #MaaS. #Micromobility. Founder @aavista360 The Data Refinery Company,0,0,1,0,1,300
145767295,sociabilities,Sociabilities...because it's all about your social media capabilities. Tweets by @SeanScannell,3,0,0,0,3,300
2176606374,MktRiskPartners,We help our clients manage the risk of doing business globally.,0,1,0,0,1,17
21308312,richardm_,"Lecturer (Univ. of Glasgow): Specialized in real-time search, event detection, summarization, social media, crowdsourcing, big streaming data",2,0,0,0,2,300
287369645,BasilHayek,"Product, Data, Healthcare, Innovation, General Hackery",1,0,0,0,1,256
2412334885,bergautier,"data scientist @Babbel, Dr. in economic geography. Interested in #R #SNA #NLP #ML #Python",1,0,0,0,1,272
400983214,JEFbabe,"loving life in wine country in Niagara, interested in current events, great food, great recipes, good music, great outdoors, animal lover & wine lover",1,0,0,0,1,300
27845032,bod0ng,"Assoc Prof at @UMNews @UMN_CEHD. Lifelong kindergartener. Interested in learning, tech, data, networks. Tweets = my own views. 🇨🇳🇨🇦🇺🇲🌎",1,0,0,0,1,300
1882554774,360socialme,"Uncover real-time and 100% verified information about anyone and start building your network. Discover. Connect. Communicate. Always!
https://t.co/rv2y6Pv2EH",1,0,0,0,1,280
141836044,stasianik,"Cognitive Science Ph.D., musician, just another system unfolding. Brain networks, volition, conscious experience, and philosophy/art of life.",1,0,1,0,2,300
1548377478,sorafy,Postdoc in neuroimaging @bdi_oxford,1,2,0,0,3,300
2451308594,Botometer,"Tool to classify Twitter accounts as human or bot. Formerly known as BotOrNot, part of OSoMe at Indiana Univ. Pls read FAQ before asking about permissions!",0,0,0,1,1,300
14061925,mikey3982,"Evidencing and demonstrating dimensions of value for health, and things that interest me.",1,0,0,0,1,300
28290853,lexing,"i spend time in machine learning, social media, images+language, as prof of computer science @ australian national university",1,0,0,0,1,300
274734503,Solvable,"We make magic happen in groups by combining tech tools,  social media, network science, & data analytics. As it turns out...people are #complicated.",6,0,0,1,7,300
315293016,dubb1o,I have applied mathematics to almost everything that moves and changes. Currently I am trying to grow crops vertically with data at Agricola Moderna.,0,0,1,0,1,300
1281526188,txkuhn,"Assistant Professor at VU University Amsterdam working on Semantic Web, Scholarly Communication, Network Science, Controlled Natural Languages, ...",1,0,0,0,1,300
206195705,MaziyarPanahi,Big Data engineer @CNRS @ISCPIF,1,0,1,0,2,300
19202628,winteram,,0,0,0,1,1,300
1090589910,phlndrwd,"Personal tweets of a PhD, Ecological Modeller, Programmer, Data Scientist, Open Source/Access advocate.",0,0,1,0,1,300
21332732,harmonylabs,Building communities & tools to reform & transform media systems,2,0,0,0,2,300
144892537,ntamas,"CTO, CollMot Robotics Ltd. Also guitars.",0,2,0,0,2,122
709503363574935552,USCAnnenbergPhD,USC Annenberg offers an interdisciplinary PhD program in humanistic and behavioral approaches to communication.,1,0,0,0,1,300
263377240,Carryveggies,"HCI research scientist, Google Brain",0,0,1,0,1,300
899023816764084224,aivillage_dc,"We are a community of hackers, ML researchers, and security data scientists focused on the use and abuse of AI - DM to join our Slack",1,0,0,0,1,300
1286401543,HCRCS,The Center for Research on Computation and Society (CRCS) advances the public good through collaboration between computational research and social science.,1,0,0,0,1,300
14538236,vardi,Communication of the ACM,1,0,0,0,1,300
30569817,dkroy,"Director, Lab for Social Machines,  Co-Founder & Chairman, Cortico, Professor at MIT, Exec Director, MIT Media Lab",1,0,0,0,1,300
3107101390,WSDMSocial,"The official feed from the ACM WSDM 2020 conference #WSDM2020 (https://t.co/H599e1Hin4, https://t.co/Rjvu4Q0Ye5)",1,0,0,0,1,300
3300958697,cosn2015,,1,0,0,0,1,9
37609127,sonswoo,"Seung-Woo Son @ Hanyang University, Ansan KOREA",0,0,1,2,3,300
139811295,bemikelive,"@ Google.

Interested in information retrieval, natural language processing, machine learning & their applications.",1,0,0,0,1,300
17561826,slavin_fpo,"work @crossoverhealth, was: Chief Science/Tech Officer, @theshedny; founder, faculty Playful Systems @mitmedialab; cofounder Area/Code. Trustee,  @cooperunion",0,0,1,0,1,300
136861797,clemsos,"Tech, art, science @qiware - Organizer: https://t.co/TLukPd6gQJ - New book: https://t.co/T8mENqlvN7",0,0,1,0,1,300
14776186,jietang,"Professor @ Tsinghua University, Artificial Intelligence, Data Mining, Social Network, Knowledge Graph",1,0,0,0,1,200
91367103,rodrygo_santos,Information Retrieval Researcher,1,0,0,0,1,300
62777265,fgilardi,Professor @IPZ_ch @UZH_ch 👑 @DigDemLab 👑 @PRODIGI_ERC 👑 I stay home and wash my hands,1,0,0,0,1,300
1595266056,Jules_a_Berlin,Researching how algorithms transform the journalistic field || PhD candidate @HSGStGallen || Former journalist & editorial analyst || From Basel,1,0,0,0,1,300
875458074386890752,ccvassallo,"PhD student at s.e.a.l. (@SealUZH).
Interested in supporting DevOps during continuous software development ⏱️.
Huge fan of using an Agile approach to life.",1,0,0,0,1,300
740657209,FlorianFoos,Behavioral Political Scientist @LSEGovernment. I like campaigns and do experiments.,1,0,0,0,1,300
1009132767538446337,EdoCeles,"Lecturer in Law, Technology & Innovation @LawGovDCU, @IrishResearch Council Scholar @UCDLawSchool, researching on #digitalconstitutionalism and #socialmedia",1,0,0,0,1,242
1128703774376300544,LuedtkeAllison,"Assistant Professor of Economics Saint Michael’s College (starting fall: AP at St. Olaf College) • Grad of @williamandmary and @uva • Networks, Math, and Macro",1,0,0,0,1,284
19569549,Kweku_OA,"Economist. @CEGA_UC, @AfogBerkeley @The_IGC Former @Cornell_Tech @Cal_engineer. statistical causal inference, machine learning, entrepreneurship, development.",1,0,0,0,1,300
3591899475,juditvar,"phd student @HorizonCDT, University of Nottingham | #digital STS, human geography, interdisciplinary, big data, scientometrics, mental health, education",1,0,0,0,1,133
23861430,thefillm,Executive Director - AI Roadmap Institute (@AIroadmap) & Senior Research Scientist - GoodAI (@GoodAIdev),0,1,0,0,1,300
53996118,zkmetty,"I'm a Data Scientist with diverse interest including political sociology, network studies and suicide research.",1,0,0,0,1,300
999191080296960000,mtakti_iehas,"Institute of Economics, Centre for Economic and Regional Studies, Hungary.",1,0,0,0,1,120
836578239107776513,binderchri_com,"🚀never dream too small 🛰️ |
freelance software developer 👨‍💻 |  interim cto 💼 | data scientist 📊 | 
❤️ bits, bots, biotech, dalí, rilke and pizza",1,0,0,0,1,300
750626225887084544,PrivacyLab_WU,,1,0,0,0,1,232
317784968,wapppHKS,The Women and Public Policy Program of Harvard @Kennedy_School equips leaders and changemakers with evidence-based strategies to advance gender equity.,1,0,0,0,1,300
936158727979323392,balazs_pager,Junior researcher at IRS @MTAKRTK_CERSHAS | Extern.collaborator #Regional #Innovation and #Entrepreneurship Research Centre (RIERC) University of Pécs,2,0,0,0,2,162
908344218954944512,davlanade,"PhD Student @Saar_Uni  @compriseh2020 | interested in Secure ML, Privacy-preserving NLP, Low-resource #NLProc & Computational social science | Disciple of Jesus",1,0,0,0,1,300
131922239,korenmiklos,Economics since 1994. Data since 1997. Python since 2003. Running since 2012.,1,0,0,0,1,300
59597712,diegolascasas,Robopsychologist.,0,1,0,0,1,300
217538515,ghoshd7,"Digital Platforms & Democracy Project @Kennedy_School @Harvard. Fmr @Facebook, @WHOSTP, @ObamaWhiteHouse NEC.",2,0,0,0,2,300
877339378468532225,Machine_Leaning,Advances in machine leaning,1,0,0,0,1,38
996528994563575808,BambusSu,,0,1,0,1,2,27
1104303863383949312,PagesNetwork,With the Network Pages we want to communicate discoveries of networks science! Scientific discoveries are a common good in the end! https://t.co/eHQHTQnIki,0,0,0,2,2,55
909468899816738816,MyqRizzo,Looking for Odysseans - Research Interests: Natural Computation and Math - Email: mdrizzzoh@gmail.com - https://t.co/sGxcG39ITz - Status: Braver than I believe,0,1,0,0,1,300
27891804,DanielKostic,"Philosopher working on theories of explanation, causation, consciousness and related issues in Philosophy of Mind and Philosophy of Science",0,0,3,2,5,300
1049825443,mkawakatsu,Ph.D. candidate in Applied & Computational Math @Princeton | Physics & Sociology @Yale '17 | @UWCAdriatic grad | Is. 41:10,0,0,1,0,1,30
2177240989,meghafon,"budding applied mathematician @FU_Berlin, dev. 💜: seeking better explanations, complex systems (bio), funk 🎶. past: @soundcloud CS+math @mit, lecturer @h_da",0,0,1,0,1,300
2539876532,adamcatto,"Interested in complexity, applied topology, and philosophy. Studied math + philosophy @stonybrooku. like/RT≠endorsement. he/him",0,0,2,1,3,287
862472819690491904,MangorPedersen,Husband+dad |🇳🇴| neuroscientist | PhD | post-doc @TheFlorey | functional MRI | brain & behaviour | network science | dynamic systems theory | machine learning,0,2,0,1,3,119
3019230126,nikunj410,"PhD at UT Austin, physicist turned biogeographer, fascinated by dispersal. Masters in ecology at @yale_eeb and physics undergrad at @iiscbangalore",0,0,2,0,2,300
98009885,finkej,Computation & social data; dynamic networks,1,1,0,1,3,197
1088893771675258880,ldallap1,Physicist & Neuroscientist. PhD candidate at Cortical Networks Lab.,0,0,1,0,1,300
2422107782,lunartiko,,1,0,0,0,1,17
1123007022964854784,DiMercurioPhD,"Pursuing a dual-title PhD in Communication Sciences/Disorders and Language Science at Penn State (previously: MS Neuro, BS Bio, BA Math).",0,0,0,1,1,56
732890947286147072,whedleyt,"Working with temporal network theory, cognitive neuroscience and some metascience. Currently PostDoc-ing at Stanford.",0,0,1,0,1,138
852136437323583488,Jose_science,"Postdoctoral researcher. Networks, animal social behaviour, evolution of cooperation, computer models, wild animals, complex systems, interdisciplinary research",0,1,2,0,3,52
1109165220675706880,dtsiot,"Ph.D, University of Thessaly, Greece, PLOS One Academic Editor",0,3,0,0,3,25
965712750377951239,negretepincetic,"Profesor Ingeniería UC, Vinken (https://t.co/wwHBGmmEO4), OCM-Lab (https://t.co/mA4kj9jbII), ISCI (https://t.co/GM9nlfevHe)",0,0,2,1,3,300
4847212268,dallastaylordrt,"Assistant Professor of Applied Mathematics for Complex Systems, Networks and Data, University at Buffalo, SUNY",0,0,4,0,4,37
1087333451685027841,SaurabhYRanjan,🧠♥️🔧👨‍💻,0,1,0,0,1,300
216585623,corypisano,"product eng @radarlabs; prev cofounder @ https://t.co/93zbmVBiXj; make stuff
 
 
 
 
 
🛸",0,0,0,1,1,220
1066998121,amccnnll,I like miserable weather ☔️⚡,0,1,0,0,1,177
1070375076992823296,thejewfunction,"The World, the function of the #Jews and human survival. New science on the age old issue of anti-semitism. learn more here https://t.co/PsV4rWQJHx",0,0,0,2,2,300
444810854,jmoralesigras,"PhD. Sociòleg, professor i analista de xarxes socials. | Sociólogo, profesor y analista de redes sociales. | Soziologoa, irakaslea eta sare sozialen ikerzailea.",0,1,0,0,1,300
992070270977441793,telark2,"Neuroscience/Graduate Student. Networks/Complex Systems.  Pain/Neuroimaging. Wanderlust that loves music, football, food and sightseeing.",1,0,0,0,1,45
913816397028876288,orlandiResearch,Complex systems and Neuroscience. Always Calcium. Postdoc with @benuccilab at @RIKEN_CBS. Implementing ML solutions to understand learning and DM,0,0,1,0,1,71
841924100721369093,ChaoJiang_Neuro,,0,2,0,0,2,300
472845689,JohnPappas10,Neuroscience post-doctoral scholar at UC Berkeley,1,0,0,0,1,259
767627906289954816,carlonicolini84,,0,0,0,1,1,69
875679268126306305,TBroekel,"Professor, University of Stavanger UiS, interested in innovation, regional economics, network science, maps, R, data, empirics",1,0,2,1,4,300
578605664,lcqJAlberto,,0,0,1,0,1,187
1927788625,Purdue_RCODI,Research Center for Open Digital #Innovation at Purdue University,1,1,0,1,3,300
52069321,shadeofbleu,"Creator and Solver of Complex Problems. Aquarius, INTP, High D High C, Human, Insomniac https://t.co/1OEywcjwoG",0,0,1,0,1,300
408004146,PluR_X,,0,0,1,0,1,300
3329692217,JeffLienert,,1,0,0,0,1,75
217139439,snaidunl,Economics professor @Columbia. I work on political economy in/and historical labor markets. @coreeconteam contributor. Expat newf.,0,0,1,0,1,300
36487776,aasiegel,Postdoc @ImmigrationLab @Stanford & Research Associate @SMaPP_NYU MENA Politics & Computational Social Science. @NYUpolitics PhD.,1,0,0,0,1,300
2595065166,RandomBrandles,ATHLETE • CAJUN • PHYSICIST,0,0,0,1,1,300
348348772,ATASEZAI,"Ph.D. network science, complexity, combinatorics
Aksaray, İstanbul, Minneapolis, Ankara
my tweets=a condensed selection from my thinking/reading",0,0,0,2,2,209
1215604573362106368,stephenclare_,Research at @FoundersPledge,1,0,0,0,1,125
1234520220280033280,PMinasandra,Ecology | Animal Behaviour | Computers | Math | MSc | IISc Bangalore | Previous account was brigaded by trolls and bots 😔,1,0,0,0,1,65
60707320,jcarnott,"Scientist, student, citizen exploring changes in climate & society. Executive Director @aspenglobal. @UMSEAS alum.",0,0,1,0,1,300
23688091,CO_EQ,Natural Wine ❤️. Open 🔥 Cook. Jazz fan. CAS. 🚵‍♂️. Mindfulness. ML nerd. model thinker. Behavior Science. UX Researcher @ Google. Views my own.,0,0,2,0,2,300
349965440,brian_calvert,“the chords of eternity in the noises of daily life”,0,0,1,0,1,300
93193823,omkarphatak,"A passionately curious explorer, an ardent student of reality. Ex-blogger.

Developer Advocate for Alexa Skills by day. Views are personal.

#QuestionEverything",0,0,1,0,1,300
384141846,c0l_k0l,,1,0,0,0,1,171
717567462,mittaldevashish,,0,0,0,1,1,44
18559243,adrianscottcom,Soma Capital; nonlinear Math Ph.D.; Data Science / Bio math / Technologist;  Social networking pioneer - Ryze; Napster; Film actor; fat tails; risk;uncertainty,2,0,0,0,2,300
2169990109,kmkll,"Time does not exist it's an allusion,🌗",0,0,1,0,1,15
1115327313200197633,marykaltenberg,Innovation & Labor Economist | Asst Prof @PaceUniversity Fall 2020 | Co-founder of https://t.co/zLIu3n2IMG | Python evangelist | 3x Red Sox Dance Off Winner |,0,0,1,0,1,82
703953657130303488,M_Iraklis,,0,1,0,0,1,11
32600547,ankur440,ScientArtist experimenting here with #hashtags and other/worldly materials and media.,0,0,2,0,2,292
1690216393,OlessiaKoltsova,"director, Laboratory for Internet Studies",1,0,0,0,1,8
300104051,brendan_snow,"Value investing and fintech. I am not wise. Opinions own, RT not endorsement.",0,0,1,0,1,300
3001875744,AngYu_soci,"PhD student @UWSoc. Studying stratification/mobility, the life course, and causal inference.",1,0,0,0,1,274
942553718767042560,BSaifaddin,"Do what's right, and fear no man.  

engineer/designer/builder/scientist/writer",1,0,0,0,1,300
22476328,j_donager,Post doctoral scholar with the Ecological Restoration institute. I use remote sensing to inform forest management for multiple goals and a changing climate.,1,0,0,0,1,300
182398226,raagamuffin,"Post-doctoral researcher at Stanford (Hurricanes/ Geofluid dynamics/ Complex Systems). See website for details. Musician (Composer, Keyboardist). Sports buff!",0,0,1,0,1,300
1149708222980382721,TheStartupWolf,"Insights on startups, wealth creation, venture capital, cryptocurrency, epistemology, complexity and darwinism.",0,0,1,0,1,300
24501055,kcarlberg,"Research scientist at @Facebook Reality Labs working at the intersection of machine learning, computational physics, and high-performance computing.",1,0,0,0,1,300
1469451499,nikitavoloboev,"Make @learnanything_
https://t.co/58zKefvjqy
https://t.co/umzUw5xOIL",1,0,0,0,1,300
2575443853,behnaz_moradi,,0,0,0,1,1,36
1036651210802163712,max_bertolero,neuroscience post doc in the complex systems lab with @DaniSBassett at @Penn. l link genes to brain connectivity to behavior. I like to ride dirt bikes.,0,0,1,0,1,300
957435600,joshwankenobi,Hialeah 🇨🇺 in SF 🌉,0,0,1,0,1,300
869464605432492032,irhumshafkat,Interested in using machine learning to make society a better place.,1,0,0,0,1,300
2473635943,theoryofjoel,"physics, data science, complex systems, sound design",0,0,1,0,1,9
748005582192410624,Michael_Levet,"Virginia Tech and University of South Carolina alumnus. PhD Student at @BoulderTheory. Mathemagician, Computer Scientist, and Economist. He/him/his.",0,0,1,1,2,300
2781162181,mnoripub,"System/Computational Neuroscience, and the Imaging technologies.",0,0,1,0,1,300
197184193,PauloMatui,,1,0,0,0,1,300
1160952215663796224,DavidMelamed8,"Dad of two awesome boys, husband, and Associate Professor of Sociology @ Ohio State.",0,0,1,0,1,74
938070905745440768,VSenthivel,Synthetic biologist / popular science enthusiast/ badminton player,0,0,1,0,1,300
393489163,KeigoInukai,"experimental, behavioral & neuroeconomist.",2,0,0,0,2,183
511107318,jacquietran,Sport scientist. Researcher. Widely curious. Striving to be less wrong. She/her.,1,0,0,1,2,300
4759267765,Ashley_Teufel,"Computational Evolutionary Biology, Omidyar Postdoctoral Fellow at the Santa Fe Institute. she/her #FirstGen",0,0,1,0,1,214
1031146742,muddyclams,education = solutions for the future (i hope),0,0,6,1,7,300
2601360294,MahinAtiq,,0,0,1,0,1,46
12954272,aschwartz,"PhD Student at the University of Vermont 
Natural Resources, Ecological Economics, Complex Systems",0,0,1,0,1,251
744390554402725889,mmjohnEEB,"PhD student @ UT Austin

she/her",0,0,1,0,1,55
89987805,scholarometer,Scholarometer is a social platform for citation analysis. It crowdsources field annotations & measures universal citation impact. Install the browser extension!,1,0,0,1,2,300
1038443343582306304,LizKelleyMarsh,"Food systems, epidemiology and climate change in urban spaces + communities @TuftsNutrition and @TuftsUEP. Learning to ask spatial questions + think in networks",0,0,2,4,6,43
3159013185,josepemanzano,"PhD Student at Sir Peter Mansfield Centre (@UniofNottingham). 

Still waiting for being a respectable person to avoid impressive profile descriptions. #xMRI #AI",0,1,0,0,1,300
232287209,dallascard,,0,0,2,0,2,225
1097183214181933056,adlightner,Evolutionary anthropology PhD candidate @wsuanthropology @wsuvanth,0,0,1,0,1,83
185989039,meta_lab,"(cyber)security: 

human rights; mass surveillance, targeted malware/APT, complex systems. 

DM for Signal",0,0,1,0,1,300
1047677350052130816,qyliang1,"Ph.D. candidate in Marine College at Shandong University, studying marine microbiology & bioinformatics. Bacterial resuscitation mechanisms during enrichment.",0,0,1,0,1,300
77911306,alexbakus,"Dad, Entrepreneur, Ukrainian-Canadian. I help scale operations. Previously @Shopify and founder @finask 🇨🇦",0,0,1,0,1,300
1555839313,CatBrinkley,@UCDavis prof working with communities on #Sustainable #Development @ the nexus of #UrbanPlanning and #PublicHealth  #ScienceofCities  #FoodPolicy,1,0,0,0,1,300
1008723602013933569,steipatr,"PhD candidate @WUR ǀ #resilience, #complexity, #deepuncertainty ǀ This isn't the emergence you're looking for.",0,0,2,0,2,269
19321984,AndrewwBrown,PhD Candidate @wsuanthropology  @WSUPullman || MS @UNTsocial 2016 || #ComputationalArchaeology || #Paleoclimatology || #HumanAdaptation || #TattooArchaeology,0,0,0,1,1,300
944994955881304069,MarkAnnuncio,Meta-meta-meta-meta-meta-meta-meta-meta-metaresearch. Relevant- https://t.co/C0wtSQcqdv,0,0,1,0,1,300
734965117,Yara_Khaluf,"Researcher, collective intelligence, swarm intelligence, Decision making, mathematical modeling, complex systems",0,0,1,0,1,63
266257331,rajivatbarnard,Economics | Barnard | Columbia | Santa Fe Institute | https://t.co/VziaErtSvp,0,0,1,0,1,300
51257255,natashajaques,Research Scientist at Google Brain and Berkeley studying social deep reinforcement learning. PhD from MIT,1,0,0,0,1,300
854410118066294784,kgbigsby,Ph.D. ‘18 from University of Iowa. I like sports and computers.,1,0,0,0,1,300
256036107,k____i,"Assistant Professor: systems biology, network-based analysis, simulation, signaling pathway
リツイートは必ずしも賛同という趣旨ではありません",1,0,0,0,1,300
48073468,the_dismal_tide,“Mathematics as currently practiced is a delicate interplay between monastic contemplation and blowing stuff up with dynamite.”,1,0,0,0,1,300
3377823299,roshcher,"Statistical seismology, physics of earthquakes, Western University",0,0,1,0,1,300
507972160,ctphoenix,Data Scientist at Migo.,0,0,0,1,1,300
3257443497,mtaylor_soc,"Asst. Prof. of Soc @nmsu. Culture, Cognition, Computation. RTs =/= endorsements. Tweets are mine.",1,0,0,0,1,300
902619844603994113,DrS0SA,"Post-doc, I study animal societies.",7,0,0,0,7,277
221292469,bayesian_stats,"Tweets about Bayesian statistics, Monte Carlo, etc from an Associate Prof at the University of Warwick.",0,0,1,0,1,300
986718011661762561,pinyuchenTW,"Research Staff Member@Trusted AI Group & PI@MIT-IBM Watson AI Lab, IBM Research. Adversarial Machine Learning & Robustness; Trustworthy ML. Views are my own.",0,0,0,1,1,250
164478889,1n9r1d,"Metadata nerd, tech head 👾 GLAM🏺collections #asdata #digitalhumanities #openglam #lodlam #openresearch #eresearch #ML #AI #dataethics enthusiast. Own views.",0,0,1,0,1,300
114039731,BrianDRPM,retired-E.D. professional discovers #SystemsThinking & #ComplexityScience sees potential for New Community Paradigms. RTs not endorsed sometimes only interest,0,0,0,1,1,300
384086602,JoelChan86,"Assistant Professor at @iSchoolUMD & @hcil_umd. Research/teach information infrastructures for innovation and discovery. Human. Son, father, husband.",1,0,0,0,1,300
326888763,sendgoodcheers,"computer scientist, labor economist @SCSatCMU. I build software for labor + data markets. Alumni: President Obama @POTUS44 @USDOL, @HELPcmteDems",0,0,0,1,1,300
14446934,jim_rutt,"Jim Rutt Show podcast, Santa Fe Institute, network culture, future of human systems, amateur scientist, general-purpose trouble maker. Bio: https://t.co/VyoxAdhZJW",1,0,0,1,2,300
928301283034914817,lihua_lei_stat,"Postdoc in statistics, @Stanford. Causal Inference, Multiple Testing, Network, Optimization, Resampling Methods, Time Series Analysis, Econometrics",0,0,0,1,1,130
24012732,JaimieMurdock,"Culture, creativity, and cognition via digital humanities, complex systems, computational social science, and philosophy of science. Personal tweets.",0,0,1,0,1,300
738452947,JacobPeters10,Postdoc at Cornell University | collective behavior | social insects | complex systems | biomechanics | honeybees | maybe robotics?,0,0,1,0,1,229
1070352119767670786,BramSiebert,,0,1,0,0,1,1
892893499523301376,rrrlw,"Medicine, mathematics, programming. #openscience #rstats #medstudenttwitter",0,1,1,0,2,219
97901597,Stefano_Peron,"Prop trader. ""Nature can never be completely described, for such a description of Nature would have to duplicate Nature”",0,0,2,0,2,300
1059923246651326464,fasanbrain,"Brain, AI, Space, energy, singularity.",0,0,1,0,1,300
161631701,hoolio_,"My podcast, Tangled, explores how we can take ideas from nature to improve how we do things: https://t.co/alG5jdJrnr",0,0,1,0,1,300
915961981777178628,AngJosMS,"Sociología, Cultura, Metodología, Política Pública, Sociocomplejidad, Simulación computacional en dinámicas sociales, Aplicación de Office en proyectos de datos",0,0,0,1,1,39
4384849588,Matthijs_Moritz,Anthropologist at the Ohio State University studying complex social-ecological systems.,0,0,2,0,2,300
895215480318947329,ScilinxResearch,Advancing operational frontiers.,0,3,0,0,3,300
313744999,Jalasvirta,"Interesting: Quantum theory, brain research, awareness of the soul, space and freemasonary, Craft. MMM, AM, RA, RC, Templars, Maltese, Red Cross, ROS, SRiS",1,0,0,0,1,300
307364657,AintMadeAMill,"CS grad student at Northeastern. 
Interested in cultural evolution, social norms, economic complexity, ""evolution of cooperation"" and programming lang. theory",0,0,2,0,2,222
148747151,js012108,Doctor en Ingeniería. Sistemas y Computación. Universidad Nacional.,0,0,0,1,1,300
16136135,mhanco,Analytics and distributed computing. Interests: Anthropology | Complex Systems | Linguistics | Machine Learning | Privacy,1,0,0,1,2,300
802707937,Hong_Inho,"Postdoc at Center for Humans & Machines, MPIB; future of work, complex systems, network science, human mobility, cities.",0,0,1,1,2,16
1141302932,madisonkhart,just trying to weave together points of the obvious,0,0,1,0,1,249
235698448,johnmsheffield,"#rstats, #rspatial, machine learning with @climate_risQ in Boston.",1,0,0,0,1,300
108202893,VickyCYang,"Omidyar Fellow at the Santa Fe Institute.
PhD in Applied Mathematics",0,0,1,0,1,36
2921127547,ihdeutsch,"Theoretical Physicist at the Center for Quantum Information and Control (CQuIC), University of New Mexico",1,0,0,0,1,244
1039937638164099072,LG_Shoemaker,"Community ecologist with an interest in math, grasslands, and complex systems",0,0,1,0,1,203
52264100,SilliPoint,"Interests: Science, Research, Physics, Neuromorphic Computing, Sports, Cricket, Movies, Politics,  and latest Technologies.",0,1,0,1,2,300
2373806853,crlsmcl,,0,1,0,0,1,262
3498347001,jddwor,Biostatistics PhD candidate at @UPennDBEI. Specializing in statistical and computational techniques for image analysis with @Penn_SIVE.,0,2,0,0,2,122
433425454,GolnarGF,"CS PhD Student @CUBoulder, interested in music, animals, plants, DIY projects, friendships, and how they shape us.",0,0,1,0,1,300
964274911911985152,rob_cope_c,Applied mathematician / data scientist | interested in dugongs / ecology / biosecurity / infectious diseases,1,0,0,0,1,300
913222195,sengupso,Patterns are everything. Phase Transitions Matter. Molecular Virology PhD. Former Oncology Researcher. Educator.,0,0,1,0,1,300
1022223972249862148,GeoBiol,"Bridging stratigraphy, paleobiology, and network science to address specific questions on spatiotemporal aspects of the biosedimentary record.",0,0,0,1,1,20
977341781724598272,RitaBarandas_,Medicine Technology Psychiatry,0,0,1,0,1,220
2493484046,andreiamatuni,🐝,0,0,1,0,1,152
3094438711,vickenhillis,Assistant professor @HumEnviroSystem @boisestatelive,0,0,0,1,1,270
724028485186912256,vandinfa,,0,0,0,1,1,201
15677536,replicatedtypo,"Born in Cardiff. Went to Edinburgh. Fell madly in love with cultural evolution. Started a blog. Got PhD @UniofEdinburgh. Now @MPI_SHH, Jena.",1,1,1,0,3,300
2937614106,kotrinakajokas,Evolutionary anthropologist @MPI_EVA_Leipzig. Primate social behavior. Fieldwork at Costa Rica with Lomas Capuchin Monkey Project.,3,0,0,0,3,267
1187340050,Naturalkiller__,PhD candidate in nutrition @CIADconacyt,0,0,1,0,1,300
796083576584409089,MattDSweitzer,"Data scientist & PhD Candidate @OhioStateComm and @SandiaLabs, political communication and social networks researcher (he/him). All opinions are my own.",1,0,1,0,2,189
401241381,SteachSF,,0,0,0,1,1,132
935985616260685827,vandana_r_v,"Evolution, Theoretical biology, Max Planck institute for evolutionary biology, Germany. Former nuclear engineering physicist",0,0,1,0,1,213
224673655,kohar_vivek,"Researcher - Computational Biology, Dynamical systems",0,0,1,0,1,51
176105004,gprimiero,"Associate Professor of Logic @LaStatale. Philosophy, computing, music, technology and more.",3,0,0,0,3,300
742815048,LiNingzi,"Researcher @leedsbiz @CUBoulder, PhD @Cornellsoc, research on organization theory and strategy",1,0,0,0,1,111
786492800,dzera_kaytati,"working at the intersection of human-centered design, AI, neuroscience & education. Co-founder of @maaind_ai @marssocietylon and #futureliteracies @andwhystudo",0,1,0,0,1,300
574747218,alexiagalati,"Cognitive scientist (language, body, space). Also, cats. Assistant Prof @UNCCharlotte Psych Science. she / her / hers",1,0,0,0,1,300
16783748,ErnieBarreto,occasionally smirks,0,0,1,0,1,300
274515797,diomavro,"Cypriot/French/Stats/Finance/Economics/Cinephile/Troll level: 99/othernonsense lover. PHD Dauphine, Industrial Organization/game theory",0,0,2,0,2,300
908707872233713664,sarahebrown12,"I am an PhD student studying environmental governance, social networks, sustainable agriculture, and agroforestry @IllinoisNRES",1,0,0,0,1,45
60910828,Conor_Finn,Postdoc @Sydney_Uni working on multivariate information decomposition and its application in complex systems.,0,0,6,2,8,300
4017250284,plborrill,"EARTH Computing:  Solid ground beneath the clouds.  We make networks unbreakable, data consistent, and transactions fast reliable and secure.",0,1,0,0,1,300
112242470,LauraSerrano10,,0,0,1,0,1,300
973356060277903361,eroi_boi,"⚛ Nuclear engineer / alchemist in training. Curious about energy, sustainability, and complex systems | he/him",0,0,1,0,1,23
370889554,emerson_mack,"Retweets that intrigue.

RTs ≠endorsements.",0,0,1,0,1,300
239250103,_arodriguezca,CS PhD student @gtcomputing | Data Science & ML,1,0,0,0,1,300
105802449,saimoncastillo,"""How the spirit becometh a camel, the camel a lion, and the lion, at last, a child""",0,0,1,0,1,300
30194985,bapeterj,"Senior Research Fellow @cecanexus @CRESS_Surrey & @SurreySociology. Social science & complexity, systems mapping, ABM, env + energy policy, partnerships.",0,0,1,0,1,300
504383252,thattinyroom,"Mathematician, Architect, Neurobiologist, Geographer but most importantly Semi-Professional High-Fiver.",1,0,0,1,2,300
3182190050,sadaf_hashimi,Ph.D. Student | 🇨🇦 @RutgersSCJ |,2,0,0,0,2,300
20823517,Jorgeabentin,"Biologist interested in #Ecomimetics, Personal & #Urban System #Antifragility, Beautiful #Cities and #Medieval Aesthetics @evomimetica",0,0,1,0,1,300
4440603802,megha_padi,Assistant Professor at the University of Arizona working on computational genomics and network models in biology and medicine.,0,0,0,1,1,53
22038612,merilx,"Educationist in Rio de Janeiro. Documentary filmmaker & community development activist with long stints in Johannesburg, Delhi, Halifax, and rural Cape Breton.",1,0,0,0,1,268
2204794339,JonMichaelWalls,Responsible Innovation/Technology Ethics/Agent Based Modelling/Social Network Analysis.,0,0,1,0,1,300
73241590,Kevsational,"Applied mathematician.

@UCC
@Cornell
@MIT",0,0,1,0,1,300
738377726,TheMattGarry,"PhD in network science @mpecdt turned data scientist @marksandspencer. Climber, Suffolk farm boi, Music nerd",0,0,0,1,1,123
106078716,guygrossman,"UPenn, Political science. An applied political economist studying development, conflict and migration.",1,0,0,0,1,300
13148552,niespika,Un philosophe à Montreal. Tweets :  my own. RT not endorsement,1,0,0,0,1,300
793915115342938112,Anamika255,NASA Earth and Space Science Fellow | Doctoral candidate at Purdue University | Studying Urban Climate from a Complexity perspective | Also musician,0,0,1,0,1,285
1928965454,samgrassii,"Freshman in mathematics at USC, primary area of interest is dynamical systems.  https://t.co/qHJQz9Vkmz",0,0,1,0,1,300
348783351,DanMcGlinn,Ecologist  at College of Charleston studying how diversity is maintained and distributed across the Earth.,0,0,1,0,1,300
97604976,jesseaaronbrown,Network neuroscientist @ UCSF Memory and Aging Center. #herenow,0,0,0,1,1,300
627927298,NadigAjay,md-phd student @harvardmed @mit /neuroscience/genomics/currently thinking about next cup of coffee,0,0,0,1,1,300
1407516390,tom_gxt,,1,0,0,0,1,262
305049585,quahada,Engineer. Co-Founder @techqueria,0,0,1,0,1,300
26730180,franktakes,"Assistant professor @LIACS @UniLeiden and research fellow @UvACORPNET. Interests: network science, social network analysis, computational social science",0,0,0,1,1,64
596762924,JohnDavidFive,"Developer into the union of information theory, neuroscience, software, education. Love data viz, mtn biking, sk8ing.",0,1,0,0,1,300
941925100533645313,MoraleJ31,#ML #DataScience #MBA #Marketing #Economics #MechanicalEngineer #Statistics #DigitalMarketing #SocialMediaMarketing #PythonProgramming #RProgramming #Kaggler,1,0,0,0,1,265
755022245894975489,SandraRomero_10,,0,0,1,0,1,135
1009929008,cluster_guy,"Interests: science, physics, nanotechnology, politics, art, sailing, tramping, tango.... etc. Not necessarily in that order.",0,0,0,1,1,300
398066910,mizvladimir,PhD student @EPFL_en. #DataMining #MachineLearning #Graphs #Visualization. Wikipedia Insights https://t.co/l3wTttYw93,5,4,0,0,9,300
32924635,akastrin,,0,0,1,0,1,300
1288103022,cpdiku,,0,0,0,1,1,300
278461514,CaronHaohuiChen,Research Scientist at CSIRO. Views are my own.,1,0,0,0,1,242
946197867525496834,BobDobolina1984,,0,0,1,0,1,287
105029708,Ervargask,"Padre feliz, Asesor en diseño e-Learning  | Relator de experiencia de clientes | Docente | Ingeniero Comercial , Diplomado y Master en gestión de negocios UAI",1,0,0,0,1,283
5378402,mattrepl,I’m happiest in the woods. A researcher in automated binary analysis with type theory and machine learning. I also model social community dynamics @GMUCompSci.,1,0,1,0,2,300
798652376429236224,MathRunnerGirl,"🧙‍♀️ Cleric ❤️ 
2:47:35 NYCM'17.
[Tweets are my own.]

Natura non facit saltus.",0,0,1,0,1,300
857325721781456898,dgocallaghan,Earth Observation Scientist,0,0,0,1,1,300
554305184,SaimaRathore,Senior Research Scientist @ Avid Radiopharmaceuticals,0,0,0,1,1,300
948423587383226368,lenanvincent,"(she/her) PhD candidate @UWMadison and @WIDiscovery - Baum Lab - Co-founder of @UW_OoLALA: Origins of Life, Artificial Life, Astrobiology.",0,0,1,0,1,300
1877372130,DamienFarine,"Studies collective movement and social networks of living dinosaurs. PI @ Max Planck Inst. of Animal Behavior, soon Prof. @ @UZh_en. #ERCStG grantee.",2,0,0,0,2,300
1467510890,plant_sci_guy,crazy about grasses. plants & systems biology. interest in complexity. radio extra W9ZA. @Illinois_Alma tweets are my own. co-founder https://t.co/3mHcxqntXg,0,0,1,1,2,300
14996765,esteban_g_r_,"Artificial  Intelligence researcher. Agents and non-monotonic reasoning. Ph.D in Computing Science @UmeaUniversity Sweden. Colombiano, Ipialeño 🇨🇴",0,0,0,1,1,300
2786420049,Berbesque,Biological Anthropologist. Research interests include hunter-gatherers and human evolution. Also likes drinking coffee.,1,0,0,0,1,300
189825879,LindaDouw,"(brain) networks | neuro-oncology | cognition | associate professor @AnatNeu_Ams | chair @ayoungacademy | running, music, dancing",0,0,0,3,3,300
20425567,nedribbesford,"Education researcher @ioe, @ucl interested in complexity and educational reform.",1,0,1,0,2,112
34276317,hegemonetics,apocalypse -   (n.) something as it really is  ه҈̿҈̿҈̿҈̿҈̿҈̿҈̿҈̿҈̿҈̿҈̿҈̿҈̿҈̿҈̿҈̿҈̿҈̿҈̿҈̿҈̿҈̿҈̿҈̿҈̿҈̿҈̿҈̿҈̿҈̿҈̿҈̿҈̿҈̿҈̿҈̿҈̿҈̿҈̿҈̿҈̿҈̿҈̿҈̿҈̿҈̿҈̿҈̿҈̿҈̿҈̿҈̿҈̿҈̿,1,0,0,0,1,300
18447918,mosabou,モーゼズ,3,0,0,1,4,300
902164423846002691,ClaudiusGrabner,"I am an economist interested in computational methods & complexity, socio-econ development, int economics, tech change and the philosophy of economics.",0,0,1,0,1,300
708304205086195712,lorenzvnt,"Senior Lecturer in Psychological Sciences at Australian Catholic University, researching the neurocognitive correlates of addiction. Views are my own.",0,0,1,0,1,300
455377205,DaveTenney,High Performance Director for the Orlando Magic,0,0,1,0,1,300
254950913,ScottDUK,All views are mine. I love connecting dots you didn't know could be connected.,0,0,1,0,1,300
57821987,MightyMaxTweets,Nerd Herder for Facebook #Khive #KhiveForever Kamala is my President! Anti Trump AF,1,0,0,0,1,125
117254439,radevd,,0,0,0,1,1,300
2925913018,LancasterSci,"Evolution/complex systems/improv/music. Scholar @RoninInstitute, @Sydney_Uni Partner @amberbiology Co-author @py4lifesci. #FlattenTheCurve. Views own",0,0,1,0,1,300
30867631,SnowFlywheel,Creating behavioural 'Snowballs & Flywheels'. Getting people and purpose rolling. Love social technology.,1,0,0,0,1,300
455188223,mvitevit,,0,0,0,3,3,126
273297132,pnasikas,evolving and developing. I Collect Coins,0,0,0,1,1,300
43090633,AndyHale11,Co-Founder at TypeFour Projects. Bristol based.,1,0,0,0,1,300
47951925,karthikraman,"Faculty @iitmadras, @IBSE_IITM and @RBC_DSAI_IITM . Tweeting in personal capacity (of course!), on science, technology and Sanskrit",0,0,0,1,1,300
737641519264501760,ResearchFeature,"Research Features Magazine official Twitter. No clickbait, no tabloid, just #research. #SciComm #researchfeaturesmagazine",0,1,0,0,1,300
860006610277629953,AdGuideNow,24/7 Marketing Insights & Strategies #SEO #SMM #CRO #PPC #CRM #IoT #SEM #DigitalMarketing #ContentMarketing #BigData #Analytics,1,0,0,0,1,300
47760903,rocajiri,"Ingeniero industrial, MSc. Apasionado por los Sistemas Complejos y el Análisis de Redes",1,0,0,1,2,83
42389574,mouldedriver,"""Let us stand here and admit that we have no road."" William Empson",0,0,2,0,2,300
3232811052,babeheim,behavioral ecology | cultural evolution | data provenance | group leader @ MPI_EVA_Leipzig,1,0,0,0,1,300
2872114635,kellybclancy,Thinking about how we think. She/her,0,0,1,0,1,300
847097790090170370,SwRIHPI,The Southwest Research Institute (SwRI) Human Performance Initiative (HPI) applies science and engineering to understand and quantify physical performance.,0,0,3,0,3,256
798515833077014528,visscherlab,"Interested in neuroscience, brain dynamics, and plasticity of complex networks.",0,1,0,0,1,300
2941377939,criticalneuro,"Cognitive Computational Neuroscience @Columbia, prev. @Princeton. Reinforcement learning, memory, planning, multi-agent graphs. fMRI+electrophys. 🤖 📖 🧠 🎹",1,0,0,0,1,300
769387159920975872,macdhomhnail,"PhD student @thecainlab, @sfucriminology. Crime and social networks, co-offending, organized crime. Cape Bretoner.",1,0,0,1,2,228
3212836701,withsarm,,4,0,0,0,4,11
2899600424,sikdar_sandip,A student for life,1,0,1,0,2,49
3226505335,eigenfactor,Revealing the structure of scientific knowledge with @CT_Bergstrom and @JevinWest at the University of  Washington.,1,0,0,0,1,300
254909999,cm_blackbird,"PhD student in complex systems. “If we truly saw the universe, perhaps we would understand it.”",0,0,1,0,1,145
23217821,ashishgoel,"Professor, Stanford University; Research interests: Algorithms and their applications.",1,0,0,0,1,300
538337776,MaxALittle,"Applied mathematician and statistician at University of Birmingham/MIT/Oxford, TED fellow: https://t.co/BDlYs81J7p Views are entirely my own.",0,0,0,1,1,300
2267890620,BrettIsraelsen,"Husband, Father of 3, road cyclist, CS PhD, researching human-AI trust and collaboration.",0,0,1,0,1,300
928951664,prateek0990,"Postdoc MPI for Evolutionary Biology, Gene Drive, Complex Systems, Mathematical Biology, Evolutionary Game Theory.",0,1,0,0,1,113
345320126,MariusSomveille,Postdoctoral researcher @Yale & @maxplanckpress. Macroecology/biogeography. Maps enthusiast. Wonder why not all animals migrate.,1,0,0,0,1,300
754609157907644417,MGildenhard,"Data Scientist in ☎️ | Interests:🔬🌍🤖📈🇪🇺🚲🥃🍵 | Education: 🦟🦠🧬☣️💻🧫🔬Biologist | I ♥️ predicting, especially the future.",1,0,0,0,1,300
33848498,akeren,Just stepped out of the corporate world back to startup land. CO-founding something that I hope will be really cool.,1,0,0,0,1,300
47962707,balicea1,"Applied deep thinker. Avid empiricist, avocationally representationalist. Director of science and content at @Orthogonal_Lab #WarrenDemocrat",0,1,0,0,1,300
3309257831,ScottBArmstrong,Coastal geomorphologist and statistician,0,0,1,0,1,227
3087725630,zpkilpat,"Assistant Professor, Department of Applied Mathematics, University of Colorado",2,0,0,0,2,300
2740582008,AVerdery,"assistant professor of sociology, demography, and social data analytics at Penn State",2,0,0,0,2,208
3395753175,biosysanalytics,"Principal, Alex Lancaster, PhD Coauthor @py4lifesci Research @RoninInstitute, @IGDOREinstitute, @Sydney_Uni Partner @amberbiology #FlattenTheCurve",1,0,0,1,2,300
4052479785,Raul_MontanezM,,0,0,1,0,1,239
758539573,risksenselabs,,1,0,0,0,1,300
2292004728,drwyatte,AI guy turned neuroscientist turned engineer.,0,0,1,0,1,213
15090415,annakrystalli,"Research Software Engineer @RSE_Sheffield. Ex-Macroecologist 💞 #rstats & open data science. @Sheffield_R_, Editor @rOpensci. Music addict.",0,0,1,0,1,300
203744844,yanjiefoo,Assistant Professor at UCF,1,0,0,0,1,300
68599172,kjosic,Mathematical neuroscience and biology.  Also occasional popular science reports on math in everyday life.,6,0,0,0,6,300
3175646543,2ndPersonNeuro,Independent Max Planck Research Group for Social Neuroscience at MPI of Psychiatry,1,0,0,0,1,300
1268655968,nosovicki,((λ (x) (x x)) (λ (x) (x x))),1,0,0,0,1,300
21616803,cfusting,Data Scientist and AI Researcher.,0,0,1,1,2,300
26252407,JelenaMarkov,Geophysics PhD candidate at the University of Western Australia - 3D modelling - Inversion - Airborne survey design - levelling - geology of West African Craton,1,0,0,0,1,300
16020643,flavio_lpp,Phd,0,1,0,1,2,300
2490580036,juliancardenasx,"Profesor e investigador #Sociología: networking, élites. Siempre del RCD Espanyol ⚽. Mi blog: https://t.co/w4CqcbdG1u y mi web: https://t.co/7O0ThhrdPY",0,1,0,0,1,300
4927471450,QLawsII,"Workshop/School: Lake Como 13-24 June '16. Physiology, ecology, interaction structures, collective behavior. We'll be twitting science we like and announcements",0,1,0,0,1,147
14524293,adagu,Professor at IIT Gandhinagar.,1,0,0,0,1,28
354043186,abitofalchemy,"Passionate about the big questions & challenges around ai & ml while caffeinated, enjoying life with my family & on the search for strong winds out of the North",0,0,0,1,1,300
2479525350,saurabh2506,working on Cognitive science and Climate Change Adaptation; interested in  socio-ecological resilence; all admiration for - complex systems science',0,0,1,1,2,300
25068244,b_p_chamberlain,ML Researcher @twitter | Head of ML @ASOS | ML PhD @imperialcollege | Research Scientist @QinetiQ. All views my own.,3,0,0,0,3,300
139380235,itsecuriteer,IT Security & Information Risk Management Analyst and Author Information security is based on outsmarting the other (the dark;-) side http://t.co/DVsUcoCV,1,0,0,0,1,300
135334886,BenJamesEdwards,Statistical modeling and Data Science at @cyentiainst. PhD. I also like food and stuff. Retweets are correlation not causation.,1,0,0,0,1,300
184199979,psorianom,"Interested in NLP, chilaquiles, Machine Learning, magrets de canard, HPC, sincronizadas y chabrot. #CDMX  #69007. Currently, leveraging open data @etalab",1,0,0,0,1,300
29526276,slartinyc,Data engineer / ML + NLP / music that goes bleep.,0,0,1,0,1,300
15060827,arildfax,I do Health informatics research at NTNU.,0,0,1,0,1,300
2607308140,_Kai_Zhao,"Assistant Professor, Robinson College of Business, Georgia State University. AI for Business",0,0,0,1,1,205
2414056867,DrAlexPenn,"FRSA: Complexity, steering complex systems/systems aikido, ALife & Society, evo-ecol & microbes, permaculture, citizen science-exciting stuff, too many fields!",0,0,9,0,9,300
2605680626,FeIiX_H,PhD Candidate in Political Science @uniofgothenburg. Research Associate @GLD_Gothenburg. Political Economy,1,0,0,0,1,300
2167029012,smtweedt,Paleobiologist studying fossils and developmental evolution in deep time,0,0,1,0,1,94
608355240,DanielCooney1,"Graduate student in applied mathematics. Interested in differential equations, evolutionary game theory, and theoretical ecology.",0,0,0,2,2,300
2356876506,arivli14,"Physics PhD candidate at UC Davis / into information, quantum processes and complex systems/ Low correlation tweets / A veces en español de 🇨🇷 (Costa Rica)",0,0,1,0,1,230
934621938,nellylitvak,"Профессор математики в Голландии, автор книг  `Формула призвания. 7 правил выбора вуза' и `Наши хорошие подростки'.",2,0,0,2,4,300
488751051,Masa_Haraguchi,"Postdoc @Harvard, PhD @columbiawater @Columbia. Climate risks, disasters, interdependencies, water-energy-food, urban infrastructure, sustainability, data sci.",0,0,0,1,1,300
65937473,Interactome,Large scale mapping and analysis of molecular plant and host-microbe interaction networks. Institute of Network Biology (INET) at HMGU. Opinions are my own.,0,0,0,1,1,300
3222385944,colemathis__,"PhD.

Somewhere between an Astrobiologist and Complex Systems scientist. 

Obsessed with the origin of life.",0,0,0,1,1,300
33911332,Ortelio,,0,0,1,0,1,300
170036250,Plektix,"Associate Professor of Mathematics at Emmanuel College, studying evolutionary dynamics and complex systems. Unapologetic SJW.",0,0,1,0,1,300
2722548632,sebbromano,Neuroscientist @IBioBA_MPSP Max Planck Partner Institute in Buenos Aires.,0,1,0,0,1,279
3148529322,GabbyLibbyBeans,"Biologist, photographer, science communicator. Working in IceLab & Curiosum, Umeå, Sweden. (she/her)
Also tweeting from @Icelab_umea",0,0,1,1,2,300
208267929,n_mcevoy,Observer of change. Researcher in healthcare system simulation. Asking why and how?,0,1,0,0,1,41
3020227294,OpenLab_App,Increase scientific productivity via #socialtools and #bigdata. #openaccess #opendata believer. Research methodolgy blog @ http://t.co/mcl3ZJWN3U,1,0,0,0,1,81
30561407,SaldivarMG,"I'm a cognitive scientist and data analyst. I apply quantitative methods to understand how humans learn and develop, especially in educational settings.",1,0,0,0,1,300
322089105,lukejchang,Director of the Computational Social Affective Neuroscience Laboratory and Assistant Professor in Psychological and Brain Sciences at Dartmouth College,1,0,0,0,1,299
807344126,lewiswbrown,"coder, philosopher, trader, farmer, #voluntaryist, evolutionary complex systems geek",0,0,1,0,1,300
1876605181,ANKhambhati,"::neuroengineer:: 

network neuroscience, network control, neurostimulation, epilepsy

Opinions are my own.",0,1,1,1,3,300
251908806,DMfun,"Data Miner, Bioinformatician, Learning Scientist, Professor, Runner,  DC Resident",0,0,0,1,1,300
2579291431,DiamantisSellis,complex systems modeler @cosmotechweb,1,0,2,0,3,300
14335176,marciano_moreno,Computing Practitioner. Entrepreneur. @NaylaVentures Founder and CEO.,0,0,1,0,1,300
192524919,_rychen,Bone Apple Tea,1,0,0,0,1,300
634216642,ROEStrar,"Systems, Complexity.",0,0,0,1,1,300
42447945,yolayne,Former foster kid building robots for preschoolers at https://t.co/ghq4jjVsoB. Double PhD student in computer science and cognitive science at @CUBoulder & @NSFGRFP.,0,0,0,1,1,300
2887412200,SFIAlumni,,2,0,1,1,4,227
116657197,robertmanduca,Sociology PhD student at @Harvard studying income concentration and cities. Headed to @UMsociology in fall 2020. All personal problems are structural problems.,1,0,0,0,1,300
51947712,LuisZaman,Assistant Prof. at University of Michigan in Complex Systems and Ecology & Evolutionary Biology. Experimental Microbial + Computation Evolution.  (He/His),1,0,1,0,2,300
23641922,bryanmuir,,0,0,0,1,1,300
35908657,biotopos,Biologist. Management Consultant. Auditor of Certified Systems. Expert in Biomimicry Design & Complexity Sciences.,0,0,1,0,1,300
413424906,a_360_view,"Associate Provost for University ELearning Initiatives at the College of William and Mary, Tech & Comm Researcher, Innovator in Tech & Higher Ed",1,0,0,0,1,300
340037000,AdaptiveAgents,Research Scientist in AI Safety & Foundations at DeepMind,0,0,1,0,1,300
2673407557,homos0c1alis,,0,0,3,0,3,57
95685085,HSDInstitute,Nothing is intractable.,0,0,2,0,2,254
4029491,gothandy,Mountain Biker. Father of 3. Business owner. Sitecore fanatic. Complex Systems geek. Trying to enjoy the ride and find some decent flow.,0,0,1,0,1,300
48394666,scalefreegan,Admirer of complex biological systems at @EMBL in @LarsMSteinmetz lab,0,0,1,0,1,300
495262329,jjpfeiffer3,Purdue PhD student.  I like ML.,1,0,0,0,1,41
2544953329,FPHeld,"Postdoc in systems, social networks, self-organisation, data and pretty graphs",1,0,1,1,3,239
75369074,YongrenShi,"Assistant Professor of Sociology at #uiowa. Networks, culture, organizations and computation.",2,0,0,0,2,96
2575841712,jdgthree,"Chief Communications Officer at Lawrence Berkeley National Lab, public relations fail commentator, futbol aficionado",0,0,1,0,1,117
1180385809,EnergyFrin,Associate Professor at @LeedsUniCIER & @SRILeeds in complex urban energy systems,0,0,1,0,1,300
363153981,danielebarch,Data scientist,4,0,2,0,6,75
38135820,jdyeakel,"Assistant professor @ UC Merced & former Omidyar fellow @ the Santa Fe Inst. Complex systems, food webs, paleontology, eco-dynamics, isotopes, & HP Lovecraft.",0,0,1,0,1,300
251007206,jmuiuc,"Associate Professor at CMU School of Computer Science, Computational Biologist @CMUCompBio @SCSatCMU",1,0,0,0,1,300
260656385,blattnerma,born; educated in #physics; living in the #data universe. mostly merciless,0,1,0,0,1,300
770762804,natiwo,"Here for leadership, tech, ads, 🏀 & more. #iamintel working on ☁️ to 💻 She/Her, Alum: @CornellMBA @haverfordedu @pennGSE @Teachforamerica Philly @ml4t",1,0,0,0,1,300
5662932,mikaelhuss,"Former bioinformatics scientist at @scilifelab, now machine learning freelancer (https://t.co/Zx3Qles6S5). Ex-Peltarion. Sometime blogger @followthedata",0,0,0,1,1,300
41518369,SDKaszycki,Getting back into this Twitter thing. Maybe. Phd 2017 University of Georgia.,0,1,0,0,1,300
1537494776,DavidPSanders,"Scientific computing, experimental mathematics, #julialang, teacher, viol(in)ist",0,0,1,0,1,300
228937822,yongjinp28,"statistical machine learning, genetics and network",0,1,0,1,2,300
440645901,winsonpeng2011,Communication + Social/Mobile Media + Computational Methods -- Associate Professor @ Michigan State University. Tweets are my own.,2,0,0,2,4,300
147341406,cesar7f,,0,0,1,0,1,30
124344740,ieoi31,,0,0,0,1,1,39
212382437,psmaldino,Paradigmatically promiscuous scientist. Modeler. Asst Prof of Cognitive & Information Sciences @ucmerced. The revolution will not be twitterized.,0,0,1,0,1,300
320539498,ShuguangHan,"Working at Google AI. Phd from Univ. of Pittsburgh. Information Retrieval Researcher. Interned at Google, Yahoo! Labs and Baidu",0,1,0,0,1,60
44730818,lvalienteb,,0,0,0,1,1,40
405121767,DrAdamPowell,"Senior Researcher / ERC PI, Department of Human Behavior, Ecology and Culture, Max Planck Institute for Evolutionary Anthropology",3,0,0,0,3,73
461379146,CSS_GMU,"Computational Social Science Program at George Mason University, Agent-based Modeling, Social Networks, Complexity, Understanding & solving real world problems",3,0,1,0,4,300
24574024,JoshuaGarland,,0,0,2,0,2,300
18506226,amiyaal,"Senior Lecturer @ Bar-Ilan University, Israel | Ecology & Evolution of Social Behavior | Animal Social Networks | Animal Communication",6,0,0,0,6,300
17476667,berty38,"Assistant professor of computer science, machine learning researcher. He/him/his.",0,0,0,1,1,300
1587409878,Nora_Connor,"Ph.D. in Computer Science, Data Scientist working in healthcare and political science. Interests include ML, ontologies, and social determinants of health.",0,0,0,1,1,127
300982073,BernardRyefield,"Author - Auteur
http://t.co/NTOKthAMs6",0,0,1,0,1,300
47477919,KarineGantin,"Translator, trainer, editor, mother.",1,0,0,0,1,300
19114108,prgarnett,"Interested in complexity; social systems, algorithms, Big Data, security. Member of @yccsa and @UoY_SATSU. Tweets are personal, some might be interesting.",0,0,2,0,2,300
16403155,AndyCrooks,"Associate Prof of Computational Social Science @CSS_GMU & @GGSDepartment at @GeorgeMasonU. #Geography, #ABM, #GIS. New Book: https://t.co/ZS6K2izu03",3,0,0,1,4,300
606307674,Socievolea,"Researcher at ICAR-CNR interested in complex networks, human mobility and social networks.",1,1,0,0,2,300
272682658,hawkrobe,computational cognitive scientist at Princeton,1,0,0,0,1,207
1257966176,YvesDubief,"Mechanical engineering professor. My life revolves around two boys, one beautiful wife, two cats, complex fluid phenomena, teaching, biathlon and alpine skiing",0,0,1,0,1,300
15023025,MichaelRFerrari,"Complex Systems Science/Engineering & Data Science. 
Climate•Atmospheres•Evolutionary & Fluid Dynamics•ESG•FinGeo•Risk.",0,0,1,0,1,300
836194548,ViveraeEng,Building a Healthcare Behavior Change Platform #javascript #devops #gamemechanics #analytics #sandiego #dallas,1,0,0,0,1,300
135065698,hendysh,"Physical sciences, complex systems, innovation, #scicomm, #KindnessInScience, #NoFly, @punahamatatini, @AucklandUni",0,0,1,0,1,300
467491930,DrAlexRyan,VP Systems Innovation @MaRSDD & Director @solutions_lab,0,0,2,0,2,300
39593856,Ron_MyIdeaTree,"Founder & CEO, https://t.co/XI3q5Lo150, interested in collaboration, brainstorming, knowledge discovery, and uncovering latent wisdom.",1,0,0,0,1,178
93873277,sergei_maslov,"Professor of Bioengineering and Physics at the University of Illinois, Urbana-Champaign working on genomics, evolution, systems biology, and complex networks",0,2,0,0,2,146
1017832027,AndrewCabaniss,"Archaeology PhD student at the University of Michigan. Ancient cities, household agency, and complex systems. Greece and the broader Hellenic world. He/him.",0,0,2,0,2,190
289134255,jimthommo,"Associate Professor, George Mason University, Fairfax, VA, USA. Cognitive neuroscientist, stats geek, Carlton supporter.",1,0,0,0,1,300
20067721,vijen,art and science in transitions,0,1,0,0,1,227
48071740,gammasync,,0,0,1,0,1,300
381012704,JanaWatsonCapps,,0,1,0,0,1,300
299207310,shuhenglin,,0,0,0,1,1,120
546081128,SFAFScienceCafe,SFAFS is a nonprofit 501(c)(3) of scientists and engineers who work with schools in the greater Santa Fe area to help improve K-14 math and science education,0,0,1,0,1,78
370172421,pbloemesquire,"Machine Learning Postdoc at UvA and VU (@INDE_LAB_AMS & @krr_vu) Studying Sparsity,  Knowledge Graphs, and Fairness. Header: https://t.co/LbO1Ihdwor",0,0,1,0,1,300
21432050,bkimbell,,0,1,0,0,1,300
212901419,cas_group,From gluons to galaxies and quarks to quasars: Innovative insights💡about complex adaptive systems. Operated by @JochenFromm,0,0,1,0,1,300
249389040,Entropisch,"Lapsed economist, recovering mathematician, off-the-shelf & not very deeply learned computer scientist. Stats/ML, graphs, philosophy, global health, runs.",1,0,0,0,1,300
25782966,OutlierProf,Assistant Professor @RutgersBschool. I teach and do research on the emergence of outliers in entrepreneurship. NSF grant helping push it all forward...,0,0,1,0,1,152
9700072,cuihua,"Scholar of social media, digital games, big data and social networks. Observer of all things tech. Prof at UC Davis. Mom of a cancer kid. Opinions are my own.",1,0,0,0,1,300
17396121,venusatuluri,"Data Mining Ph.D. from Ohio State, now @Twitter. Updates on topics chosen uniformly at random.",0,0,1,0,1,300
247629991,SusannaChandler,,1,0,0,0,1,242
78834227,deanmalmgren,executive portfolio director and data scientist @ideo // former @dsatweet cofounder // @thisismetis @nuvention @umsi @elemetric_ advisor,1,0,0,0,1,300
16665857,brianlawler,"These are my own tweets. Right, like anyone else could be responsible for this noise.",0,0,1,0,1,300
45330789,aleahmad,"Turadg Aleahmad, Analytics Engineer at Coursera",1,0,0,0,1,173
2708319865,JacksonmMatt,,1,0,0,0,1,53
41875374,sugandhwafai,"reading, cooking, learning new things and software, and looking for a job.",0,0,0,1,1,300
1094616925647327235,_slowlettuce,"RTs =🤔, come rock my priors",0,0,1,0,1,300
1226616695080574977,ThomasH24161336,"Interested in causal inference, complex networks, and computational social science.

推し：@suisei_hosimati ← 今日もかわいい",0,1,0,0,1,4
2328075054,ellamguest,"Research associate on Public Policy Programme @turinginst.
PhD researcher in Reddit lurking @OfficialUoM.",1,0,0,0,1,34
390586695,IBEI,"#research & postgrad #education in international relations, politics & development to advance the understanding of global challenges to governance in our world.",2,0,0,0,2,300
334765997,JohnRobPool,@WorldResources & @Cities4Forests | @UniofOxford & @Rhodes_Uni | #RuralDevelopment #Africa #NaturalCapital #WaterSecurity #ClimateResilience | Own views,1,0,0,0,1,300
25293397,JeroenStragier,Visiting scholar at MIT Media Lab - Postdoc at Ghent University - Proud dad of Winter & Marit - Wearable tech - health behavior - behavior change - Ironman,1,0,0,0,1,300
137986271,kclarity,"Evaluation, data & learning. Views my own.",0,0,2,0,2,300
594855914,FHaouari,"PhD Student in Computer Science, Qatar University. Interested in information retrieval, natural language processing, machine learning and deep learning.",0,0,0,1,1,300
825790087560564738,laragard_,"Digital Humanist. Social reflection on information technology, data meaning, distant reading & open access.",1,0,0,0,1,300
960902861772283904,FreedMichael23,"PhD from @mitpolisci. Postdoc at Hebrew University, assistant professor at University of Haifa. Religious leaders and conflict in Israel, Middle East.",1,0,0,0,1,300
750426116519759872,PaolilloRoc,"PhD-departs @BIGSSS_Bremen, social complexity and agent-based models | residential segregation | immigrant integration | ...",1,0,0,0,1,300
597801279,iporras_jose,,1,0,0,0,1,300
226698188,ninadicara,"[she/her] Mental health data science, family social work, PhD chat📱Proud Trustee for @svcymru 🤝",1,0,0,0,1,300
403060037,digital_meaning,"Knowledge Management,Behavioral Analytics, Strategic Intelligence, #FutureofWork, #edtech #elearning, Corporate Training #Localization #OSINT",1,0,0,0,1,300
861417356756533248,lucy3_li,"a.k.a. Li Lucy. Natural language processing and computational social science. @UCBerkeley PhD student. Previously: @Stanford '18, MS '19. she/her",1,0,0,0,1,300
258342412,osullivansara,"Sociology lecturer at UCD, researching gender, #repealthe8th, SoTL. Co-editor Irish Journal Sociology https://t.co/1aqtk7ty4n",1,0,0,0,1,300
856058012930330624,berriche_manon,PhD Candidate @medialab_scpo 👩‍💻 Working on #disinformation 🤔 Graduated from @sciencespo & @criparis  👩‍🎓 Also passionate about literature 📚,1,0,0,0,1,300
1174759372586663943,mokatttt,r̷a̷i̷s̷o̷n̷n̷a̷b̷l̷e̷m̷e̷n̷t̷ ̷d̷é̷c̷o̷n̷t̷r̷a̷c̷t̷é̷e̷,0,0,1,1,2,73
806381131927080962,armin_neuro,Computational neuroscience researcher | M. Sc. integrative neuroscience scholar at @OVGUpresse IBIO | Currently pursuing Master thesis with @GJocham at @hhu_de,0,1,0,0,1,135
1090631653783977989,projectEUNOMIA,"H2020 project EUNOMIA: User-oriented, secure, trustful and decentralised social media
https://t.co/FVhVhBMBcg",1,0,0,0,1,241
284142381,NetMev,"Assistant Professor | Center for Media and Journalism Studies |
University of Groningen",1,0,0,0,1,300
21285682,AXCavero,"Argonaut, digital explorer & creative thinker. Latelly interested in data ethics, Blockchain and rock'n'roll. CEO at @caelumlabs",1,0,0,0,1,300
1181565438775431168,GblVincent,"Always late, but kind anyway. 
Historian and student (International Relations).
Love books, beers, wine and movies.",2,0,0,0,2,91
863139289,AngelikiMonnier,"Prof. Information-Communication, @Univ_Lorraine @Crem_UL @MasterJMN",1,0,0,0,1,300
1170590019829956608,rikkimendiola,"Comm x ComSci | Studies Comm and Tech, HCI | Aspiring scientist",0,0,1,1,2,204
923910074233475072,Lana_Bilalova,"PhD cand @LSEIRDept. Quant text methods,  NLP for soc.sci., ML for text methods, media bias, computational soc.sci. Russia, Ukraine. RTs != endrts",1,0,0,0,1,233
600294991,sparkyuncut,"Business Owner, Software Development, IT Infrastructure Engineer, Web Hosting & Ecommerce and Electrician and Cable Monkey / Technical Installer",0,0,2,0,2,300
15071251,DeborahmCollier,"Leader in Education, Business & Digital.  Executive Producer, Author, Presenter, Futurist CEO / CMO / CIO & NED.  President at the Digital Skills Authority",8,0,0,0,8,300
57343120,milantheshrink,"Psychiatrist,Believer in Unconditional Love and Chocolate ice cream,
Technology in #mentalhealth #stigma #mindful 
#AI #ML transform Healthcare",1,0,0,0,1,300
2909357496,Rajeshtipparapu,,1,0,0,0,1,300
56893721,MarcosG_M,"Ni am@s, ni esclav@s. Teoría Crítica hecha periodismo, arte y activismo. Cofundé @DataCritica. Becario 2019-2020 del @FONCAMX. PGP Key ID: 363C5246",1,0,0,0,1,300
23233540,Tehranix,Optimist. Detecting social media manipulation @astroscreenhq. @Techstars alum.,1,0,0,0,1,300
3290954644,Hossein_income,"Im Iranian Blogger Hossein Daramad A developer And programmer Web 
https://t.co/sCSrMofN7L
https://t.co/7cKMuGOB76",1,0,0,0,1,300
15807813,cfwells,"assistant professor, journalism & emerging media studies, boston university. opinions my own and subject to revision",1,0,0,0,1,300
1085268044165890048,Actual_Chat,Actual is an AI-mediated chat app for meaningful conversations 🤗📱🤗 WAITING LIST: https://t.co/mX4EJrxqus (We formerly tweeted as @IxyHelps),1,0,0,0,1,131
867312279355871234,NoortjeMarres,"Professor in Science, Technology & Society (STS), Digital Sociology, interdisciplinary experiments at CIM (University of Warwick)",0,0,0,1,1,300
18270066,freedomhouse,Freedom House is an independent watchdog organization dedicated to the expansion of freedom around the world. Check out @FreedomOnTheNet for more.,1,0,0,0,1,300
72620239,lizzypostel,"I live by these words by the Lady Amy Poehler: ""The robots will kill us all.""",1,0,0,0,1,300
1037685217547485184,AVermillet,"Instructor in Cognitive Science, Aarhus University.
Occasional musician.",0,0,0,1,1,50
124669129,surangasms01,"Researcher in Mobile Security & Privacy. Tweets #Tech, #Chess, #Cricket, #DataScience, Newbie #DeepLearning",0,0,1,1,2,300
917376183947485184,ebrahimireza1,"Machine Learning Engineer
#AI | #IIoT | #DigitalTwins | #AutonomousSystems",0,1,0,0,1,53
882808693,JoaoABeraldo,VC Platform @eqtventures | MSc @LSEdatasociety | BA @warstudies,1,0,0,0,1,125
2999579951,birlamirla,,0,0,1,0,1,229
928655012443459584,JudeHKurniawan,"Postdoctoral Fellow, PhD (ABD) @sutdsg. #scenario & #foresight researcher in #energy, #transport, #mobility, #technology, #SmartCities",0,0,1,1,2,300
142078689,vndimitrova,"PhD student in economics @warwickecon | education & labour, collaborative research & networks, health & environment",1,0,0,0,1,300
4920081483,ssudars_clemson,"Dynamical Systems, Fluid Dynamics. Clemson Tiger.Assistant professor at MEC. Tweeting in personal capacity.",0,0,1,0,1,227
96102210,PLOSBiology,"PLOS Biology, the PLOS flagship journal in the life sciences, is a highly selective open-access, peer-reviewed general biology journal (published by https://t.co/Rw7iuTOHdk).",1,0,0,0,1,300
909911057589665792,liulch16,Ph.D. student @MITPoliSci,0,0,0,1,1,42
166479009,ZeerakW,"PhD @SheffieldNLP #NLProc, structural inequality, and languages. Researching hate speech online. Organising @AbusiveLangWS. DMs open.",1,0,0,0,1,300
2907896399,philnyc,"The commons 4 the common good: ""Mankind have as equal & just a property in land as they have in liberty, air, or the light & heat of the sun."" ThomasSpence1775",0,1,0,0,1,300
906613973423865856,EthicsOfAI,News and discussion on AI Ethics and policy.,0,0,1,0,1,19
201664779,malekz4deh,PhD Student @QMUL/@intelsensing; member of @databoxproject @ImperialCollege #Sensor #Data #Privacy #MachineLearning 🚵🏻‍♂️,0,2,0,0,2,300
88750176,DaesAgelmar,"Kimi zaman seyre dalar şu alemi, kimi zaman alem beni seyre...",0,0,0,1,1,300
20661896,RodrigoCetina,Com Law & Policy: How does a privatized digital public sphere interfere w/ freedom of expression / Exec. Director RCC @Harvard & IGLP @HarvardLaw Researcher,1,0,0,0,1,300
30406341,Katalinovich,I (don't) know this girl.,1,0,0,0,1,300
932728257778274305,jmenter_93,"Data Scientist @mmdatascience - M.S. C.S. @umasscs '19, B.A. Math, @smithcollege '16 - STS + algo fairness + causality - Opinions are mine - She/her 🏳️‍🌈♿",0,0,0,1,1,300
366323045,MalJayaram,"Faculty Associate @BKCHarvard & Executive Director, @digitalasiahub. Privacy, identity, data ethics, law, technology, Asia, culture, travel.",1,0,0,0,1,300
956767843730649088,tianyangyt,"PhDing in Communication @AnnenbergPenn
PoliComm + Network",1,0,0,0,1,24
165163696,guircarlos,,1,0,0,0,1,300
3401363555,donara_barojan,Information Warfare Expert / Trainer / Deputy Project Director at Zinc Network. Previously with @stratcomcoe & @dfrlab 🇱🇹 living in 🇱🇻/🇬🇧,1,0,0,0,1,300
46895181,kavesalamatian,,0,0,0,1,1,300
2725181065,ashrayme,Lecturer @ The University of Queensland. Work on NLP and Social Media.,1,0,0,0,1,300
131122922,DBarnardWills,"Political Scientist working on technology,  privacy, identity, security and the politics of surveillance. Senior Research Manager at Trilateral Research",2,0,0,0,2,300
79744977,hunglt9,"Tech Evangelist and Python Developer at Developer Circles from Facebook. I'm newbie #DataScience , #MachineLearning, #BusinessIntelligence & Analytics",1,0,0,0,1,298
1165874058,AnamusTimes,PhD student in Computational Biology at ETHZ.,0,0,0,1,1,294
100180651,hafeezmhd,Perpetually fighting Entropy,1,0,0,0,1,300
2385300366,r_josefsson,"Occasional tweeter, Chief Economist & Founder of Alta Doctrina AB. Errors or omissions are my own doing. If you disagree, let’s discuss!",0,0,1,0,1,300
14611059,egflo,"Senior Researcher in Cybersecurity @CSS_Zurich @ETH_en.
Research Associate at @OxfordCTGA @UniofOxford.",0,0,1,0,1,300
920653165996924929,NithinP_,,1,0,0,0,1,300
45511536,ashkurko,"Spent my first 7 years in 🇷🇺, the rest mostly in SF. Interested in politics, policy, tech, society,. @UCSanDiego alum.",1,0,0,0,1,300
14288561,iason,"Stand back, I 'm going to try science!",0,0,2,0,2,300
211013669,rohanmwilliams,"I want to be better & make work better. Aspiring I/O psychologist. Reader, writer, scientist, trivia nerd, player, fan, composer, husband to @Marieze, dad.",0,0,5,0,5,300
184445216,nassereledroos,"Technologist with @DARollins || I study race, technology and privacy in criminal legal systems || Former Tech Fellow w/ @ACLU_Mass || views mine || 🇾🇪🇮🇳🇺🇸",1,0,0,0,1,300
153876878,tinakovacova,"ML practitioner, MBA, entrepreneur. 🇸🇰🇬🇧🇫🇮🇨🇦",0,0,1,0,1,300
19750159,justinhendrix,"Brooklyn, emerging media & technology, NYC Media Lab + RLab, formerly at The Economist. Opinions mine. Not a journalist.",1,0,0,0,1,300
3031711163,hellochmi,Tbh don't know how Twitter works,0,0,1,0,1,34
45217765,benji_smith,Founder of @ShaxpirHQ  Creator of https://t.co/hKLLxZD4pe  Author of Abandoned Ship https://t.co/8w2Bzbxnxo  Loving husband of @emilylaumusic,0,0,1,0,1,300
95083618,jeu1987,Researching sociology of quantification & machine-assisted decision making (ML/DSS/AI) @jadatascience Developing data science services for SMEs,1,0,0,0,1,300
47963552,FadyKalo,"Product Owner @AdbrainTech. I live my life in beta. Interested in startup, tool builder, gadget lover and everyday life hacker. Fail Fast, Fail Forward.",0,0,1,0,1,300
15269360,etopirika5,"世界を放浪しながらコンピュターや数値計算、数値設計の研究をしてます。目指せ定住！


東京→デルフト🇳🇱→東京→NY🇺🇸→東京→ロンドン🇬🇧→東京→北京🇨🇳→東京→トロント🇨🇦→スイス🇨🇭→トロント🇨🇦→東京（New!）",0,0,1,0,1,300
808893873766432768,maheedhargunnam,"Computer Science Master's Student @ODU, Member @WebSciDL",1,0,0,0,1,38
1563961200,guilbon,Interventional cardiologist. @HopitalPompidou PhD student. #precisionmedecine #IntegrativEpidemiology @paristxgroup Young cardiologist. #ESCCoT @CCF_cardio,1,0,0,0,1,300
456387366,YazdanKakaei,Software Engineer,1,0,0,0,1,300
47074771,AliiKhatibi,Neuro-enthusiastic|Senior Research Fellow|@CprSpine |@unibirmingham|Pain| NeuroImaging|SpinalCord|Neuroplasticity|OpenScience|Runner|Movie-lover| He/His,0,0,0,1,1,300
3279885278,IpshitaZ,Postdoc at NYU. Studying entorhinal and hippocampal circuits that support spatial memory.,0,1,0,0,1,107
337748783,rituroych,"Brain states, Networks, BehaviourNeuroscience. PhD student in Cornelius Schwarz's lab @CIN_UniversityofTübingen | @mpiNeuro |
Cerebellum now, erstwhile Insula",0,0,0,1,1,263
26347355,favareja,Intentando innovar la educación con tecnologías/Trying to innovate education with thecnologies,1,0,0,0,1,300
835426850100953088,ScienceStandard,"We bring science closer to life. Publish updates from Industry and Innovators. Focus: Genomics, Next gen Tech, Precision medicine, Discovery Medicine",0,0,0,1,1,300
4273813048,DanLammerhirt,Data ethnographer. Interested in the political economy of data. Current: PhD on cooperative health data platforms/apps @locatingmedia. Past: research lead @okfn,0,0,1,0,1,300
1515330510,GuptaRajat033,"Software Engineer;Udacity Mentor for NLP,AI and DRL NDs, Student @fastdotai; dally on twitter, reddit, arxiv, kaggle and MOOCs in DL",1,0,0,0,1,300
1267094256,JaiSeaman,"Publisher, Research Methods, SAGE Publishing",1,0,0,0,1,191
70940388,sbetamc,"Security Engineer @ConsenSysAudits \r\n PhD Candidate @Concordia \r\n Former: @Bitaccess @goFaast \r\n Founder: @shiryakhat, @RxCMontreal, @superbitcoiner",1,0,0,0,1,300
769555544613027840,AleMSMachado,"Biologist, PhD Student in Ecology @UFSC.",1,0,0,0,1,300
763984830,rdthinker,"code, distributed system, operating system, big data, datascience, literature, art, edutech",0,0,2,0,2,214
828192525848498176,futures_sandbox,"Independent non-profit community learning platform for Futures Studies- Explore, Experiment, Experience. Founded by @itsanisah @aloha_futures",0,0,2,0,2,300
28170598,Ea_Qadeer,"Striving towards coherency.  Interests: energy, economics, entrepreneurship, investment, education, and Afghanistan.",1,0,0,0,1,232
17365579,biem113,,0,0,1,0,1,300
15414807,johnmaeda,"EVP Chief Experience Officer, Publicis Sapient | Board Sonos | How To Speak Machine https://t.co/TaiK3rLDq5 | STEM to STEAM | Exec Producer #CanvasFilm | AGI",0,0,1,0,1,300
156926668,emmanueltouzery,"French in Slovenia, father of three, java by day, haskell+rust by night, linux user, ex-rubyist.",0,0,1,0,1,300
103710211,bobogejiaqi,"Agent-based modeller, economist",1,0,2,1,4,300
96008020,Jacoboermen,"Interested in digital media, user engagement, research methods, log data analysis, and media economy. Ass. Prof. at Uni. of Copenhagen.",1,0,0,0,1,300
988408902,carmel_kent,"Online collaborative learning, the Semantic Web,open biomedical informatics, learning analytics",3,0,0,0,3,300
1387770396,Big_Data_Face,Computational Social Scientist. I'm interested in big social data and anything on sports data analytics. I love a bit of Moneyball,1,0,0,0,1,300
56741675,xrysoflhs,"Prof of NLP at QMUL, London and Warwick, UK. Interests: #NLProc, textmining;biomedical applications;#ComputationalSemantics, scientific #discourse;social media",1,0,0,0,1,300
1922183119,EssiDeh,Social media researcher at QUT Digital Media Research Centre (@qutdmrc),0,0,0,1,1,300
2473705581,ILorscheid,"Professor of Digital Business and Data Science, Vice–Rector Research. Agent–based Modeling — 📚 https://t.co/sUWvfLmysg",0,0,1,0,1,234
763673716714770432,arowan_ml,Bayesian reasoning and probabilistic programming in industry.,0,0,1,0,1,300
1608934440,MichaelBossetta,"Social Media and Politics Researcher |
Postdoc & future Asst. Prof. @LundUniversity 🇸🇪
Pinball Wizard 💫
Host: @SMandPPodcast🎙
Co-host: @MetalAcademix ⚔️",1,0,0,0,1,300
78291551,incognitosum,Mucks with minds @Swinburne. PhD-in-progress. Member @profuturists. Curious about post-growth innovation. Or is that post-innovation innovation?,0,0,1,0,1,300
2367405893,JDzakula,"Fellow, LSE",1,0,0,0,1,181
208600933,GlobalSherpa,"Mostly insights and ideas on global development, sustainability, esg/impact investing. Advocate for inclusion and opportunity. Likes nature, maps, data.",0,0,1,0,1,300
1072244070,UrbanoReviglio,"Ph.D candidate on Internet ethics, personalization and serendipity.",1,0,0,0,1,300
99258364,waelalwani,"Human
https://t.co/hhATaZ4pJ9",1,0,0,0,1,300
419652244,DarraghMcCashin,@TEAM_ITN Early Stage Researcher/@UCDPsychology PhD student. Interested in clinical/forensic applications of technology.,1,0,0,0,1,300
3031612759,predictech,"UCIPT is a multicampus, multidisciplinary collaborative accelerating innovations that leverage social technologies to predict human behaviors and outcomes.",1,0,0,0,1,300
253890669,boyu2011,,0,0,1,0,1,300
566812856,gracebene,PhD student in Communication at @ucdavis,5,0,0,0,5,72
337943052,NicPes,Principal investigator in Hybrid collective intelligence at the Max Planck Center for Humans and Machines. Interested in brains and bots doing stuff together.,0,0,1,0,1,300
44601535,ilincavalentina,simple girl in a high tech digital world • 🇷🇴 + 🇩🇪 • i like to have fun with data & get crafty w pen & paper/code/words. data science director @wunthompson,0,0,0,1,1,300
426279405,jisa_,"An International Journal covering: Networking protocols and architectures; web protocols, standards, and development; security; middleware; cloud, and much more",3,1,0,0,4,300
15138336,petrushyna,is a close-to-finish PhD that adores working with data and define useful insights for learning or business purposes. She is working at ACIS at RWTH with @klamma,1,0,0,0,1,300
3807113533,RahmtinR,Software engineer @ Google. Interested in social networks and graphs.,1,0,0,0,1,137
3947870715,lopezmodeler,Physicist and mathematical modeler,0,0,0,2,2,107
2395777129,homa_r86,"PhD Built Environment, interested in technologies of communication, collaboration and participation",1,1,0,0,2,144
2343366632,reyes_cornelia,"Lecturer in Digital Methods @KingsCollegeLon, online social networks researcher, PhD @MediaLSE",3,0,0,0,3,192
3815201,hanimorsi,PhD candidate @IDS_UK. Interested in how people use emerging technolgies to challenge injustice. Other interests: mountain bikes and strong black coffee.,2,0,0,0,2,300
1693998487,djtsumpter,This is my old account. Please follow me at @Soccermatics.,1,0,1,0,2,300
459714447,amedhat_,"Staff Data Scientist @Facebook. Previously, Chief Data Scientist of @DueDil and Researcher @oiioxford. Egyptian.",1,0,0,0,1,115
474914634,aileen_mb,Senior Research Impact Facilitator for Social Sciences Division at Oxford Uni - views my own,1,0,0,0,1,300
501199289,bcsparksgrove,"Marketing Scientist, polymath, innovator, and data visualization evangelist",1,0,0,0,1,300
16708296,ituassu,Professor de Comunicação Política da Pontifícia Universidade Católica do Rio de Janeiro (PUC-Rio),1,0,1,0,2,300
93622724,monica_murero,"Academic Prof. Rientro Cervelli awarded, 8 books, Communication and Healthcare, Social Robots, Interdigital Theory, Media Literacy, Wearable, ELife Dual Effects",1,0,0,0,1,300
633963776,KathrynEccles,"Digital Humanities Research Fellow, Oxford Internet Institute and Pembroke College",0,0,0,1,1,300
586246774,LofredM,Project Lead for AI at @wef but Philosopher at heart. I write mostly about the Governance of AI. Alum of the @oiioxford.,1,0,0,0,1,300
2969351825,Journal_DMDH,#computing #humanities #data_visualisation #information_retrieval #statistics #text_mining by #publishing #scholarly work beyond the traditional humanities,0,1,0,0,1,78
137286823,jiangluyun,,1,0,0,0,1,181
41041947,mlindsbrown,"Research Assistant Professor, Social Worker, amateur user/philosopher of technology, Emmett’s Mom  https://t.co/ln5KNYTYHY",1,0,0,0,1,300
9421422,dkmj,"The adjacent possible is a shadow future hovering on the edges of the present state of things, a map of the ways in which the present can reinvent itself #shifu",0,0,1,0,1,300
126981072,ClaireNS,#rtats #modelling #healtheconomics #cea #epidemiology #research,0,1,0,0,1,300
589408945,julioadl,Research Fellow @imperialcollege,1,0,0,0,1,300
176110250,i_scienceEU,iscienceEU: Open and multidisciplinary understanding of the development of the Internet as a societal and technological artefact.,1,0,0,0,1,300
628230869,BadHessian,"Collaborative computational social science blog. #rstats, Python, cluster computing. Don Knuth meets Charles Tilly. Submissions welcome: https://t.co/iPAGzovqmV",0,0,0,1,1,300
51131871,cristina_alaimo,"Assistant Professor in #DigitalEconomy and Society @UniLUISS, PhD @LSEManagement writing on #Data #DigitalPlatforms and other cool things 😎",1,0,0,0,1,300
6522202,dekstop,"Digital geography and data science @oiioxford, trustee @localwelcome. To not combat supremacist thought in 2020 means to become complicit in it.",1,0,1,0,2,300
57140128,VickiNashOII,"Deputy Director @ Oxford Internet Institute. Political theorist and policy geek, big on human rights, digital freedoms, DVD box sets, tea and cake.",1,0,0,0,1,300
708113,toledobastos,Communication & computational social science @CityUniLondon. DNAC affiliate at @DukeU and CCSS @ESS_Survey. Tweets not quite my own (see Twitter ToS) #rstats,2,0,0,0,2,300
156176296,AlathurSreejith,"Indian Institute of Technology Delhi.
E-Government, ICTs",1,0,0,0,1,30
6817322,fundinha,Research Manager at Facebook.,2,0,0,0,2,300
631854130,wcebc,The channel for Enterprise Social Network experts. #wcebc #wcsocbiz #ESN #collaboration #intranet Imprint: https://t.co/gx8s5tPZyO,1,0,0,0,1,300
69957686,sirleiarosa,"Doctorante, spécialiste en TIC et Éducation, EaD-FAD, médias sociaux - étudiants internationaux et migration Ambassadrice responsable pour @UdeMBrasil",1,0,0,0,1,245
22461446,timhighfield,"digital media, time, visual cultures @SocStudiesShef.
Social Media + Everyday Politics, @polityinstabook. next: Digital Time.
Secretary @ICAVisComm.
He/his.",1,0,0,0,1,300
1134154461583159296,BerruetaThomas,Robotics PhD at @NorthwesternU. @harveymudd alum '17. I do algorithmic work in understanding and exploiting emergent behavior in complex systems. VZ 🇻🇪.,0,0,1,0,1,148
1120097060336885765,am_stupinski,"UVM student studying data science, complex systems, and psychology. passionate about mental health awareness and playing in the mountains. she/her",0,0,1,0,1,50
1228794039815876608,YulinYuResearch,"ML, NLP, causal inference, Network, Computational Social Science researcher| @UMich@umsi PhD student |Opera Singer/ Classical music lifer | previous journalist",0,0,0,1,1,75
1162909805968875521,LaraBBro,Biology undergrad @ Smith College // fascinated by patterns & complex systems // dev bio & landscape studies with a sprinkling of applied math,0,0,1,0,1,20
1164727750487236608,hanryjoey,"Colleague student in Science Faculty Department of Mathematics
Bachelor of Art in English for work skills",1,0,0,0,1,300
52220052,joao_pedefeijao,Palavras nada Belas   ☯   Muito menos Confiáveis,0,0,1,0,1,300
78161066,DdotHes,| there’s never just one thing |,0,0,1,0,1,300
1222536781414969346,edenhofer_jacob,PPE finalist at The University of Warwick,1,0,0,1,2,300
2288758911,frederikDL,"Professor of Ecology @ UNamur interested in communities, ecosystems, biodiversity, environmental change, running. Assoc. Editor @JEcology",0,0,1,0,1,300
906744107908911104,bdescob,,0,0,1,0,1,300
2561629186,alleborghi1996,Currently doing MSc Systems and Control @tudelft,0,0,1,0,1,64
1032997493137723392,mbelotti99,working with complex systems modeling. views my own. (she/her). also updating @g2p2pop,0,0,1,0,1,92
241672832,ericpenaphysics,Physics + Computer Science @ Ohio State  | System Science + Complexity @ SUNY Binghamton,0,0,1,0,1,300
1196871291908902913,pmars19,"I'm a PhD student in the field of physics of complex systems, specialising in mobility systems.",0,0,1,0,1,2
1695606637,mikadomu,"cognitive models of opinion formation. trying to bridge the gap between physics, neuroscience and public policy.",1,0,1,0,2,160
149222626,brian_minard,"Into building software, the pragmatic use of Agile methods and creating products that delight customers. Avid horror fan. Speaking only for me.",0,0,1,0,1,300
4688598517,trickseye,friendly neighborhood reluctant replyguy,1,0,0,0,1,300
2847233865,sdroy2410,"Assistant Professor @csunorthridge  | Research interests: complex systems, time series analysis, agent based modeling",0,0,1,0,1,16
1181765492421337088,yannispetro,Stochastic Mechanics PhD student @Columbia. Studying uncertainty propagation. Designing robust structures. Curious about inherent human biases.,1,0,0,0,1,222
1177160699119906816,CDTRandomSys,"The @EPSRC Centre for Doctoral Training in Mathematics of Random Systems: Analysis, Modelling and Algorithms @OxUniMaths @OxfordStats @ImperialSci",0,0,1,0,1,128
251582810,d_rethans,"Cities - Social, environmental & economic sustainability. Incongruity perception. Bleeding edges. Holds simplistic views about complexity and vice versa.",0,0,2,0,2,300
433343491,matteosaponati,PhD candidate @ ESI for Neuroscience - IMPRS program @mpiBrain - master degree in physics - working on dynamics of prediction and learning. musician.,0,0,1,0,1,71
22671862,JoshHavu,Postdoc at @YaleEMD. Transmission dynamics of infectious diseases. Tuberculosis. Interested in DAGs and causal inference.,0,1,0,0,1,300
23793085,hunkara,Information matters!!,0,1,0,0,1,300
417599004,volsurfer,,1,0,0,0,1,300
1176134141194035200,maths_pepe,"Maths Profesor at Chihuahua State University. My research interests: Combinatorial optimization, machine learning, neural networks, complex systems.",0,0,1,0,1,0
82690534,virtualmario,"MD, PhD #neuroscientist: #language, 7T fMRI, ECoG, modelling ephys, func neurosurgery & BCI | Postdoc @TU_Muenchen, former @Maastrichtu | #OpenScience #Equality",0,0,1,0,1,300
1169154279120261120,SreejithS_,life ain't shit but a fat vagina.,1,0,0,0,1,52
116301504,ccc_personal,RT are not endorsements,1,0,0,0,1,300
760291693,SenecaWidvey,"Data Scientist and machine learning engineer with a background in mathematics, science, research, and psychology.",0,0,0,1,1,300
2780506176,stemler_t,"Lecturer Applied Mathematics UWA, either chaotic or stochastic but always complex",0,0,1,1,2,135
1490295024,stoll_martin,"Dad, numerical analyst, amateur Whisky drinker and aspiring coffee geek",0,1,1,0,2,300
891136116711141376,LoganTCollins,"My name is Logan Thrasher Collins and I make science fiction into reality. I'm a futurist, synthetic biologist, neuroscientist, and innovator.",0,0,1,0,1,199
796806627647066112,AlParsai,"Soyez réalistes, demandez l'impossible.",0,0,1,0,1,300
23690674,bree___martin,Mathematical biology @UTAS_. Modelling Australian megafauna extinction with @ecol_evo and @cabahCoE. 🐨🦘🌏,0,0,1,0,1,63
1046416613967192064,Aaragorn004,Bored of designing buildings and Bridges  for last 15 years.Kill most of my time on twitter.,0,0,1,0,1,300
1058222666971176960,DionDetterer,"PhD candidate in computational biology, with interest in epistasis, complex systems, machine learning and information theory.",0,0,1,0,1,300
47931441,nirmalthyagu,"Hi! I am a physicist working in complex systems. I tweet on my interests, books, papers and talks I liked and sometimes on my hobbies too!",0,0,2,0,2,231
1575165924,MikePablo_,PhD | modeling cell signaling | baking | he/him/his,0,0,1,0,1,64
2542875342,coreeff,"I think, therefore I am",1,0,0,0,1,279
37711745,jefgreen3,"Senior Lecturer in Applied Mathematics at the University of Adelaide. Enjoys sleeping, wine and mathematical biology.",0,0,1,0,1,300
2937555623,kevin_moroney88,,0,0,0,1,1,140
827235197645180929,TonTesch,,0,0,0,1,1,300
267838491,rebeccahoyle,"Loves hard sums, creativity, interdisciplinarity, yoga, sculpture, dancing, my two boys, sliding down sand dunes and laughing. Views my own not my employer's.",1,0,0,0,1,300
789835914830839810,sabina_haque14,PhD student @Harvard @HMS_SysBio & aspiring mathematician/theoretical biophysicist. @Middlebury '18.,1,0,0,0,1,300
423988609,FisVasori,"Física, facultad de ciencias (@fciencias),(@UNAM_MX).",0,0,0,1,1,139
1094985468461101056,christian_hurry,PhD student at @KingsCollegeLon. I'm modelling the immune response to cancer with statistical physics and complex systems approaches.,0,0,1,0,1,73
1139920944296628224,ShosukeYuu,"@BristolUni Maths and Philosophy student.

Interested in logic, complex systems, and categories

Cis | Gay | He/Him

Eng/中/粵/日本語少し",0,0,1,0,1,300
1128380818060083200,EmmaZajdela,"PhD student in applied math @NorthwesternU, NSF fellow @NSFGRFP. Passionate about #scidip #scipol #scicomm. Franco-American violinist & aspiring judoka 🥋",0,0,1,0,1,213
198326980,medelero,"Chilean Neuroscience PhD student working in attention and consciousness using EEG, iEEG, Eye-Tracker and fMRI.",0,0,1,1,2,300
2202035538,diziegel,physicist / neuroscientist interested in improving healthcare,0,1,0,0,1,55
909450383524642817,dannyjvoils,Computer engineer and software developer.,0,1,0,0,1,300
1002754575336595458,NayefAhmad4,"Doing data science-type stuff in Vancouver, BC. I'm an #rstats kinda guy. Here's me in a suit: https://t.co/TW1FZdwrgJ",0,0,1,0,1,300
203822182,montiniLab,Founder of https://t.co/zy41MU2tep / Intelligence Designer,1,0,0,0,1,300
1106554656610811905,JoseNegreteJr3,"PhD in physics of biological and complex systems, currently working as a postdoc @oateslab @ EPFL. He/his",0,0,2,0,2,300
265959548,shmget,I’m a multi-disciplinary problem solver in engineering and scientific computing.  Also ponder topics on science and Christianity. Views mine.,1,0,0,0,1,300
942532466866249728,CodeClassics,Brought to you by @AlexCBilimoria,0,0,2,0,2,300
171952596,karenedaniels,(she/hers) Natural Philosopher at @NCStatePhysics,0,0,1,0,1,300
115047324,0ffero,Software Architect at @GoWanderu,0,0,0,1,1,300
2699371362,josegalaz_,Papá. Mate-inge-nerd. Creador de https://t.co/G0SrlUplLP.  Dad. Math-engi-nerd. Creator of https://t.co/G0SrlUplLP,0,0,1,0,1,300
887818204298358784,ScienceGrtAgain,"👨‍🔬Science and its place in society. 

Emphasis on biotechnology, artificial intelligence and policy. 

🇫🇷🇬🇧🇯🇵",0,0,1,0,1,204
302492024,pClusella,"Doctor, però no dels que curen. Somiar, treballar, lluitar.",0,0,1,0,1,300
1092515663057510403,MathApplied,Opportunities and positions for applied math grad students and post-docs. #AppliedMathOpps for postings.,1,0,3,4,8,183
555110342,RifaldyFajar,Be mathematician and rsearcher - GoAbroad2019 #ManJaddaWaJada,0,0,0,1,1,300
809477971518095361,hansmriess,"PhD candidate @PennEngineers working in the intersection of complex networks, sheaves, and lattices. Advised by @robertghrist. Undergrad DukeU ‘16.",0,1,0,0,1,238
2865560428,catherin_naylor,Applied to the mastery of complex systems #automation #AM #Philosophy #highenergyphysics #metallurgyofsuperalloys RT’s ❌ 👍. Cat 🏳️‍🌈 Polymath,0,0,1,0,1,300
191030084,zemlyansky,"Full-stack developer. Working on @statsimcom 🎲Bayesian statistics, modeling, data analysis.",0,0,1,0,1,300
371048115,Judy_Reach,"Social Justice Educator, Researcher, MotherScholar. Opinions and views are my own.",1,0,0,0,1,300
973371523,anastasiabzv,@Princeton MAE PhD candidate & @nsfgrfp . @Cal physics alumna. Searching for beauty in ugly math. All views and reflections my own. She/her.,0,0,0,1,1,300
1907030478,Slav636,Active Directory MCM. I can tell #ADHorrorStory or two. Ex-Microsoft Security MVP. Identity guy. I solve problems with infrastructure.,0,0,1,0,1,300
305439873,Sim2Kul,von vorne beginnen,1,0,0,0,1,300
1070269195697426435,ebsaicbp2019,"12th EBSA and 10th ICBP-IUPAP Biophysics Congress. Madrid, Spain, July 20-24 2019.",0,3,0,0,3,226
763107778051313668,gamala05,"theoretically, ecologist; assistant professor @UCDavis",0,0,1,0,1,236
882964190096486400,DLBarack,"Philosopher and neuroscientist.
He/his/him. Type 1 diabetic.",0,0,1,0,1,300
578938846,krystoferivanov,,0,1,0,0,1,300
951116923084902400,dr_Royy,Assistant Professor #complexity #computationalscience #sustainabledevelopment #datascience,0,0,1,0,1,53
1049486971603537920,JimmyCh60659590,,0,0,1,0,1,300
984857755843481600,load_ing718,,0,0,2,1,3,300
1058691719175254016,scu_lab,"Twitter account of @lmescu lab at @unisevilla and @ibis_sevilla. Computational and Developmental Biology. Maths, Physics and of course... Drosophila. #scutoids",0,0,0,1,1,208
413184641,jcwalrath,"PhD physicist, now Engineer at Intel. Purdue and UMich alumna. Former member of APS Committee on the Status of Women in Physics. Tweets are my own. She/Her.",0,0,1,0,1,300
143475723,SvenLeyffer,I am a computational mathematician at Argonne National Laboratory working on large-scale nonlinear optimization.,1,0,0,0,1,300
1036680836685484033,cerocriaderosCR,Nuestro objetivo principal es desarrollar modelos matemáticos para ampliar aún más la toma de decisiones de los funcionarios de salud pública.,0,0,0,1,1,52
1001781811100487680,MathsNuig,"School of Mathematics, Statistics and Applied Mathematics, NUI Galway.",0,1,0,0,1,163
274656629,sfernando131,"Science, Technology and Society PhD student. Law & Tech. Collective knowledge and decision making. Complex Systems. Star Trek. Borgs.",1,1,0,1,3,300
401578287,BRamKram,"Applied Mathematician, Biophysicist, Postdoctoral Fellow, Department of Mathematics, University of Houston.  I am a tennis, basketball, and chess dork.",2,0,0,0,2,300
297787682,missseliss,"Essentially, all my models are right, but some are useful. | Current: @AU_Economics @CorePowerYoga | Former: #CSSS19 @NERA_Economics @UrbanInstitute @Cornell",0,1,0,0,1,300
4924635291,stateofsystem,,0,2,7,0,9,300
801158597162008580,monoyesencia,🐒,0,0,1,0,1,36
1003310101372002305,aroniskn,I am a cardiology fellow at the Johns Hopkins Hospital. Clinical interests: cardiac imaging and EP. Research interests: computational EP and complex systems.,0,0,1,0,1,103
876363777805082624,ysarjes,,0,0,3,0,3,15
20466744,rarufu,"Father. Husband. Physicist. Mathematician. PhD. MATLAB geek. Former data analyst, HiL and R2R test engineer. Now dev. engineer for automated/autonomous driving.",0,0,0,1,1,300
4013218217,ecmiindmath,The European Consortium for Mathematics in Industry (ECMI) is a  consortium of academic institutions and industrial companies that acts  co-operatively.,0,1,0,0,1,300
722001114992926720,shefmathbio,Twitter feed of the Mathematical Biology research group at the University of Sheffield.,0,0,1,0,1,300
893273972426457090,gordonvchavez,Health Economics & Analytics @novocure | Math+Stats+R,0,1,0,0,1,300
978668963008835584,roxana_zeraati,PhD candidate @Uni_Tue and @MPICybernetics | Interested in brain dynamics and self-organization | Promote #OpenScience | Love @DaalBand,0,0,1,1,2,300
1733486984,JeroenStruben,"Prof. @emlyon. Social & systems scientist researching market formation (eg sustainable mobility, nutritious food,...) & societal transformation.",0,0,2,0,2,300
47271413,sayangupta,"Professor of Applied Mechanics,
The Uncertainty Lab,
Indian Institute of Technology Madras",0,0,2,0,2,100
971865222318346240,TiagoMaths,Mathematician working on collective dynamics in complex networks,0,1,0,0,1,7
3864080902,DivergentData,returned peace corps volunteer 🇬🇳🇧🇫 full-stack systems biologist/ data scientist. 活到老学到老,0,0,2,0,2,300
1916122094,mmultiplier,,1,0,0,0,1,300
149029214,AlokVasudev,🐙,1,0,0,0,1,300
965564963673792512,mpiMathSci,"The Max Planck Institute for Mathematics in the Sciences. Carrying out research at the interface between maths and the sciences, since 1996.
RT \neq Endorsement",1,1,1,0,3,300
17840902,tomfid,,1,0,1,0,2,300
948328837938589703,chaaosbook,"Theoretical physicist. This is for science only
Please post your politics -if you must- on a separate account, like my human namesake  @PredragCvitano1",0,0,1,0,1,300
22104455,colemanb,PhD student at @mpicbg. Interested in bioimage analysis and developmental biology.,0,0,1,0,1,126
338976512,MeKakaoFilippao,"Young Computer enthusiast.Interests:Reversing as a NEWBIE.Living for malware removal,football.Reading articles.",0,0,1,0,1,300
1563872216,colehturner,fallible,0,1,0,0,1,120
316518255,mbi_osu,"The Mathematical Biosciences Institute offers a vigorous program of research and education, and fosters the growth of an international community of researchers.",1,0,0,0,1,300
2444608582,agt525,Math & Physics undergrad. Interested in mathematical/physical oncology and computational biology.,0,0,1,0,1,300
2419233360,Hamlet1776,,0,0,1,0,1,300
3254326953,victoriapb1,"Postdoctoral researcher @sysbiomed  Interested in multiscale models of biological processes, connecting models to data",1,0,1,0,2,300
814528892299976705,iSystimata,[ Sociological Perspective; Complex Systems; Modelling & Analysis ] Idein: @0b100010000,1,0,0,0,1,17
477906156,appliedivan,"I enjoy traveling, nature, science, history, languages and people. In the meantime, I do Mathematics.",1,0,0,0,1,300
2427263774,neillinscheid,,0,0,1,0,1,78
2405048743,physics_brain,Physical models of the Brain,0,0,9,0,9,300
1336653415,sanjayk_13,planting seeds,0,0,1,0,1,300
211834516,TonyPershin,"Postgraduate researcher at the University of Leeds. Transition, turbulence, chaos, patterns and dynamical systems span my space.",0,1,1,0,2,300
882394172082102273,SMB2018,"Twitter account for the 2018 Annual Society of Mathematical Biology meeting in Sydney, Australia, July 8-12. Instagram: @smb2018sydney,",0,0,1,0,1,223
301285594,JuanPiCarbajal,Physicist. Researcher at HSR & EAWAG. Open Scientist,0,0,1,0,1,300
808174022,jos4001999,,0,1,0,1,2,300
1017083936,dippintippin,,0,1,2,0,3,97
785851877690867712,jamie_a_dean,"Postdoc with Franziska Michor @DanaFarber, @HSCRB and @HarvardChanSPH doing #radonc, #mathonco and #machinelearning research. Tweets my opinion.",0,0,1,0,1,300
45180093,theoreticalwzrd,Physicist with depression | active matter/nonlinear dynamics | Diversity & Mental health in Sci advocate | BUPhy alum | Cosplayer | Gamer | She/her | 💖 💜 💙,0,0,1,0,1,300
834032047190601729,ComplexMentis,,0,2,2,5,9,157
760550561116815360,drmrkellyjr,"Assistant Professor of Mathematics at Transylvania University. Interests: Mathematical biology and optimization, coffee, travel, beer, running, and my dogs.",0,0,1,0,1,300
67618264,cwkulp,"Professor of physics and perpetual student of physics, nonlinear dynamics, complex systems, machine learning, and guitar.",0,0,5,0,5,300
2295073622,SamuZambrano,"Somewhere between Physics and Biology @MyUniSR . Trying hard not to tweet about everything (but -just in case- views are my own). In ENG, SPA, ITA. 🇪🇺!",0,0,0,2,2,300
778648070057754624,OyarzabalSovek,,0,0,1,0,1,253
3917254580,M_Curatolo1991,,0,0,1,0,1,71
303350008,jfpas,Mathematical-Physicist focused on #RELATIVITY and #COSMOLOGY. Físico-Matemático especializado en #RELATIVIDAD y #COSMOLOGÍA.,0,0,1,0,1,300
39223556,johnmdudley,"Physicist. Nonlinearity, optics, lasers, extremes, outreach, SciComm, Past President of European Physical Society, Hon IUFrance, Hon FRSNZ See also @IDLofficial",0,0,1,0,1,300
771349841557553152,Otero_Muras,Working on math/computational approaches to help understanding & de-novo design biological networks. #computationalbiology #Synbio #CRNT #celldecisionmaking,0,0,0,1,1,300
768554370392875008,Chri_Pristipino,Interventional cardiologist - Founder and Past-President of the Italian Association for Systems Medicine & Healthcare (ASSIMSS).  Opinions are only my own.,0,0,0,1,1,300
2788372879,YoungModeler,"Sharing stories about system dynamics, agents' behavior and other modeling curiosities",0,1,0,0,1,300
749615394810363909,UAntwerpMathCS,"Everything related to Math and Computer Science that is interesting to the community at Mathematics and Computer Science Department  Uni. Antwerpen, Belgium",0,0,1,0,1,58
3043420364,ictstifr,"ICTS is a multi- & inter-disciplinary effort with a mandate to take new initiatives on the frontiers of science, & catalyze & promote collaboration in research.",0,0,1,0,1,241
2887741977,k_efstathiou,"Associate Professor of Mathematics, Duke Kunshan University",0,1,0,0,1,130
4157479522,SIAM_NUIGalway,"NUI Galway SIAM Student Chapter - news, events & general mathematical interest. Based @nuigalway. Managed by @RobertoGalizia",0,1,0,0,1,300
61693730,DiscreteMathBio,"Applied Mathematician. Interested in Systems Biology and Bioinformatics. Developing computational tools for modeling, simulation, and control of GRNs.",0,0,0,1,1,300
348522881,ima_umn,The Institute for Mathematics and its Applications was founded in 1982 and is among the most influential math institutes in the world.,0,0,0,1,1,300
359851815,IelyaasCloete,,1,0,0,0,1,300
582291300,petpii,Applied mathematician and mathematical modeller at @nuigalway with an interest in dynamics.,0,1,0,1,2,63
427295058,chaoxity,Less than the sum of my parts (it's complex).,0,0,0,1,1,300
408465162,nanevetes,Physicist and shower singer. Currently working as Postdoctoral researcher at @WWU_Muenster,0,0,1,0,1,300
1568033816,launknaacs,a verbal geek with pseudorandom tweets,1,0,0,0,1,300
15845100,fygibson,,0,0,1,0,1,300
10665822,kalcifer,"Investigador en Matemática Aplicada, “Our perception of the amount of knowledge we have is inversely proportional to the amount of knowledge we have.”",1,0,0,0,1,300
543254470,Muhannad_kha,Curious,0,0,1,0,1,300
2417170736,Alliterativity,"Mathematician and modeller.  Married, mother of a musician and a mathematics student, mess-tolerant, manufacturer of material things. Enjoys mountains and music",0,0,1,0,1,80
263020833,BerkeleyISchool,"The UC Berkeley School of Information is a multi-disciplinary program devoted to enhancing the accessibility, usability, credibility & security of information.",0,0,0,1,1,300
1053264590983872512,SaraASolla,"Professor, Northwestern University",0,0,1,0,1,300
3091462907,gran_stat_mech,"pattern formation, minimal music, granular matter, meditation, X-ray tomography, machine learning, smart home,  ...",0,0,1,0,1,300
4819593028,omiddor,"Postdoc @UniofOxford & @ETH interested in Porous Media, Fault Mechanics, Friction, Machine Learning & Fluid Dynamics. Own views, like/retweet no endorsement.",0,0,1,1,2,192
1648277749,GSWarrington,"Math Prof at U. Vermont. In parallel universes I am an astronomer, a photographer and a juggler.",0,0,1,0,1,300
795096464,aklamun,"PhD student @Cornell, applied math. I work on complex systems, including #stablecoin/#DeFi design and network cascades.",0,0,2,0,2,300
1083402468485197831,GissellEstrada5,,0,1,0,0,1,1
960092029236596736,ANZIAMnews,"Latest news from ANZIAM (Australia and NZ Industrial and Applied Mathematics), a Division of @AustMS. | Typos by @nomad_penguin. Co-conspirator: @haydenmaths.",0,0,1,0,1,300
2776033835,MathsCU,"The School of Mathematics at @cardiffuni. Tweeting about news, research, activities, events and more.",1,0,0,0,1,300
1206076800,MegganCraft,"U of MN Ecosystem Health Assistant Professor. Disease ecologist, world traveler, and aspiring runner.",1,0,0,0,1,97
311052101,Trends_Ecol_Evo,"TREE publishes polished, concise, readable reviews in all areas of ecology & evolutionary biology. Tweets by the editor, Andrea Stephens",1,0,0,0,1,300
135043302,SciencePapers,New Nonlinear Sciences submissions to https://t.co/HHqPequzVU (not affiliated with https://t.co/HHqPequzVU),0,1,1,0,2,300
839543244153212928,SarahLizHarvey,"Physics PhD candidate @Stanford, theoretical statistical physics, biological computation. @UW alumna.",0,1,1,0,2,241
521906763,ErikaChristakis,"Author of NYT bestseller, The Importance of Being Little (Viking). Early childhood educator.",2,0,0,0,2,300
154407102,NigelGoldenfeld,Interested in everything.  I tweet here about science. This does not mean I like today's US political situation nor that I do not express my opinions elsewhere.,1,0,0,0,1,300
748740431635095553,MathFeed,"New! Math news aggregator: newspapers, blogs, videos, Amer. Math. Monthly, more. Get free iPhone/iPad app for more features. By Francis Su @mathyawp",1,0,0,0,1,300
17797390,5harad,"Professor at @Stanford and Director of @CompPolicyLab, where we use data + tech to drive reform in criminal justice, education, voting rights, and beyond.",1,0,0,0,1,291
3433220662,Anthony_Bonato,Mathematician at Ryerson U. Researcher on complex networks and network science. SFF writer. Represented by @thejordache. The G in LGBTQI2S & the v in vegan.,0,1,0,1,2,300
564930438,BIRS_Math,"The Banff International Research Station for Mathematical Innovation and Discovery, in the heart of the Canadian Rocky Mountains.",1,0,1,0,2,300
29356679,dbasanta,Math modeller | @MoffittResearch | @MathOnco | Cancer ecology & evolution | @mathoncoblog | Grand Vizier @ScientistsInc | @tasteofsci | @2Scis,1,0,0,0,1,300
41689599,robalsaca,"Math, biology, and a pinch of salt.",0,0,3,0,3,300
36843988,TEDNews,News from #TED and its global community of passionate thinkers. Follow @TEDTalks for daily talks and ideas.,1,0,0,0,1,300
47616319,avklopper,Senior Editor at Nature Physics,0,0,0,1,1,90
1277969868,mathDSb,Unofficial bot by @vela w/ altered @sho_iwamoto's code. @mathAGb @mathAPb @mathATb @mathCAbot @mathCObot @mathCTbot @mathCVb @mathDGb @mathDSb @mathFAbot ...,0,0,1,0,1,300
1122863389,AppliedMathCR,The Applied Math Institute of Costa Rica is designed to provide a successful university-like experience for students who are interested in mathematics.,1,0,0,0,1,186
44169290,moiazjiwani,Aggregating my interests and thoughts.,0,0,1,0,1,300
300395549,HarDLR,On my way,0,1,1,1,3,300
245388976,sean_a_mcclure,"Founder Kedion, Ph.D. Computational Chem, builds AI software, studies complexity.",0,0,1,0,1,300
808015576769642496,datarequena,PhD student #bioinformatics #rarediseases @InstitutImagine,0,0,0,1,1,223
563311832,szarnyasg,Research fellow. Benchmark task force lead at @LDBCouncil,1,0,0,1,2,132
1418434280,cristacedo,"Anthropologist, Economist and PhD in Cognition and Human Evolution, Scientist of evolution of human sociality, trust and cooperation in groups and cultures.",0,0,0,1,1,300
463919906,eraser_T,Tesis de mis días.,1,0,0,0,1,300
2202925394,pablojensenlyon,"Chercheur CNRS, physique et réseaux sociaux",0,0,2,0,2,300
838051974,DybleMark,"Anthropology +/- evolutionary biology
Lecturer at UCL Anthropology",1,0,0,0,1,179
834715022467162112,LeeKoren2,"Zoologist, hyraxologist, single academic mama, PI @BarIlanU. Studying wildlife hormones and behavioral ecology",3,0,0,0,3,300
1179763649134465026,NanaTAKA15,PhD student in biopsychology / ethology 社会行動/コミニュケーションでの受信者の役割やふるまいに興味があります,1,0,0,0,1,209
2605920368,alnus_verdi,🦍♥️🌍,1,0,0,0,1,300
814958290388008961,_straussed,"Behavioral ecology, social hierarchies, social network analysis. Population Biology Program of Excellence Postdoctoral Fellow at University of Nebraska-Lincoln",2,0,0,0,2,189
2884862075,GraceHDavis,"PhD candidate Evolutionary Anthropology UC Davis. Collective behavior and ecology in wild primates. Decision-making, leadership, group movement, social networks",4,0,0,0,4,300
824289477069828096,WanderingBiol,"Biologist interested in animal social behavior, personality, and conservation. Frequent nomad. Currently a postdoc at MUN with @wildlifeevoeco
She/her",2,0,0,0,2,215
1187267635379134465,UoR_MbyResEEB,"MSc by Research in Ecology, Evolution & Behaviour 
@UoR_LifeScience @RoehamptonUni
Instagram: uor_mbyreseeb",2,0,0,0,2,206
1232700832434606080,suncatx,"on a mission to make a difference
pending msci zoology @bristoluni
amateur photo/videographer currently into social networks+ decision making+ vision+ sound",2,0,0,0,2,269
50996858,AMCELL,"Reader (Assoc Prof), Animal Behaviour. Research: animal behaviour, welfare. Tweets: animals, environment, science, higher ed, equality, politics. 🌈🇮🇪 he/him",1,0,0,0,1,300
1065691708980105217,BenhaiemSarah,Behavioural Ecologist @IZWBerlin studying spotted hyenas in the #SerengetiNationalPark for 11 years - into black coffee and all fluffy 🐰🐹🐯🐨🐴🐺,2,0,0,0,2,130
910116050502606850,JMorandFerron,"Associate Professor and University Research Chair in Cognitive Ecology, Department of Biology, University of Ottawa",1,0,0,0,1,300
3246918568,mathildpoyet,co-founder Global Microbiome Conservancy @globalmicrobiom | postdoc in @ejalm's lab at @MIT | microbial ecology and evolution,1,0,0,0,1,300
1093353697986236416,mattinamarie,"PhD Cand. | UC Berkeley | life history trade-offs, brains, endo, & repro physiology. often chasing after birds, bats, and scenes for rad photographs. she | her",1,0,0,0,1,300
2950222006,softropbio,,1,0,0,0,1,74
773847744826007552,JoshJArbon,"PhD student at @UoExeterCEC with @cornishjackdaws | Social learning, networks and cognition",1,0,0,0,1,300
2872614250,gracellison,PhD Student researching the behaviour and ecology of Galago senegalensis 🐒,1,0,0,0,1,300
893433700700106752,SmuldersLab,The Smulders Lab at Newcastle University (UK) studies how evolution changes brains.,1,0,0,0,1,300
1006801362930237440,LjerkaOstojic,Exp. Psychologist at Interdisciplinary Research Group - Contemporary Issues in (Animal) Behavioural Science @IGDORE. Previously found working with jays. she/her,1,0,0,0,1,300
4417323807,biologging,The official twitter account for the International Bio-Logging Society. Follow us for society news and updates on the International Bio-Logging Symposium!,1,0,0,0,1,300
2377379185,AdriMaldoC,,3,0,0,0,3,300
765149946597158912,laurenrpeel,Project Leader for the Save Our Seas Foundation and Manta Trust's Seychelles Manta Ray Project,1,0,0,0,1,300
1199666099144445953,Cameron_J_Baker,"Movement and behavioural ecologist, wildlife photographer. PhD candidate @UQ examining crocodylian sociality",1,0,0,0,1,39
323307096,ursurs,Primate Behavioural Ecologist & Biological Anthropologist. Blog: https://t.co/mTyVk95Bnw,2,0,0,0,2,89
954037191667314688,JaimeMuriel82,Avian ecophysiologist. Post-doc at the Pyrenean Institute of Ecology (CSIC) @IPE_CSIC,1,0,0,0,1,300
869324559903842306,EthanHermer,"Studying cognitive ecology at UOttawa. Studying musical things at home. Views are my own, or are stolen from others whom I agree with on some things. He/him.",1,0,0,0,1,300
209579868,brilsly,Animal welfare science type. https://t.co/kYp6JWdOv4,1,0,0,0,1,300
1189549181792407558,jettebonoan,MSc Biology student @Concordia (@biologyatCU). Studying the social network of female reindeer. Reindeer are cool 🦌.,1,0,0,0,1,30
2442506964,frantsjensen,"Marine Biologist and acoustician at @whoi; PhD @ Aarhus Uni, Post Doc @ WHOI and @ Princeton EEB; fascinated by the ocean and all life therein",0,0,1,1,2,300
3272124758,rony_speaks,Graduate Student @CornellNBB studying speciation in Hawaiian Crickets; @iiserkol alumni; he/him/his; 🇮🇳 in 🇺🇸,1,0,0,0,1,191
3005981389,krissubramaniam,"Postdoc @UCDavis with interests in behavioral ecology, primate social evolution and health, and human-wildlife interactions",5,0,0,0,5,250
779271176891826176,DFG_SoHaPi,"Investigating effects of sociality on health in primates 🐒🔬👾
#Primates #Health #Lemurs #Chimpanzees #Macaques
#Endocrinology #Parasites #Microbiomes",2,0,0,0,2,300
823983228432355328,chamaillejammes,"Ecologist @CNRS; Linking movement, distribution and abundance of animals, particularly large herbivores, for science and conservation. Tweets my own.",1,0,0,0,1,300
903328628884217856,tncvidya,"Assoc. Prof. at JNCASR, Bengaluru. Study animal behaviour, especially socioecology of Asian elephants in Kabini, and phylogeography and evolution.",1,0,0,0,1,258
61408211,LucyRansome,"PhD Candidate (Behavioural Ecology) @GriffithUniversity & @NatGeoExplorers. African wild dogs: collective decisions, leadership, social networks, #Tech4Wildlife",2,0,0,0,2,176
2267645766,arpeggio_jay,"PhD student in @RobinMTing's lab • Rapid evolution, bioacoustics, behavior, sexual selection • Audio engineer and cellist • Co-founder of @AceFanTennis",1,0,0,0,1,300
64055098,travishughes,MD-PhD Student @harvardmed @mit. Single-Cell Sequencing. Immunology. Infectious Disease. Harvard Immunology PhD.,1,0,0,0,1,300
952595943383359490,AnaC_RGomes,"PhD student at CIBIO/InBio, UPorto. Understanding how phenotypes influence social behaviour and mate choice in the common waxbill.",1,0,0,0,1,122
1179666145755840512,sruthi_kon,"Post-doctoral fellow, Behavioural Ecologist, Studies Wasps and Asian honey bees, Music lover, Book worm, Unrealist",2,0,0,0,2,67
1869245306,AllisonMRoth1,Postdoc @UF | Behavioral Ecology | Ornithology | Animal Personality | Social Networks | Sexual Selection | Disease Ecology | PhD from @UniofOxford,1,0,0,0,1,60
1069907880441192448,JaeggiAdrian,"Behavioral ecology, evolutionary anthropology, evolutionary medicine and public health. Assistant professor at University of Zurich",1,0,0,0,1,300
917211276,LynneUSneddon,Scientist specialising in aquatic animal biology and fish welfare. Views and opinions are entirely my own and have nothing to do with my employer.,1,0,0,0,1,300
4751181176,LauraKateLopez,"Postdoc at #UMich. Ecologist interested in #behaviour, #predators and #disease in aquatic systems. Feline fanatic 🐈 proud Hufflepuff 🦡 She/her 🇦🇺 🇪🇸",1,0,0,0,1,300
64035862,mikebergerson,Mental Bodybuilder/Science Hobbyist/Part-time Caregiver/Very Stable Genius,1,0,0,1,2,300
1062874223566249984,dr_rymer,"Animal Behaviourist, Mouse Lover, Budding Marine Snail Enthusiast, Learning about Spider Behaviour, Researcher and Lecturer",1,0,0,0,1,300
1107569019861770240,fred_mery,"evolutionary biologist, behavior, evolution of social interaction,  drosophila, street art, art and science interaction,",1,0,0,0,1,300
1098911568681725952,Julie_M_Kern,"@UniNewEngland PDRF. Behavioural Ecologist. Communication, cooperation and conservation. Feathers and furries. Co-founder @Dwarf_Mongoose project 🐻.",2,0,0,0,2,166
2883415632,Vlad_Demartsev,"Behavioural ecologist #AnimalBehavior #AcousticCommunication #Bioacoustics 
Post-doc @unikonstanz, Germany",1,0,0,0,1,40
1165252919328985094,GoldsboroughZoe,Researcher of animal behaviour and welfare / Research Assistant @UtrechtUni / Always curious to learn more. She/her,1,0,0,0,1,24
961670219667263488,CaitlinKarniski,Associate Editor @commsbio 📑 | PhD @sb_dolphins 🐬| Double Hoya @georgetown | she/her | Views mine and/or my dog Bert’s 🐶,1,0,0,0,1,300
1007536748723888128,ndlilie,"PhD candidate @unibielefeld and @NC3Niche studying social niche conformance. Interested in behavioural ecology, sociality & evolution.
🐦 & 🐒",2,0,0,0,2,37
3279086118,aninditaces,"Postdoctoral researcher in Evolutionary Biology at Queen Mary University of London.
Interested in science policy and science communication.",1,0,0,0,1,300
2169930518,CREEBroehampton,"CENTRE for RESEARCH in ECOLOGY, EVOLUTION and BEHAVIOUR (CREEB), UNIVERSITY of ROEHAMPTON",1,0,0,0,1,300
1908157021,EllisJGLangley,Postdoc @univofstandrews. Cognition & tool-use in the critically endangered ‘alala. Previous PECer 🐥 @pec_exeter.,1,0,0,0,1,300
899931006668591104,elodiebriefer,"Associate Professor in vertebrate social behaviour @behaveco, @uni_copenhagen. Research: animal behaviour, vocal communication, emotions, cognition and welfare.",3,0,0,0,3,300
735838082637914112,Helen_Gray_,"Postdoc in @asherblab, Newcastle University. Tweets about animal welfare, behaviour, running. All views my own.",1,0,0,0,1,300
978706420999876608,Katja_Rudolph88,Behavioural ecologist working on the link of sociality and health (https://t.co/DSwdniFAeC) @DFG_SoHaPi #Primates  #Sociality #Sifaka,2,0,0,0,2,244
1111912209301622784,holly_howls,"Animal behaviour researcher, baker of cakes, and reader of books, also I howl at wolves and sometimes get replies",1,0,0,0,1,107
801852788,pri_mo_tologist,"Post-doc researcher studying chimpanzee behavior, demography, & conservation w/ camera traps & genetic monitoring. 🐵 she/her",3,0,0,0,3,300
3427820495,crstanley_rsrch,Senior Lecturer in Animal Behaviour & Welfare at University of Chester. Behavioural ecologist & social network analysis enthusiast,4,0,0,0,4,300
1129848326193635328,SchoofLab,Asst prof @YorkUniversity @GlendonCampus. Primate behavioural endocrinology. Co-manager Nabugabo Research Site. PI Community Nkima Project. She/her.,3,0,0,0,3,300
1092255319,CarlWoods25,Senior Research Fellow in Skill Acquisition @iHealthSportVU | Skill Acquisition Scientist @PAFC | Ecological dynamics and practice design in sport,0,1,1,0,2,300
1114784280293588998,APELAB2,The Antwerp Primate Ethology and Evolution Lab @Uantwerpen BECO and Centre for Research and Conservation @ZOOscience_eng @ZOOscience_be,1,0,0,0,1,37
3034532994,naturalist_chj,"PhD student @UofAEEB.Study collective behavior in ants. Passionate about science in general and spreading word about it.IISER-TVM(@tvmiiser) alumni 🇮🇳 
He/him",1,0,0,0,1,300
942240958921498625,KeynanOded,"Behavioral ecologist, Dead Sea & Arava Science Center. Science education center in the central Arava region. Arabian babblers research project.",1,0,0,0,1,118
1050227943656574976,OrrSpiegel,"Behavioral ecologist, #MovementEcology, individual variation, social networks.",2,0,0,0,2,300
923658317813174273,Walters_Lab,The lab of Eric L. Walters at Old Dominion University. Our research group has studied cooperatively breeding acorn woodpeckers for 50+ years at Hastings Reserve,2,0,0,0,2,300
2929171994,The_robins_hood,Doc Robins giving you the low down on all the latest toutouwai scandal (and science),1,0,0,0,1,172
814252688,ConnerPhilson,"PhD student @UCLA with @TeamMarmot. Interested in the evolution of sociality, behavioral ecology, and science policy",1,0,0,0,1,300
924315400531337217,SuaqOrangutans,"Location jungle episode @ourplanet.
Help us save one of the last remaining populations of wild Sumatran Orangutans! Facebook: SUAQ",1,0,0,0,1,300
117908387,gabrielsotalia,"Postdoc Research Fellow at @_SMRU_, University of St Andrews, UK, studying Amazonian dolphins sounds, behavior and ecology + amateur artist + geeky",1,0,0,0,1,300
2803862462,lmartinezinigo,Primatologist. Working on intergroup relationships in primates. Wanderer and wonderer. Mujer inconveniente y ave fénix,2,0,0,0,2,300
635381653,TurnerDizzy,"Curious by nature, lifetime thinker. Evolution beyond the apex.Brain,mind,language🎵& complex systems.🙌A positive perspective, quality of life caregiver.🌱🗺🌳",2,0,3,0,5,257
800661896953151488,jorgiane_parish,PhD candidate @UniofAdelaide @waiteresearch studying the interactions between #honeybees and fungal spores.,0,0,1,0,1,121
908264247347597312,Cha_Defolie,"Behavioral ecologist, investigating #sociality #stress #health #fitness in #primates + other mammals / travel & food-lover / happy mom*2 / @primatweeps team",1,0,0,0,1,300
2570449356,RoosKentie,Researcher at @IBED_UvA and @NIOZnieuws. Studying how changes at North Sea impact gull populations.,1,0,0,0,1,300
337183206,zhgarfield,Evolutionary anthropologist. Research fellow @IASToulouse. I study how individual behavior and group dynamics interact in the context of cultural transitions.,1,0,0,0,1,300
2846161344,anthroyogi4,"biocultural anthropology, mixed methods, food-medicine-drugs",1,0,0,0,1,300
1087473296059248640,ConservBehavior,Animal Behavior Society Conservation Committee- Promoting conservation behavior research and researchers,2,0,0,0,2,300
2941722843,pizzaky,"Postdoc Research Fellow 

Interested in cognition & behaviour, comparative cognition, innovation, intelligence, philosophy, squirrel lang.🐿️",1,0,0,0,1,272
1032476094094442496,TheOVEN_Foote,Jennifer Foote's lab at Algoma University (@algomau),1,0,0,0,1,246
65726968,MadisonMiketa,"Wildlife biologist // Animal behavior, welfare & conservation // PhD on dolphin behavioral ecology @sb_dolphins @Georgetown // #EverTrue to @BrownUniversity",2,0,0,0,2,300
4926409928,AnimBehSociety,We promote and advance the scientific study of animal behavior and publish the journal Animal Behaviour. Website: https://t.co/vnKSS0aXJh.,2,0,0,0,2,300
2764741506,SnellRoodLab,"Butterflies, brains, and behavioral ecology at U. Minnesota. Tweeting about lab news, plasticity and cool bugs!",1,0,0,0,1,300
9180262,janbenetka,"Living in Melbourne. Finishing PhD in data science. Cycling, drinking coffee and reading maps in nature. | Intern @ Microsoft Research, USA | PhD @ NTNU, Norway",1,0,0,0,1,273
422892484,14Katie41,Former PhD student at @cardiffuni studying coral reef cleaner fish behaviour |MSc Animal Behaviour with @crabexeter & BSc Marine Biology (Plymouth University),1,0,0,0,1,300
826472252262739968,marca_poirier,PhD student using 🦗 to explore the evolutionary causes and consequences of cognition and behaviour w/@JMorandFerron. Previously bighorn sheep 🐏 Ram Mountain,1,0,0,0,1,242
44373964,rachana_bhave,PhD student @uvabio | Sexual selection | Quantitative Genetics | Behavioural ecology| Lizards | 🐱 obsessed | Alum - @IISERPune @CES_IISc,2,0,0,0,2,269
887284087542689792,laleaver1,"Behavioural ecologist @UniofExeter, studying cognitive and behavioural adaptive specialisations in squirrels",1,0,0,0,1,300
751707568871878657,ravindra_pn,"Postdoc @FIU || Alum @MQBiology, @IISERPune || Multimedia editor @animalecology blog || #scicomm #insectVision #neuroethology https://t.co/iFrDoHsLAJ",0,0,1,0,1,300
989068863177359362,Icarus98378742,"Anthropology, complex systems, cognitive science",0,0,1,0,1,230
554479229,KarinKjernsmo,"Evolutionary and Behavioural Ecologist, researching #colsci in the @Camo_Lab at Uni. of Bristol",1,0,0,0,1,300
263476810,JA_Iturrizaga,Behavioral ecologist // PhD Student @ the Parker Lab (#UMSL) // Conservationist // Neotropics,1,0,0,0,1,300
2815708629,giumasoero,"#PhDstudent @UniTurku, working on population dynamics + behavioural ecology of pygmy #owls 🦉
Ecologist, ornithologist, traveller",1,0,0,0,1,300
263421212,morceglo,Behavioral ecologist and bat biologist interested in social behavior,2,0,0,0,2,300
1040224111723732994,ButtozCedric,Social cognition and cooperation in chimpanzee and bonobos. Post-doc at the MPI for Evolutionary Anthropology. Dpt of Primatology.,1,0,0,0,1,204
1034987805934608389,JessicaCusick1,Postdoc @IndianaUniv ~ PhD @floridastate ~ behavioral ecologist ~ dolphins~fish~birds~hamsters~ cooperation / aggression / personality / stress / gut microbiome,1,0,0,0,1,269
935810509164699648,CervelleOiseau,"Cervelle d'Oiseau est la chaîne de vulgarisation scientifique de Sébastien Moro, orientée sur l'éthologie. https://t.co/riUBFfZNyH",1,0,0,0,1,300
722709051956727809,AMGBarreaux,"Vector biology, ecology & evolution, modeling, maternal investments, host-parasite interactions, vector control: tsetse flies & mosquitoes; AAT, HAT and malaria",1,0,0,0,1,300
1026404288564736000,SG_PighD,"P(ig)hD. Animal behaviour and welfare; Interested in social behaviour, social bonds.",1,0,1,0,2,300
720141566841602048,Miquel_TT,"PhD student. Spotted #hyena researcher @GCCGtweet, @DENVI_HU @HELSINKISUS, @helsinkiuni | @insideNatGeo | @HyaenaSG | #Conservation & #HumanWildlifeConflict",1,0,0,0,1,300
1290000733,DavidWLawson,"Assistant Prof & Anthropologist @ UC Santa Barbara🌴✌🏼☀️ Interests: Behavioral Ecology, Parental Care, Marriage, Childhood, Global Health, Tanzania",1,0,0,0,1,300
52119917,GlanceScience,"Explorer of animal behaviour; ecology, physiology and evolution. Chicken fancier",1,0,0,0,1,300
1018032846567452672,AlexisLevengood,PhD student at the University of the Sunshine Coast | Collab with @sb_dolphins | Interested in the ecology and evolution of social behavior,1,0,0,0,1,229
348757029,mrmic1,"Behaviour, Evolution & Invasion Ecology, R enthusiast. Postdoc in the Sih Lab at @UCDavis",1,0,0,0,1,300
890347520928481281,platformpapi,ecology & technology,0,0,1,0,1,300
1600631118,biologyFran,"Assoc Prof at QueensU. Biologist, mom, amateur equestrian. Behavior, physiology, life history, evolution, ecology, etc, usually in birds & beetles.",1,0,0,0,1,300
913087533554307072,trhaaland,PostDoc in the @kokkonutter lab. I build evolutionary models and then try to understand them.,1,0,0,0,1,300
827235590454308867,wildlifeevoeco,"Vander Wal lab studying the interface between Behavioural Ecology, Population Ecology, and Evolutionary Biology at MUN. Tweets by @ecolojack and @PQPTurtles",3,0,0,0,3,300
15639362,DrAnneWinters,"Evolutionary & behavioral ecologist interested in #colsci, aposematic warning signals, and chemical defenses. Postdoc at the University of Jyväskylä.",1,0,0,0,1,300
45339158,mariannedhk,Linguist in AI & CogSci 🧠👩‍💻🤷‍♀️🤷‍♀️🤷‍♀️  MSc student @UvA_Amsterdam,1,0,0,0,1,300
625025342,SeanPCoyne,"Comparative Human Development, Ph.D. Assistant Professor of Psychology, @NotreDameofMD. Study biopsychology: sexual maturity, risky behavior, decision making",1,0,0,0,1,300
152019415,ishmajl,Trying to understand Social Cognition by building Cognitive Architectures. PhD student @SPECS_lab,1,0,1,0,2,300
2990049500,Nidoranking,,2,0,0,0,2,300
3025477949,Will_0_Tree,Masters by Research with @CRABExeter studying cooperative social strategies in rhesus macaques.,3,0,0,0,3,300
2204143046,erin_sira,Postdoc @UniofExeter studying social behaviour & aging. Previously w @KluaneSquirrels. Outdoor enthusiast | #scicomm | creative writing. Views my own. She/her,1,0,0,0,1,300
951489667354021893,j_welklin,My running is often interrupted by birds and frogs. I spend most of my time on @FairywrenProj. Editor at @ScienceOutside.,1,0,0,0,1,126
902320559152918530,JChartove,"BU PhD student, theoretical neuroscience. Applications of bifurcation theory and Fourier analysis to quantitative systems pharmacology and biometric data.",0,1,0,1,2,248
2821205806,BehavEcol,Behavioral Ecology is the official journal of the International Society for Behavioral Ecology (ISBE) #behavecol #BehavEcol2020 @isbe2020 tweets by @KateUmbers,5,0,0,0,5,300
863076634823458816,Kybernesia,Kybernesia is an innovation consultancy for biomimetic systems and knowledge engineering. Constraining and Navigating the Hyperspace of Technological Potential.,1,0,0,0,1,300
745204531793797120,Dr_Tetulness,"Insect sensory biologist and problem solver. Arthropods, ions, brains, biomes. Improv, theatre, poems, dance.",1,0,0,0,1,300
3077762153,KMonceau,"Lecturer - MCf, La Rochelle Université & Centre d'Etudes Biologiques de Chizé (CEBC)",1,0,0,0,1,300
3331627803,sanjaya775,🦑,1,0,0,0,1,187
2204778019,IsabelleWinder,"Lecturer in Evolutionary Anthropology @BangorBioZoo. I like primates, evolution and anatomy. Tweets my own views. Also @BangorPrimates @BangorHEAS",1,0,0,0,1,300
3527239401,AlexHutfluss,"PhD student, studying within- and between-individual differences and behavioural stability in birds at the MPI for Ornithology/LMU Munich.",1,0,0,0,1,57
927247249679241216,ronniecowl,Dr. @ScienceatCZ @EAZA_RMG Reproductive Biology Coordinator 🐒 working on reproductive management in conservation  breeding with a passion for primate sociality,3,0,0,0,3,145
4096413075,LaGala_Silvia,"Natural scientist specialized in ecology and ethology. 
Areas of interest in primate behaviour, conservation and cognitive science.",1,0,0,0,1,21
796380767173505024,ChristinaHWheat,Dinosaur behaviour. Dog domestication. Postdoc @CollectiveBehav & LundUni. Canid/craft beer/Led Zeppelin enthusiast. Wolf mother & occasional butterfly catcher,1,0,0,0,1,300
905331808857972737,Ecamerlenghi,"Evolutionary Biologist-Ecologist, Phd student at Monash University, current focus on animal societies, mixed species groups and social networks.",1,0,0,0,1,65
3314256564,eva_ringler,,1,0,0,0,1,300
4927917609,fedurekp,Interested in animal communication. Lecturer in Psychology at the University of Stirling.,1,0,0,0,1,112
2568732936,StephenLang_,Studies how predators hunt prey | Postdoc working on 🐧 foraging behaviour @AngliaRuskin | PhD @CollectiveBehav & @UniKonstanz,1,0,0,0,1,75
845394555646160896,PrimateOnTheMov,"Senior Lecturer @uop_psychology, Marie Curie alumna. Interested in #ComparativeCognition, #Primates. One of @ManyPrimates. #FirstGen. #Academicmum. She/her",3,0,1,0,4,300
1192074421,ColumboAhmed,Mr. @Zyanwang / Postdoc at @princetonNeuro in @MurthyLab / Founded @CTORadio / Plays a little guitar / PM tweets v diff from AM tweets,1,0,0,0,1,300
411008241,simonsvan92,studying Mediterranean sperm whales with @_lrendell @_SMRU_ @ATursiops https://t.co/eosH9wbicC 🇰🇪🇪🇺🏳️‍🌈,1,0,0,0,1,300
2601276744,rjpheathcote,"Behavioural ecology postdoc at Bristol University. Researching signalling, predator-prey interactions, speciation, mate choice",1,0,0,0,1,300
587927961,dkcorvus86,"Behavioral, cognitive, urban ecologist, and ornithologist who occasionally dabbles in other taxa. He/his",1,0,0,0,1,210
3087618285,PallidHarrier,Assistant Curator for @MerlinBirdID and @MacaulayLibrary. Also studying vagrancy in Franklin's Gulls and urban #ecology in Michigan #birds. She/her.,0,1,0,0,1,202
36976313,zannaclay,"Asst Prof @DurhamPsych.Primates, developmental psychology, bonobos,conservation. Cross-cultural psych. Evolution & devpt of empathy, language & culture. She/her",1,0,0,0,1,300
882507417271062528,Tal_pov,rt ≠ endorsement,1,0,0,0,1,215
851674667005784065,Dragons_Lab,Research group at University of Sunshine Coast interested in studying evolution in the wild.,1,0,0,0,1,83
4852816143,DanPapageorgiou,"Studying the social life of vulturine guineafowl! PhD student at the MPIAB, Department of Collective Behaviour. @NatGeoExplorer. Views are my own.",3,0,1,0,4,300
874857937,jcbeehner,"Assoc Professor of Psychology and Anthropology, University of Michigan. Studies reproductive strategies /  suppression in wild primates.",1,0,0,0,1,227
402371601,nicolettarig,"Visiting researcher @CUSur_UdeG - Ecophysiology, Nutritional Ecology, Anthropology - 🐒🐦🦇🐁- Italian in Mexico ⚜️🇮🇹🇲🇽",1,0,0,0,1,300
259824278,SurlyJill,"biologist by trade, cyclist by might (she/her)",1,0,0,0,1,85
2458051746,CMBettridge,"Evolutionary biologist specialising in animal behaviour. I study sociality, at the moment my focus is on primates and white rhinos.",2,0,0,0,2,300
1635222104,Susanne_Shultz,"Evolutionary Biologist, Anthropologist, Conservation Biologist interested in the evolution of sociality, population structuring and physiology. Mom.",3,0,0,0,3,300
776834692171563008,plucky_primate,PhD student studying behavioral ecology and conservation | she/her | @MSUHyenas | @BioOnTap,0,0,1,0,1,220
21877288,RachelAHarrison,Postdoc at UNIL studying social learning in children (and other primates!). ESLR #CulturedScene Journal Secretary. She/her.,1,0,0,0,1,300
730148637704110080,moisessfb,,1,0,0,0,1,206
4126472945,Ced_Jouanneau,Graduate student in Behavioural and Evolutionary Ecology @UnivLyon1. Enthusiastic birdwatcher and banjoist in my spare time.,1,0,0,0,1,70
763452859652403201,RD_Garlinger,Wildlife Specialist with @whiteoakconserv M.S. in behavioral ecology🐥|| social behavior | #scicomm | #WomeninStem | she/her || Instagram: @rd_garlinger,1,0,0,0,1,300
1191315828,marinka_kma,"Entomologist passionate about #parasitoids #Hymenoptera #wasps, ecologist, #biocontrol and #GIS enthusiast, loving wife, driver, #WoW companion",1,0,0,0,1,147
596571234,FayeJThompson,"Post doc @UniofExeter studying intergroup conflict, ranging behaviour and population dynamics in the banded mongoose",1,0,0,0,1,300
835166465485582336,FrogListener,"Asst. Prof of Integrative Biology @okstate interested in animal communication, sexual selection & cognition. #Frogs, bugs & rock and roll, in that order",1,0,0,0,1,300
2469865608,BinoMajolo,,4,0,0,0,4,300
4414526354,SeanEhlman,"Evolutionary ecology, phenotypic plasticity, and adaptations to novel environments. Data through #rstats. NSF Postdoc at Univ. Minnesota. He/Him. 🐠🌲⛰🌞🏳️‍🌈",1,0,0,0,1,196
793925332030132224,DrKimor,"Postdoctoral researcher interested in behavioural ecology, predator-prey interactions, maternal effects, ecophysiology, colour polymorphism and brood parasitism",1,0,0,0,1,300
272931538,lizard_lab,"We are a research lab investigating behaviour, ecology & evolution of lizards. Tweets by Martin Whiting. See web page for research, lab members, photos, blog.",1,0,0,0,1,300
2301535339,orneladg,"Postdoctoral researcher investigating the social live of ants. 
My opinion and views change in light of new information",1,0,0,0,1,300
817757677585580033,KristineMeise,"Behavioural Ecologist, Field Biologist,  interested in understanding how animals interact with their environment to improve conservation management strategies.",2,0,0,0,2,174
807210274495328257,julianelukas,PhD student 🎓 @LeibnizIGB studying collective #animalbehavior 🐾 & loving all things #fishsci 🐟| Reaches peak performance around 11PM | Aspiring dachshund owner🐶,2,0,0,0,2,300
164802999,BouchardC_,Post-Doct on #glasseel #recruitment & #migratory #behavior | #Ecology | #SpaceUse | #Evolution | #Bayesian & #RStudio ❤️ | #Wine & #Rugby🍷🏉| Tweets are my own,1,0,0,0,1,166
779420940379811840,BenevidesLai,"Marine Biologist, PhD. #fishbehavior #marinescience #conservation",1,0,0,0,1,160
799239506792775680,AttilaFueloep,Ornithologist & behavioural ecologist @EvoZooDeb and @EvolEcolUBB interested in social behaviour (and some other bird-related topics). Details on my website.,1,0,0,0,1,168
800253110220300290,EvolEcolUBB,Evolutionary Ecology Group @UnivBabesBolyai | birds | flight | feather structure | personality | ecological physiology | life histories | ageing,1,0,0,0,1,300
4851372314,webber_quinn,"PhD student @MemorialU in @wildlifeevoeco studying social mammals (🦌🦇), social networks, and animal movement in a social context! (he/him)",4,0,0,0,4,300
796273225768505344,Chloedodds10,BSc hons animal behaviour UoC graduate 🎓👩🏼‍🎓,1,0,0,0,1,25
2455687826,gerrygcarter,studies cooperation and social relationships in vampire bats. Assistant Professor @EEOB_OSU,5,0,0,0,5,300
792564297503084544,PascalRMarty,"Post-doctoral researcher at UC Davis. Interested in primate evolution, sexual selection, socio-endocrinology, life history, and human-wildlife conflicts.",1,0,0,0,1,18
756242571303739392,lefevreromain_,Research Scientist in Behavioural Ecology 🐴 | Data Analytics Enthusiast 📈 | Jazz Addict 🎺. Tweet aussi en français. Mes opinions n'engagent que moi.,1,0,0,0,1,300
4582598836,persmiseth,"Reader in Animal Behaviour at University of Edinburgh. Parental care, family conflict, life history & inbreeding. Burying beetles. (he/him)",1,0,0,0,1,300
3437020947,RhesusMaCassidy,"PhD student @DPZ_eu & ultimate Frisbee player. Interested in applied animal behavior, animal welfare, cognition, hormones, and social buffering in primates.",1,0,0,0,1,300
788660598187884544,behaviour2017,"Welcome to Behaviour 2017, a meeting on animal behavior that will be held from July 30 to August 4, 2017, in Estoril, Portugal.",5,0,0,0,5,300
787121721622999040,onigiritani,"Theoretical Ecologist. Selfing, Dispersal, Host-Parasite, Social Behavior, F.R.I.E.N.D.S, Arsenal, AS Roma, Caligraphy, Anime, fonts, 🐶. ""Lio-sue-kay""",0,0,1,0,1,300
3304913886,davidghamilton1,Behavioural ecologist studying social networks in Tasmanian devils | Scot in Aus | Posts predominantly concern science & quoll puns | Weekly #DevilFactThursDay,1,0,0,0,1,300
783965762167902208,ASanchez_Tojar,Behavioural & evolutionary ecologist. Postdoc @unibielefeld. PhD @IMPRS_OrgBio & @imperialcollege. Ambassador of @EcoEvoRxiv #metaanalysis #openscience #birds,1,0,0,0,1,300
3430086047,informedbirds,"Behavioural ecologist who likes thinking about how information shapes our world. Living the HiLIFE, Kiwi/GB exile, now in Helsinki",2,0,0,0,2,300
80802729,Caniden,Online & zu Fuß durch die Welt der Hundeartigen.,0,0,1,0,1,300
3131430161,DenizSalali,"Lecturer in Evolutionary Anthropology/Medicine @UCL, Research Fellow @BritishAcademy_ Evolution & Behaviour & Health https://t.co/ohere834Cs",3,0,0,0,3,300
3430129162,aberghaenel,"PostDoc at the Konrad Lorenz Institute of Ethology - Domestication Lab, University of Veterinary Medicine Vienna",1,0,0,0,1,300
636192524,P_Tkaczynski,Post-doc working with @TaiChimpProject on social development and endocrinology in wild chimps 🙈 (he/him),4,0,0,0,4,300
2458303536,ChrisDBeatty,Evolutionary Ecologist interested in biogeography and speciation.  I work mainly with dragonflies and damselflies as model organisms. he/him #NatGeoExplorer,1,0,0,0,1,300
385611620,TomCurrieEvo,Associate Professor in Cultural Evolution EVORULES: Cultural Evolution & Ecology of Institutions (ERC Starter Grant),2,0,0,0,2,300
3975884772,chuckrpa,Holy Science!!!•PhD• Behavioural Ecology•Behavioural Flexibilty•Climate Change•,1,0,0,0,1,300
2194880713,avstrauss,"phd candidate, field biologist, museum enthusiast, science communicator (she/her)",2,0,0,0,2,300
4169253981,vviblanc,Researcher at the #IPHC studying social #evolution and effects of GxE on individual social #phenotype. #Behavioral #ecology and #ecophysiology work in the wild.,1,0,0,0,1,300
2374323464,VLee37,"PhD researcher @UoExeterCEC with @CornishJackdaws, views are my own.",1,0,0,0,1,300
714616018950180865,larterretral,MA in monkey fights from the University of Calgary. About to start a PhD studying sexual selection and vocal communication in frogs at UT Austin.,1,0,0,0,1,300
3149100370,gcmcdon,"Postdoc. sex, conflict, mating systems, sociality, evolution. @UNIVET_Budapest/@UniofOxford/@OxZooDept/@egioxford.",3,0,0,0,3,121
2201833089,LivioF_80,"Postdoctoral researcher. Research interests: animal behaviour, bioacoustics, dolphins, ethology, machine learning, penguins, vocal behaviour",2,0,0,0,2,300
721302510804176896,FishLab_MQ,"We are the Behaviour, Ecology and Evolution of Fishes Lab @MQSciEng. Visit our website for info on research & opportunities: https://t.co/XGbXQdJE8c",6,0,0,0,6,267
607292914,englishse,"Royal Society Dorothy Hodgkin Fellow - interested in maternal effects, developmental plasticity and vector ecology",1,0,0,0,1,300
2205410924,sb_dolphins,"Shark Bay Dolphin Research Project -- Protecting the dolphins of Monkey Mia and Shark Bay, Western Australia through research",1,0,0,0,1,300
1448304912,kokkonutter,Evolutionary ecologist. What if snow had heritable properties; we could breed it to form at up to +5c not 0. Wouldn't that be wonderful. Discuss.,1,0,0,0,1,300
710800359120183296,vanessa_higham,"Evolutionary Biologist, PhD Researcher @MonashUni. Interested in mitochondria, sexual conflict, microbiome, diet and life-history evolution in the #Dowlinglab",0,0,0,1,1,300
3017093141,emilyjemesser,"Primatologist with interests in social behaviour, culture & learning in children and non human primates. Science communicator. Postdoc at UT Austin.Views my own",1,0,0,0,1,300
1113456200,HippoReads,"Real world issues, academic insights.  https://t.co/OtXNarWxFs",1,0,0,0,1,300
849270546,ilumivuTweets,Human data capture systems for #mHealth #mmentalhealth #psychology researchers. Integrating #wearabletech and #mobile EMA to illuminate behavioral change.,1,0,0,0,1,300
260355830,esworldwide,"Evolutionary anthropologist, 
evolutionary psychologist, 
behavioral economist, 
studying life history theory and cooperation.",1,0,0,0,1,300
4494517461,FHillemann,"DPhil @egioxford, working on social information use and decision-making in mixed-species groups ... what's next? will announce soon!
🌈 she/her",3,0,0,0,3,300
371328288,MBPesendorfer,"terrestrial ecologist: behavioral & population ecology, plant-animal interactions, masting, and forest conservation. opinions mine only @BOKUvienna  @smbc",2,0,0,0,2,300
4337561602,A_PigsLife,"PostDoc @FBNBehavPhys. Animal behaviour, personality, emotion, cognition. Looking for the Answer to the Ultimate Question of Life, the Universe, and Everything",2,0,0,0,2,300
3432805331,Social_Beasts,"Animal behaviour, sociality & evolution. 

Rigorous Science + Smart Citizens = Citizen Science.",2,0,0,0,2,300
1864525388,NeeltjeBoogert,"Research Fellow in Behavioural Ecology @ University of Exeter, interested in sustainability, conservation, human rights, positive news",1,0,0,0,1,300
2350510640,arjundevamar,Associate Professor | FitzPatrick Institute of African Ornithology |@Fitztitute | University of Cape Town #Ornithology #Ecology #HumanWildlifeConflicts #Raptors,1,0,0,0,1,300
3297535251,HumanEthologyCZ,"Human Ethology Research Group, Charles University in Prague, Czech Republic",1,0,0,0,1,300
3587756483,dots_to_connect,"Researcher at CNRS-MNHN-Uni Paris. Behavioural biologist, interested in sociality, its costs, benefits, and evolution in primates",4,0,0,0,4,300
1672868695,AlisonGreggor,"Postdoc, Institute for Conservation Research, SDZG, Gates-Cambridge alum. Fascinated by animal minds. Budding conservationist. Views are my own. She/her/hers",4,0,0,0,4,300
2489658036,LMarechal_,"Researcher interested in human-wildlife relationships: conservation issues, behavioural ecology, pathogen transmission, animal welfare, and wildlife tourism",1,0,0,0,1,300
2890805361,bruce_rawlings,"Postdoc in the @EVOLearnLab studying cultural evolution in kids and chimps. Also like Ipswich Town, cricket, and good beer.",1,0,0,0,1,300
3143219572,AllertBijleveld,Behavioural ecologist | Tenure-track researcher at #NIOZ Royal Netherlands Institute for Sea Research,1,0,0,0,1,300
2977077309,drchrisyoung1,"Senior post-doctoral researcher in primate behaviour and endocrinology, University of Pretoria, South Africa",5,0,0,0,5,300
152251106,YKRho,Animalito esquivo.,2,0,0,0,2,300
2246220103,POMontiglio,Ecologist of individual variation in real & virtual ecosystems.,1,0,0,0,1,300
1065278929,MullonDlm,"Theoretical evolutionary ecologist into sex chromosomes, socio-cultural evolution, eco-evolutionary dynamics, Drag Race and other fun stuff.",1,0,0,0,1,173
3227641089,ChristinaHMeier,Researcher in Comparative Cognition,1,0,0,0,1,17
812786065,stphn_slzr,"Behavioural Ecology 
#individualvariation 
#risktaking
#aggressiveness
#bluetit
phd student @unibielefeld",1,0,0,0,1,300
2814033022,AmyLeedale,"Behavioural ecology post-doc
@Cambridge_Uni, @CamZoology, @Camb_BEgroup
Social evolution, kin recognition, inbreeding, sexual selection, bioacoustics",1,0,0,0,1,248
452164418,Partha_Marcus,"Ph.D student studying social behaviour in macaques.  Also, looking for postdoc opps. Here to talk if someone needs to in these crazy times. Least I can do.",2,0,0,0,2,300
2280115880,jasonkamilar,"UMass Amherst, Biological anthropologist, primatologist, comparative biologist, Editor of Evolutionary Anthropology @evanthro, transplanted New Yorker",1,0,0,0,1,300
561365226,pauledwardrose,Behavioural ecology. Animal welfare. Zoo biology. Vice-Chair BIAZA Research Committee. Co-Chair Flamingo Specialist Group. All views own.,3,0,0,0,3,300
3198332901,kayakusvulgaris,"Postdoc in behavioural ecology at University of Zurich, enjoys automating things and nice graphs, views are my own",8,0,0,1,9,300
3173195825,EthoGes,News and views from Ethologische Gesellschaft. Account hosted by Markus Zoettl.,1,0,0,0,1,89
1382505163,MarkusZoettl,Behavioural Ecologist and Zoologist. Interested in social evolution and cooperation.,1,0,0,0,1,300
875383045,HarryHMarshall,Lecturer in Zoology at U of Roehampton. Behavioural Ecologist and Conservation Biologist. Research on animal social behaviour under environmental change.,1,0,0,0,1,300
21517586,james_gilbert,"Zoologist @UniofHull; he&him. Insects, bees, thrips, parental care, social behaviour, nutritional ecology. Lab tweets @WildEcolHull.",1,0,0,0,1,300
2605020270,stephanleu,Behavioural ecologist with a keen interest in sociality and networks,2,0,0,0,2,67
3100606329,ChimpanzEve,"PhD student @UniOfYork studying social development in humans, chimps, & macaques. Fieldwork lover. @st_psy @InkawuP & @BudongoChimps alumnus. She/her",1,0,0,0,1,300
816471540,EthologyScience,"Ethology is the scientific study of animal behaviour. Intelligence, cognition, sexual behaviour, personality, learning, sociality & all that cool stuff!",1,0,0,0,1,300
2536869537,PankaSomogyi,myrmecologist #ants #insects #behaviouralecology 🐜,1,0,0,0,1,300
2840726613,SandraWinters22,"Postdoc in the @Camo_Lab at @BristolBioSci | animal coloration, evolutionary ecology, optimal phenotypes, #colsci",1,0,0,0,1,300
446966904,StefanoKaburu,"Anthropologist with a particular passion for non-human primates. 

Lecturer in Evolutionary Biology @wlv_uni",2,0,0,0,2,300
1729866499,AlbrechtS_H,"Applied Evolutionary Ecologist, squash player, @CRC_CRC @LaurentianU, beer/tequila/pastis drinker, Dir @CEEEC_LU @renewzoo Sec @csee_scee, TwitterCop",1,0,0,0,1,300
1704035064,ben_dantzer,"Asst Prof @UMich, studying animal behavior, evolutionary ecology, & physiology, prefers wild animals in wild places. He/Him/His. Views mine.",2,0,0,0,2,300
540281606,WaspWoman,Behavioural ecologist (mostly social insects); @SoapboxScience and   @bigwaspsurvey cofounder. https://t.co/uuCjULgufr,0,0,1,0,1,300
2842289548,SurenCabral,"PhD student @usqedu, Research Assistant @nifslk, MRes @unisouthampton, Commonwealth Shared Scholar
Animal Behaviour, Ecology, Physiology, Conservation",1,0,0,0,1,289
2315629800,ginnygreenway,"Postdoc interested in mating systems, the role of sexual selection in speciation and broader evolutionary ecology | she/her",1,0,0,0,1,266
2462060442,EvoZooDeb,"Dept of Evolutionary Zoology, UD - zoology, evolution, behaviour, personality, life history, ageing, population genetics, taxonomy.",1,0,0,0,1,300
2935800729,andrea_migliano,"Prof of Evolutionary Anthropology, University of Zurich",4,0,0,0,4,74
37243261,szenyo,Neo4j Ambassador. Baseball Freak. 🇭🇺,0,0,0,1,1,300
525578247,jwaup,"multidimensional human @EnigmaMPC #privacy

he / him",0,0,0,1,1,300
1160635021431988224,DavidGent18,"Husband, father, runner, pathologist, bad jokes, Duck fan, Jesus follower",1,0,0,0,1,94
700684631381643265,abbeyepage,MRC research fellow at LSHTM: combining population health and evolution,3,0,0,0,3,300
1112663133355737088,PennyMealy,Research fellow in complexity economics @INETOxford @oxmartinschool @UniofOxford. Research fellow @BennettInst @Cambridge_Uni,0,0,1,0,1,228
91675521,Davide__Cirillo,Of Music and Science!,0,0,1,0,1,300
1171319695,SimonCarrignon,,0,0,1,0,1,300
835054647148752896,ReginaMeszlenyi,"Machine learning researcher and Continental Automotive, Cognitive Science-Machine learning PhD",0,0,0,1,1,300
2621780097,tombochynek,Researcher modelling collective behaviour and evolution; ant and robot enthusiast. Postdoc at Northwestern University.,0,0,1,0,1,196
897749804,Toni_Valles85,There is only one meaning of life: Keep your genes immortal through reproduction,0,1,0,0,1,300
237769375,QMULMaths,We are the School of Mathematical Sciences @QMUL.,1,0,0,0,1,300
241198269,_Sefy_,,0,3,0,1,4,300
3367784062,MaximeDerex,"Studying cumulative culture, social learning & innovation in the lab.",1,0,0,0,1,284
524294533,rnmantegna,I am a physicist interested in the analysis and modeling of economic and social systems,0,1,0,0,1,198
1856509825,ValerioCapraro,"Senior Lecturer. Research on cooperation, altruism, honesty. President @viadelsaleonlus Raised 500k to help victims of the Central Italy earthquake",0,0,0,1,1,300
3302978609,NetSciX2016,The NetSci-X is the primary winter conference on Network Science promoted by the NetSci Society. January 2016 at @PWr_Wroclaw by @ENGINE_WrUT,0,0,0,1,1,184
796659414459645952,ShengleHuang,PhD candidate of European Joint Doctorate Program SuPER-W at UGent (CMET) and TUDelft (EBT). Speaks my own. 涯系客家人. AFOL,0,0,1,0,1,285
792738119833493504,_Little_Yui_,"Microbiología 🔬🧫🧬🧪🦠🍇🍦❤ 
💎
🇵🇪",1,0,0,0,1,300
862511748716285952,JacobJCrouse,"Research fellow @BrainMind_USYD @Sydney_Uni | Mental health, early intervention & neurobiology 🧠",0,0,1,0,1,300
56424676,xKore,"WILD TO THE KORE 🦁 // 
also @sonnybanksmusic // 
#dubstep #dnb #bass #drumstep #trap",1,0,0,0,1,300
825105282145587201,Lisaandrollab,Andrology lab focusing in advanced semen analysis. We developed a technology able for investigating any disorder affecting male genital organs.,1,0,0,0,1,300
360914667,Jero_Vazquez,Plant ecologist / Conservation biologist,1,0,0,0,1,300
724515838133301248,mkhar0,Bioengineering PhD student @Stanford | she/her | science v art,0,0,1,0,1,120
557060187,RaspyPi,"All things Raspberry Pi, Embedded Computing and Sensors",1,0,0,0,1,300
1150750162366730240,InCIAM_Univ,"Institut Créativité et Innovations Aix-Marseille Université
#créativité #creativity #innovation #recherche #formation #éducation #santé #travail #designthinking",1,0,0,0,1,295
222318574,eugeniabsotop,"De Caracas, Venezuela. 🇻🇪 University of Florida 🐊 PR major 👩🏽‍💻",2,0,0,0,2,300
1192733168736067584,learning20201,Music can inspire amazing positive problem-solving actions in the common people! Check out the playlist linked below:,0,0,1,0,1,300
1180906436253175808,sofiya_voytiv,PhD student in sociology @Sociologi_SU. Doing research on the (symbolic) deterritorialization of conflicts in the homeland using mixed methods,1,0,0,0,1,33
2203086529,jennawneal,"Not That Kind of Psychologist, Social Network Analyst, School Researcher, Indiepop fan, Cat fan, traveler, & wine drinker. Views are mine. RT=inform. she/her",1,0,0,0,1,300
324954417,SoAP_Groningen,Het Sociologisch Antropologisch Periodiek is sinds 1970 het vakgroepblad van Sociologie Groningen. Door en voor sociologiestudenten en -docenten.,1,0,0,0,1,300
821445787,_MCEngels,Postdoc | University of Groningen | Students' relationships with teachers & peers and their academic/emotional development in primary and secondary school 🍎🍐,1,0,0,0,1,300
2333551188,Steve_McD1,"Sociology prof. Social capital, networks, labor markets, Internet & society, inequality.",1,0,0,0,1,160
801456506076069888,ProfTroester,Professor of OrganizationalBehavior & Leadership Researcher | Trainer | Coach,1,0,0,0,1,262
236047003,gabrielhancean,"University of Bucharest, Department of Sociology",1,0,0,0,1,300
4743494374,alex_gdlp,"PhD student in Analytical Sociology at @IAS_LiU from Barcelona. Segregation dynamics, networks, causal inference. Metalhead.",0,0,0,1,1,300
1615252842,WeedenKim,"Professor & chair @CornellSoc, director @InequalityCU, deputy editor @SociologicalSci, Alaskan. I don't speak for @Cornell, @SociologicalSci, or Sarah Palin.",1,0,0,1,2,300
979218330190888963,ANSNA_Au,Australian Network of Social Network Analysis. Building greater collaboration & cooperation among SN researchers. Raising the profile of Australian SN research.,1,0,0,0,1,106
919294448,paul_dimaggio,"Twitter Interests: Music, politics, food, sociology, information technology policy",1,0,0,0,1,300
1158639465293918208,marioehuezo,,0,0,0,1,1,300
65564634,kaylloquial,Researching experiences of air quality / PhD student @uniofoxford @OxfordDemSci / views are my own,0,0,0,1,1,300
744386748185194496,EllaSheinfeld,"OM Ph.D. student @RutgersBSchool; Former data analyst @YaleSOM @YaleCOPPER; Behavioral sciences, social influence, innovation, health care, data-driven research",2,0,0,1,3,300
18089975,drjenndowd,"Assoc Prof, University of Oxford. Deputy Director @OxfordDemSci. Demography, Population Health, Epidemiology #poptwitter #epitwitter #econtwitter #soctwitter",1,0,0,1,2,300
397991469,ruettenauer,"Postdoctoral Prize Research Fellow in Sociology @NuffieldCollege, @UniofOxford. Environmental Inequality, Urban Sociology, Spatial Methods, Causal Inference",0,0,0,1,1,176
1076686669,SanderKunst,"PhD student in Sociology and Political Science @UvA_AISSR || Education, Political socialisation and Cosmopolitan attitudes || U2 and Beatles fanatic ||",1,0,0,0,1,47
2472326539,cgottlie,"Macroeconomics, Development, Household Finance. Currently Assistant Professor @hsgstgallen. Former Post Doc @NuffieldCollege and PhD @europeanuni.",1,0,0,1,2,300
1216760405797883904,sociology_uzh,Welcome to the Institute of Sociology UZH - Willkommen am Soziologischen Institut der Universität Zürich,1,0,0,0,1,64
1215429763,cwsmonden,"Mostly sociology and demography, some cycling, and stuff I find interesting but not necessarily like or agree with.",0,0,0,1,1,300
837770828,SocresOnline,"Sociological Research Online is an international, peer-reviewed journal publishing high quality applied sociology.  
sro.journal@britsoc.org.uk",1,0,0,0,1,300
1155120565,emirhandarcan,"Alumni @RutgersSCJ
#Research on #Security Studies and Policies. 
#Data Analyst. Humanist
#GIS and #Nvivo Professional
.",1,0,0,0,1,300
24961714,drdavegriffiths,"Sociology Lecturer at Univ. Stirling. Interests in SNA, stratification, social capital, elites, occupations, quangos, social advantage & social statistics.",2,0,0,0,2,300
983967271252000768,BarclayKieron,Demographer at the Max Planck Institute for Demographic Research and Stockholm University.,0,0,0,1,1,122
576058205,sanderwagner,Asst. Prof. of Sociology at ENSAE/CREST. Chairman of #Croissanttwitter 🥐,0,0,0,1,1,300
847789794470105088,PSG_LSHTM,Twitter feed of the Population Studies Group at the London School of Hygiene and Tropical Medicine,1,0,0,0,1,300
3238856081,YuliyaKosyakova,Senior researcher at the @iab-news | Lecturer at the @UniMannheim and @otto_friedrich | #Migration #Integration #Refugees | #Sociology | @alumnieui,1,0,0,0,1,209
908637164271005697,OxSoc,Jobbing social scientist at some Hogwarts lookalike university in the South Midlands,0,0,0,1,1,300
1061484524926844928,shpenev,Postdoc @Upenn studying social networks in health. I mostly tweet at businesses about their poor customer service.,1,0,0,0,1,220
846747851334074368,ptts_muenster,"Postcolonial, Transnational & Transcultural Studies
PTTS @wwu_Muenster
MA National & Transnational Studies https://t.co/d6kSYbhwG1
Tweets by @dnyangulu & @profmarkstein",0,0,0,1,1,300
2483947273,kirk_davids,"Professor @SociologyOxford & @NuffieldCollege | Director @csinuffield | Author, Home Free: https://t.co/TAU3iZNjEr",4,0,0,0,4,300
95272927,selcukbeduk,"Researcher interested in poverty, wealth, life course, transmission of (dis)advantage and comparative social policy",1,0,0,0,1,300
755677281360678912,sara_geven,"Assistant Professor Sociology, University of Amsterdam. Research interests: education, stratification, social networks",3,0,0,0,3,212
702433673329680384,AndreasKlaerner,"Sociologist, social networks, poverty, health, rural studies. Head of Network on Social Networks and Health Inequalities @Networks_Health",6,0,0,0,6,300
36920452,NuffieldLibrary,We are a social sciences library serving Nuffield College and the University of Oxford,0,0,0,1,1,300
984736653104308224,lives_equal,"Research looking at #inequality, early adult life courses and economic outcomes at mid-life in 5 countries. Funded by NORFACE #DIAL https://t.co/TX0PMwyGLk",1,0,0,0,1,300
2906820023,EnglandPaula,"Sociologist doing research on gender, sex, families, work. Citizen trying to help get democrats elected. Mindfulness meditator. Person enjoying life. She/They",1,0,0,0,1,300
1230640932,uva_amcis,"Amsterdam Centre for Inequality Studies, University of Amsterdam http://t.co/3go7cuXsCV",1,0,0,0,1,143
272346794,DirkJacobs71,"full professor in sociology @ULBruxelles, @germe_ulb, teaches methodology, research on education, political participation, social networks & migration",1,0,0,0,1,300
23964268,oxmartinschool,The Oxford Martin School at the University of Oxford is a world-leading centre of pioneering research that addresses global challenges.,0,0,1,0,1,300
2565126223,INETOxford,The Institute for New Economic Thinking at the Oxford Martin School (INET Oxford),1,0,0,1,2,300
1133771239,DSPI_Oxford,"Oxford University's Department of Social Policy and Intervention. Teaching MSc, MPhil & DPhil in Comparative Social Policy & Evidence Based Social Intervention.",0,0,2,0,2,300
11651852,k2239pgg,,0,0,0,1,1,300
975130979944845312,Violeta_ICS,"PhD student @IFISC_mallorca. 
Trying to explore ecological interactions through the lens of complex systems 🌱",0,1,1,1,3,158
3121503958,cedricsueur,"Associate Professor, group leader in #animal #ethics, #epidemiology, #primatology, #leadership, #social #network and #modelling;  @Physiol_Evol_Be",1,0,0,0,1,300
2519605567,minjunkim7767,🚀 | Entrepreneur | Network Science | A.I. | Data Science | AdTech | FinTech | Hydrid-Commerce |🚀  https://t.co/v3sgxijWOJ,0,0,1,4,5,57
917348442455793667,juicethemodeler,"Mathematical modeler, keen student of human behavior, lost in translation for over a decade, and just another sailor on the great material continuum",0,0,0,2,2,300
4690619832,kasia_kozdon,"AI researcher / neuroscientist working on a PhD in spiking neural nets, UCL iGEM2016 team advisor, and a TA in ML @UCLcs | @ISALstudents board member",0,0,2,0,2,300
2188294226,JoshAFirth,"Research Fellow @UniofOxford with interests in sociality, networks, contagions, ageing, human behaviour & health",5,0,0,0,5,300
163277744,emilyboeving,"PhD Candidate | Network Scientist | Comparative Psychologist #Primatology #SocialNeuroscience Social networks, behavior & cognition in primates, birds & humans",2,0,0,0,2,300
140773102,matmagnani,,4,0,0,2,6,242
27932853,jeffcmohr,Cofounder & CEO @kumupowered. Often found running in the mountains or dabbling in complex systems and networks to spark lasting change.,0,0,1,0,1,263
245734683,michignolo,,0,1,0,0,1,11
3052278951,data4sci,Take Control Of Your Data. Join our Sunday Briefing newsletter for the best in #DataScience and #MachineLearning https://t.co/jhNAUkVml8,0,2,0,0,2,300
3079709494,KreyonProject,"Unfolding the dynamics of creativity, novelties and innovation",0,0,1,0,1,284
422394656,ggna_moony,Je sais que je ne sais pas ce que je ne sais pas (Zénon),1,0,0,0,1,131
4851045233,DivyataSohalV,PhD in Knowledge Management • @henleyforum • Complexity Geek,0,0,1,0,1,294
22748201,thanhvy,"A female engineer and #AgriFoodTech entrepreneur, who is unlocking complex systems. INTJ.",0,0,1,0,1,300
559756727,flodebarre,"CNRS researcher, Theoretician in Evolutionary Ecology ORCID 0000-0003-2497-833X |  Tweets about science and women in science.",1,0,0,0,1,300
1017115266591920128,AfricanCoffeeC,#African #Coffee #AfricanCoffee #CoffeeIsAfrican,1,0,0,0,1,300
1725251,pitsch,,0,0,1,0,1,300
988606892933959681,DrAnyaJones,Post-doc in Systems Immunology 🇭🇲 | Data Analyst @telethonkids | Allergic to pessimism | Travel aficionada 😎🏕⛰,0,0,0,2,2,300
478098171,PiFu67,,0,0,0,1,1,300
216591528,hanisaf,,1,0,0,0,1,300
382247879,abdurrezzak_efe,"Making inferences about you via my Markov Blanket. 
Science, Tech and Art.",1,0,0,0,1,300
880819693531123712,Miami_Biostats,,1,0,0,0,1,300
18449997,niedro,Responsabile Editoriale presso Associazione Rousseau,2,0,0,0,2,300
425745533,StephStammel,The frequentist half of ‘the Bayesian and the Frequentist.’ Data scientist. Consultant. Geek. Not necessarily in that order. She/her.,0,0,1,0,1,300
811459856049655808,dylanista0524,,0,0,1,0,1,300
1204494661311762433,MitscheleKaiser,,0,0,0,1,1,16
2773849450,jalochowski,"""Being a journalist is always better than working"".
Science journalist, doc film maker.",0,0,1,0,1,300
26080070,KarineEhn,"PhD student, doing research on social networks effects on mobility in our society (neo-nomadism). Passionate for aviation, skydiving and kite-surfing ✈️🪂🏄‍♀️",1,0,0,0,1,23
965695299766366208,PassGiustino,"Dottore in Scienze Politiche ed Internazionali - Student of Business Communication and HRM Policy, valutatore e comunicatore del Rischio",1,0,0,0,1,26
1188390292153667586,HomoSacer3,"lecturer, now in 🇯🇵 A family living in 🇬🇧, a kid a UK citizen, deeply concerned about kid’s future in post-Brexit UK. RTs not endorsements",0,0,1,0,1,300
51553667,diojenez,Dodger fan and research scientist at Facebook.,1,0,0,0,1,300
278584940,plurabellaties,"Pocket maker, coffee enthusiast. I collect grammatical negations and types of string.",0,0,0,1,1,300
137903824,marc_cart,"🌍 TEST b4 arrest 🌎lock our bodies in not our voices. londoner. migrant. anti-war healthist. ⚽️ writer. di stefano to messi, via maradona. spanglish tweets",0,0,0,1,1,300
106503983,monchos77,"Aquí, ahora",1,0,0,0,1,300
407613438,0fysh0,"Papa, crummy squash player, international technocrat, opinion-haver. Interested in risk, disaster & decision making.",0,0,5,0,5,300
371337594,ekponk,"Canadian/UK citizen. Ph.D. Londoner. Ex BBC, FT. Data Scientist. Musician. Also reads a lot. And retweets apparently.",1,0,0,0,1,300
784520812514709506,Planck_Epoch,,0,0,0,1,1,300
61713692,lexmastin,"Epidemiologist at @SalfordUni. Working on surveillance - previously canine echinococcosis, now emerging plant pathogens...",0,1,0,0,1,300
17069103,MartijnBAARDA,Making the soul of organisations relevant to the market. Bridging the gap between business and marketing strategy. Insanely curious. Life randomizer.,1,0,0,0,1,300
199478071,Catpawn,"Consultant and life long learner: sciences & technology, philosophy, chess, tennis and yoga",0,0,1,0,1,300
984446349016875009,pinakiclickz,Graduate student trying fix to grave issues with life!,0,1,0,0,1,155
1182672083282808834,mbkoltai,"math modeler in systems biology
-.-.-
combining complex systems + political economy @ https://t.co/r9QGsjQkUy",0,0,1,0,1,87
398222025,spawnofKahn,DEFinitely a wonk. @DEFConference,0,0,0,1,1,300
1140066312380567553,brwilder,PhD student @Harvard working with @MilindTambe_AI on machine learning and optimization for public health,1,0,0,0,1,18
1467841231,CarlaPermeus,,2,0,0,0,2,300
1240500205373419520,cxteam_lim,physics. complex systems. https://t.co/3qUJXFxSg3,0,0,1,0,1,300
10851282,luferwi,,1,0,0,0,1,300
1065784806045294592,tollstroll,my alter real ego,0,0,0,1,1,300
972450667431383041,agcxbt,Crypto-Enthusiast,1,0,0,0,1,300
17452088,aline_jacques,,0,0,0,1,1,66
49806445,JamieDunning,"I am an easily distracted ornithologist, interested in group dynamics and sociality. PhD candidate @imperialcollege & research fellow @irs_goldsmiths.",3,0,0,0,3,300
2308743744,ElMudoRiquelme,,1,0,0,0,1,300
86973349,blip2009,"A deplorable fly on a wall, a rebel with and without cause...",0,0,1,0,1,300
1065503533,JakRuby5,Late Stage Capitalism Vs 21st Century....  Which side are you on?,0,0,1,0,1,300
3138327049,blackhandkelly,,1,0,0,0,1,300
419362604,Tomas_Dapkus,"TV Anchor, Political Editor",1,0,0,1,2,300
170744536,AhmadMkhatib,"A husband and a father. PhD researcher @UofGlasgow @UofGIHW @UofGMVLS @theSPHSU,. Place & Public Health. Him/he. Views my own.",1,0,0,0,1,300
277693056,germanmartins,"Complexity Sciences & Sport. Todo cambia, nada perece. Ovidio",0,1,0,0,1,300
46540818,shintaromori,"What is Physics ?
Statistical Physicist",0,0,1,0,1,300
1109447228911951874,WBarhdadi,PhD researcher @ugent | developing computational models in ecology 🌱 | interested in population & community ecology and complex systems,0,0,1,0,1,0
2283652956,GIS_jiang,"Urban Scientist, Geospatial Data Scientist, Assistant Professor at Temple University, Alum of MIT Senseable City Lab.",1,0,0,0,1,274
231437901,dzviovich,,0,0,1,0,1,300
4640050572,trottiest,"Founder & CEO at @getcleverpet. 
Enthusiastic about the potential of minds.",0,0,1,0,1,300
1766071,ekenzie,"Systems scientist, researcher, parent, diagram geek, science enthusiast",0,0,0,1,1,300
1220667695160614913,sagaplague,"PhD student #genomics #bioinformatics
🧬🦠☣️🦠🧬
Currently covering #COVID19 #pandemic with #FactsNotFear",1,0,0,0,1,300
1410661344,EmilioDiazVar,,1,0,0,0,1,275
28439392,manolisd,"Curious by design...
Father, husband, and UCY PhD candidate (order may vary several times during the day).",1,0,1,0,2,300
58008316,jonsv89,,0,0,0,1,1,300
393604216,wlharder,"Now @CTRL_AU @AmericanU, next @gouchercollege | working on #facultydev, #inclusivepedagogy, networks, #socialmedia | PhD in Pol Sci  | Tweets=me | he/him",1,0,0,0,1,300
883148766,VVLVasconcelos,Postdoctoral Research Associate @ Princeton University,0,0,1,1,2,44
3169212490,ProfPrencipe,Rector Magnificus @UniLUISS; Associate Editor @JMS_Journal; proud alumnus @1994ccc @SPRU @SussexUni,1,0,0,0,1,300
37764670,nlessa,"Fundador e CTO da Moleque de Idéias. Arquitetura de sistemas,Clojure, computação distribuída, e-commerce, sistemas de pagamento, ambientes de aprendizagem livre",0,0,0,1,1,300
786845424,kuanggrade,"Computational neuroscientist in training.
Aspiring Consciousness/self-awareness researcher.",0,0,2,0,2,300
1314104323,theanhvub,,0,0,1,1,2,300
1039927673907294208,SamW112358,Math Grad | Liverpool fan | On placement working with the Good Practice Exchange team at the Wales Audit Office | Views my own,0,0,1,0,1,300
114291686,mdbod,,1,0,0,0,1,300
1149056096776130560,illegaldaydream,"Scientist, Engineer, Activist. Freelance subversive.

Affiliated w/ @PursuanceProj @ddosecrets @uvmcomplexity @DaylightingSoc @rpisec @adpsociety and others.",0,0,0,1,1,192
830241976633159680,JalayerK,"I am an assistant professor at East Carolina University, interested in research, publication, and teaching.",0,0,1,0,1,36
597570039,PeterSforza,"Director, Center for Geospatial Information Technology @ Virginia Tech | Geoinformatics, GeoDesign, 3D, Broadband, Public Safety, Agriculture. personal account.",0,0,1,0,1,300
1081872397433794560,miltonlopez_,"Software engineer for fun and profit. Interested in interesting things.
Bibliophile.
Building to learn, learning to build.",0,0,1,0,1,300
337330113,FrancOrsucci,Mind scientist...in complexity science.,1,0,1,0,2,142
34297961,d_vf,,0,0,1,0,1,300
19915011,ManuTanger,"Interested in Complexity Sciences, Innovation, Tech, Social dynamics, entrepreneurship and finding the most interesting path. Singularity University & Beta-i",0,0,1,0,1,300
1005171702475747328,GiuliaRuzzene,PhD candidate,0,0,1,0,1,97
270218342,ShaneAScaggs,PhD student @OSUanthro studying socio-ecological systems,1,0,0,0,1,300
540333147,Francesco_i0ri0,"cancer data scientist at Wellcome Sanger Institute, Cancer DepMap Analytics Team Leader, algorithm designer, dad, cook, failed singer, resting runner 😉",1,0,0,0,1,300
220768077,martinapatone,#PhD #stats #bigData,0,1,0,0,1,300
1034101695897378816,L1KNB,"Economist, @AIER Research Fellow, +20yr fin mkts trader, PhD candidate. Spontaneous order, complex systems, statelessness, #crypto, #gold, #liberty, #gaming.",0,0,1,0,1,300
43111060,meedabyte,"Creator of https://t.co/WXpBs3oDph 
@Thinkers50 Radar 2020
@Boundaryless_ Co-founder: https://t.co/JzidgNNG25",0,0,1,0,1,300
720150009908490240,hossein4527,"Master of Complex systems & Nonlinear dynamics @SBU_ccnsd, Tehran",0,0,2,0,2,15
322544579,dwkok,"Shoshin. Organizational life: Culture Behavior and Ecosystem complexity. Stay inquisitive, don't believe the hype and challenge everything!",0,0,1,0,1,300
233239622,colmedagomez,,1,0,0,0,1,186
1098248394655571968,EdgardoBrigatti,"Collective behaviors in biological and social systems, complex systems and data science.",0,1,3,0,4,137
880873768310030336,curtatkisson,"I program and do math, then go to the jungle to see how full of crap I am.",1,0,0,0,1,295
64680623,LaurelFogarty,Senior Scientist at the Max Planck Institute for Evolutionary Anthropology making models of cultural evolution.,2,0,0,0,2,300
3524620768,AlinaGutoreva,"Behavioural Science PhD @ University of Warwick, working on social influence. AI, communication and wellbeing scien-siast (scientists*enthusiast)
*job-hunting",1,0,0,0,1,300
1102937621507047424,mariamartinz13,Galega. Física. Juapa de lexos.,0,0,4,0,4,300
1174747324507197440,MeganRWinkler,"Population Health Researcher | PhD, RN | @PublicHealthUMN | #foodsystems #SDoH #nutrition #obesity #healthywork",0,0,1,0,1,126
2751294448,EricaLangnas,Anesthesia Resident | Research Scholar @UCSFanesthesia,1,0,0,0,1,50
2897127418,v_fes,"Digital society, machine learning, computational biology, network science, data science, big data, natural language processing, personalized medicine, finance.",0,0,0,2,2,114
936263937951260674,realphiljacquod,"Physics professor, graph theorist, wine practitioner, mountain hiker and wannabe alpinist",0,1,0,0,1,240
6493652,jgmrichter,Journalist at @WineLandSA. Former academic publisher. Interested in #postfoundationalism & #criticalcomplexity.  Born at 332.66 ppm. Expert follower.,0,0,2,0,2,300
266855827,MorganAvatar,Not an avatar,1,0,0,0,1,130
2428410232,SoL_Bulgaria,#Systems Thinker; #Leadership and Organizational Renewal; #Game Changer;# Transformational Learning; #Complexity Tamer; #Enterprise Agility; #Mindful Presencing,0,0,1,0,1,300
1090923396060319744,socialphysics2,"The interplay of tech, community and structures. RT’s are ❌ endorsements. The beauty of complexity and explorations.",0,0,1,0,1,210
45417325,hrmoaddeli,"Freelance Python developer, Data science, Deep learning , Big data enthusiast.",0,0,1,0,1,300
1154777694988636160,retroprogress,RetroProgress: the possible progress in a living planet. Account created by @jmcampsc #ClimateChange #ThereIsNoPlanetB #ClimateCrisis #RetroProgress #RP,0,0,4,0,4,300
934383820601724928,up_impact,Project management software optimising organisational ecosystems for high #performance. #peopleanalytics #values #insights #teamdevelopment #equality #metrics,1,0,0,0,1,300
1092012778762747904,complexityedu,"Il CEP è un gruppo di ricerca dedicato allo studio e alla diffusione della complessità. The CEP research group studies complex systems.
@uniperugianews",0,0,1,0,1,300
738776917529108481,Intro2ABM,"Complexity Explorer's Introduction to Agent-based Modeling Massive Open Online Course twitter feed.

https://t.co/FtvQrH3Cea",2,0,2,0,4,300
177227124,pabloestradac,"22. Economist | Data Scientist. ""Give to the world the best you have, and the best will come back to you"".",1,0,0,0,1,181
772587967,davramirezcruz,,1,0,0,0,1,31
405124299,heidiColleran,Independent Max Planck Research Group Leader @BirthRites @MPI_EVA_Leipzig. Anthropology of Reproduction | Demography | Cultural Evolution | Vanuatu & Poland,3,0,0,0,3,300
28780171,fozpinar,"You never change things by fighting the existing reality.
To change something, build a new model that makes the existing model obsolete.
Buckminster Fuller",0,0,0,1,1,300
1149131962013147136,SociologyUalr,The Sociology program at the University of Arkansas at Little Rock. Tweeting to spark the sociological imagination.,1,0,0,0,1,171
961433894510841856,MitoPsychoBio,"Mitochondria and psychobiology. Our lab studies mitochondrial signaling, brain-body communication, mitochondrial disease, and aging.",0,0,0,1,1,300
772173634815205377,BanjoCollie202,"Lots of fun ideas with not enough time to do them.
I like ludology, narratology, linguistics, complex systems and computer graphics. 
Sometimes I make things.",0,0,1,0,1,128
21561362,faaez,Data scientist working on new mobility @Uber,0,0,1,0,1,300
1072114919523278848,Nickolas_Song,,0,0,1,0,1,65
16289312,DeltaKnowledge,"CFA Knowledge Manager, Public speaker on Collaboration, Complexity & Resilient Business - enjoys a good game of Go, Ice Hockey & a bit of Watercolour",0,0,2,0,2,300
1107354568868790272,network_motif,,0,0,1,0,1,226
3098250995,stylianipantela,"Software Engineer @Twitter. Previously @VerticaBigData, @Harvard CS '15, @HarvardDASlab & @WayfairTech. She/her.   🇺🇸🇬🇷🌎",1,0,0,0,1,300
822153101113196548,sturm_steffi,PhD student @UniBarcelona interested in brains and minds and the role of the cerebellum for cognition. 🌿,0,0,1,0,1,261
869397837511102464,AGMAndirko,"PhD student, University of Barcelona @cbl_bcn. Human evolution from Genetics to Archaeology through Neurobiology.",0,0,1,0,1,300
2470883774,ShapesOfEmpathy,"Inclusive wisdom theorist, eldercare, DIY mystic. Book explores inter-personal development of big picture thinking: dialectics, systems, metacognition, empathy.",1,0,0,0,1,300
1904917267,IuliaCioroianu,"Prize Fellow @UniofBathIPR. Computational social science, social media, campaigns and elections. Ph.D. New York University",1,0,0,0,1,224
3128651926,vivekhsridhar,Evolutionary biologist | Social & collective behaviour researcher | PhD student at the Max Planck Institute of Animal Behaviour,0,0,1,1,2,300
1126908675119915009,YeSun_UofUtah,"Associate Professor, Dept of Comm, U of Utah
Love quant research & mountains
Like = LIKE or save for future reading/research
Retweet =\= endorsement",1,0,0,0,1,289
2995384038,EmeliJAnderson,Epidemiology PhD student @EmoryEPI. HIV/STIs. Mathematical modeling.,0,0,0,1,1,59
974539527699103747,EzekielLucas_,"Currently: Cloud sales @ a F100.
Interests: start-up ecosystems, productivity, work culture, data science, and knowledge management. UGA alum. Views are my own",0,0,1,0,1,300
1034734556824395777,LuGram12,"Global health & development researcher @UCL | community participation / politics | gender | VAW | South Asia. Views my own, RTs not endorsements.",0,0,2,0,2,300
957745963753406464,Asem_A_A,"TA @CairoUniv. Enthusiasm for Bioinformatics, ML, Research Engineering. Fisherman. Loves Geology and Botany.",1,0,0,0,1,296
611495395,MadelonRooseboo,"Improving Health at National Health Care Institute @Zinkwaliteit, stimulating change leadership, art of implementation",0,0,2,0,2,300
193021408,nefstath,"Transportation Systems, Smart Cities",0,0,1,0,1,252
262489445,TonyDSirianni,"Postdoc in Quant Soc Sci/Sociology @Dartmouth, @CornellSoc PhD - social interaction/networks, group processes & CSS. Buffalo, NY expat.  https://t.co/R6mS7Hw9QG",4,0,1,1,6,295
81486414,nekonekno,In lak'ech. Mexicano amante de la ciencia y los chocolates. A veces sueño con ser investigador. #cosmology #firstgen #STEM #GirlsOnSTEM,0,0,1,0,1,300
1116790237198524416,FieldingGrasty,Building relationships for better science at the Center for Open Science @OSFramework,0,0,0,1,1,300
3275064685,NinarehMehrabi,,1,0,0,0,1,50
253633132,SerginhoeReis,13y bridging the gap between people and solutions in healthcare market.,1,0,0,0,1,300
3246735435,wolkenmachine,Independent Researcher & Tool Builder. A quiet space for thinking about systems.,0,0,1,0,1,300
2165264170,hdodiazm,"Professor, Electrical Engineer @UNColombia. MS, PhD @RPI. I see math and models everywhere.",1,0,0,0,1,265
152864375,wwpIII,"scientist + entrepreneur | as for me I am tormented with an everlasting itch for things remote. I love to sail forbidden seas, and land on barbarous coasts.",0,0,1,0,1,244
51525530,TupyMG,Economista. Professor da @ufvbr; Coordenador do @ysi_urewg Working Group @ysi_commons @ineteconomics; Doutor em Economia Regional e Urbana pelo @cedeplar @ufmg.,0,1,0,0,1,300
1102602230182625280,SmartSpaceTime2,"Popular science book by @markburgess_osl which explains the deeper meaning of space and time in physics, computers, and artificial intelligence.",1,0,0,0,1,300
1104023158527528961,HeleneArduin,"Post-doc fellow @CNRS - modelling complex systems - infectious diseases dynamics
#ABM #rstats",0,0,1,0,1,86
102110379,ziuturi,Soft matterist with predilection for biopolymers,0,0,1,0,1,18
628699729,MrBlakeCorrigan,"Wolf and tree ecology, dynamical systems, differential geometry and ink drawing - 
Fourth Year - Applied Mathematics - Maynooth University",1,1,0,0,2,300
1365111331,shrmir,Computational social scientist | #stackoverflow addict! | pretend painter,0,0,0,1,1,82
1101926560616103937,ContagionTheo,,1,0,0,0,1,34
976614312,ScimPulse,The SCimPULSE foundation is a non-profit organisation that promotes science to impulse mankind towards ever greater heights,0,0,2,0,2,300
210168141,girlinthewild,,0,1,0,0,1,33
818549985520340993,LTysik,,0,0,1,0,1,300
959287245151678469,mr_hiwatig,Electronics Engineer turned Hydrographer turned Data Scientist | Human life is a blip in the cosmological timeline | Carpe diem!,0,1,0,0,1,166
930679698539106305,em_prosperaus,More activist than urban planner. Musing on monopoly rents in complex systems and how much I love Anne Haila.,0,0,1,0,1,300
1050594244262383617,Srishti_ACM,Student body from @SrishtiArtDes I Recognized body of @TheOfficialACM & @sigchi | Multidisciplinary students working in in the space of #HCI,0,0,1,0,1,300
1095952703824510976,judyxkam,@SternUC | @NYUakpsi | @NYUtennis,2,0,0,0,2,26
838593540,AlbertoQuezad12,"Ando relax, dije relax...",0,0,1,0,1,300
1090855680884572160,ShenGrant,,1,0,0,0,1,7
153487645,scottdempwolf,"Twitter is my gateway drug.  Assistant Research Professor at University of Maryland & founder, Tertius Analytics.  INTP #DeadCorps",0,0,1,0,1,300
1533041317,ASonawalla,Software Engineer | Traveler | Entrepreneur,1,0,0,0,1,9
117201805,luanabarbosa05,,2,0,0,0,2,300
1092952337000337409,andreayou11,,1,0,0,0,1,7
1495573794,cjeffrun27,"nurse, musician, trekkie, old soul, she/her. student of complex systems. best described as a non-newtonian fluid. love is love 🌈 all views my own.",0,0,1,0,1,300
734736738611036160,vince_formica,"evolutionary biologist, Mountain Lake Bio Station, evolution of social networks, muddy boots bio, Swarthmore faculty, #feminist, terrible mispelled/bad gramarer",1,0,0,0,1,300
165625639,Aelphababreak,Bióloga,1,0,1,0,2,300
2375578982,sach1tb,"Crowds, fish, birds, insects, and robots keep me up late at night",1,2,2,0,5,300
108065318,maevemdx,"I am a Mother, Eternal Student and Sustainability & HSE practitioner. Considerate of all things participatory and kind to people & planet.",0,0,1,0,1,300
4709304387,keaton_sa,"Neuroengineer, developer, musician.",0,0,1,0,1,300
1261617626,TheGrandBlooms,complex systems & nonsense,0,1,2,0,3,300
1085095613073580032,contactSGK,"Entrepreneur, Complexity Theory enthusiast, Wicked Problems, curious about modelling social evolution and decision making with AI + Big Data",1,0,2,0,3,300
13124412,GuofengCao,"GIS professor at Texas Tech, @ttugis, geographer with a geek mind, data scientist/statistician, software engineer.",0,0,0,1,1,228
991721847271100416,RamRamanathan4,"Chief Scientist at @goTenna. Mobile wireless mesh networks, network algorithms & analysis, graph theory, network science.",0,0,0,1,1,26
566657203,ke_marsh23,Epidemiologist | Translational Researcher | Data Scientist,0,0,0,1,1,27
1051573353465749506,mugugaipen,phdstudent@sabanci,0,1,0,0,1,64
951349231134093313,minimaxx_io,"Tree finker.
here to learn, connect & procrastinate.
¯\_(ツ)_/¯¯\_(ツ)_/¯
¯\_(ツ)_/¯¯\_(ツ)_/¯¯\_(ツ)_/¯¯\_(ツ)_/¯¯\_(ツ)_/¯ &",1,0,0,0,1,300
1083339724750835714,TBen_Yassine,"From Casablanca, Morocco - living in London.
My days are usually spent around Classical music, Machine Learning, Neuroscience, or Literature.",0,0,0,1,1,81
88125472,ErnestZambrano,Doctor en Control y Sistemas Dinámicos,0,0,0,1,1,300
285821128,Indecosys,Cloud based industry ecosystems ( iEcosystems™) that facilitate self-organising trading partners to co-create optimal value in sustainable environments,1,0,2,0,3,300
143051205,vbehzadan,I earn my living by exploring and writing about existential threats and vulnerabilities. Assistant prof of CS and Data Science at @unewhaven .,0,0,1,0,1,300
58025800,Granjel,"Researcher, doing my PhD at @unisevilla & @LabMessy | #FPU2016 | Species coexistence, ecological networks, community ecology 🌱🌾🌼🐌🦗🐝 + 🌊🐚🐟🦀 | #galego",0,0,1,2,3,300
846368911,conways_law,Access to tools. Radical simplification. Systems thinking applied to human activity.,0,0,1,0,1,300
1045254783324418048,artisoc_,"株式会社構造計画研究所（KKE）マルチエージェントシミュレータartisocのtwitterアカウントです。社会シミュレーション, 複雑系等に関連する情報を発信します。/ An account of artisoc, Multi-Agent simulator by KKE Inc.",0,0,1,0,1,171
3060431662,jaarciniegasb,,1,0,0,0,1,167
3303634571,i_cant_adult,"teller of truths, purveyor of sarcasm and wit, tattooed mommy of two, gardener extraordinaire, local food enthusiast, keeper of schedules, finder of lost things",0,1,0,0,1,87
920708679892168705,Social_Philix,,1,0,0,0,1,13
1036304237666492416,DanielRemondin1,"In God we trust, all others must bring data!",0,0,1,0,1,94
3058654835,PaulineEzanno,"scientist @Inra_France @inra_sa @bioepar_dynamo, epidemiology, modelling, population dynamics",1,1,0,1,3,300
3394729193,leandroagudeloz,"Research Scientist @MIT @MIT_CSAIL
| Computational Biology | Machine Learning |
agudelo@mit.edu",0,0,0,1,1,109
888948163058425858,MRLINAY,,1,0,0,0,1,75
2864356347,hcinst,Human Computation Institute is a non-profit innovation center that advances the science of scalable crowd-power to tackle wicked societal problems.,0,0,1,0,1,300
3981933203,bettermeasured,"Data scientist 👩🏻‍💻  I crunch numbers in R, create #maps & #dataviz, answer data-questions and tell data-stories about #arts #culture #ngo #CSR #governance",0,0,1,1,2,300
1384195608,ChiTownCopper,"Personal Page - Thoughts, opinions, & strategies are not intended to represent or speak on behalf of the Chicago Police Dept, its policies, or its strategies.",1,0,0,0,1,300
48015304,IranianITcrowd,"Just a Naïve P cell navigating its way to maturity, in this mad complex world, by (PhD in) deeply learning the mysteries, and features of the immune repertoires",0,0,1,0,1,300
86742721,innovaterashish,A THINKER,0,0,1,0,1,300
1056954853912690688,memet_memetat,,0,0,1,0,1,1
4741976232,MatthewWSiu,"Currently exploring: Cognitive science, tools for thought, collective intelligence, urban planning, history of complex societies",0,0,1,0,1,300
26594288,quantummoose,"Psych researcher studying motivation, decisions, and learning. Leftist. he/him",0,0,0,1,1,300
262088479,kramsivrup,"Science, publishing, open access, cycling, snow, rivers & fish. Views my own.",0,0,1,2,3,300
66386770,filipbabovic,"I think about risk and uncertainty of all kinds. Now in the private sector. 
Crate Digging. Traveling. Many other verbs as well.",0,0,1,0,1,300
2797217540,RustedOak,,0,0,3,0,3,300
963430560000630784,IntJnlCompMaths,IJCM and IJCM:CST are world-leading journals publishing research in numerical analysis and scientific computing from academia to industry.,0,0,1,0,1,259
905697709524377600,raamnaathn,"I often drop myself deep into the Pacific.
Sometimes I build new islands, most of the times I swim in sleep.
ML @ SBI Tokyo.
@NUSComputing & @join_ef alum.",1,0,0,0,1,44
478389969,GillesKratzer,Biostatistician in nutritional clinical trial  #rstats #vetMed #epidemiology. 🎓alumni @epfl & @uzh,1,0,0,0,1,300
15580340,jorgevallejos,"Current focus: Ecosystem design. I enjoy learning, brainstorming, thinking about the big picture, reinventing myself and my community. #strategy",0,0,1,0,1,300
771410156148051968,AroRhythm,"No, I'm not complicated, 'I'm just a whole lot of different simple people': @octopia_ || Biological anthropologist",1,0,0,0,1,136
1108831704,alikadircan,Businessman. Fan of MKA-1881-1938,0,0,1,0,1,300
436233965,Fer_Plascencia,Network Theory-Behavioral Economics (Cornell University),4,0,2,0,6,300
942946407396364295,LandbaseVenture,"We facilitate the rebuilding of communities that maintain the connections between people, knowledge, and place necessary for adapting to a changing world.",0,0,1,0,1,281
1044538625382395904,ojscholten,PhD Student @UniOfYork  🇬🇧 Decentralised Gambling researcher. Aspiring professor.,0,0,3,0,3,172
1043889390748139526,CelestinCoquide,French Phd student in physics and complex systems studies,0,0,1,0,1,58
14409745,maponi,"I learn and teach information technology. 
“Walk criss-cross over the landscape” 
 (Wittgenstein).",1,0,0,0,1,300
892026178864893952,stroebel_econ,Professor of Finance at NYU Stern,2,0,0,0,2,211
622184929,ampanmdagaba,"Assistant prof @BardCollege. 🦄 Networks, neurons, data, AI, complexity, beauty, platonic forms

For art, magik, and random photos, see my alt: @mostaleoht",0,0,0,1,1,300
849489168958976000,Master_2_BDIA,Formation Master Informatique - parcours Bases de Données Intelligence Artificielle : Data Mining - Décisionnel - NoSQL - Data Science - JEE - Hadoop,1,0,0,0,1,147
229658775,_NeilC_,🇮🇪 S&C Coach 🏋️‍♂️| Sport Scientist 📊 | PhD Candidate @Leedsbeckett #rstats,0,0,1,0,1,300
968586868928507904,Tutkaileva,Economist knows the price of everything and the value of nothing,0,0,1,0,1,300
45358126,eshmelabraham,PhD in Complex Systems and Public Health. A complex systems scientist at Exeter University,0,0,2,0,2,28
2980822037,VerusLoo,,1,0,0,0,1,300
1032842968703483905,DougMonroe10,,0,0,1,0,1,300
2586541148,keschh,"Biomedical Engineering Ph.D.
 
University of Washington. 
 
Neuro/Computer Science.",0,0,0,1,1,142
713389493076758528,xbresson,"Prof of #ComputerScience @NTUsg. Interested in #DeepLearning, #GraphNNs, #AI, #research, #teaching, #innovation, #advisory. Opinions my own",0,0,1,0,1,300
14686896,OscarAVas,Love science applied in contemporary problems. Follower of game theory and social network analysis,1,0,0,0,1,300
723657183846666241,gppcarleo,"Quantum Physicist (@FlatironInst @FlatironCCQ) with a computational heart. Machine learning for quantum, QMC, and other beasts. Developer of NetKet @NetKetOrg.",0,1,0,0,1,300
546921239,RuthAhnert,"Literary history meets data science. PI on @LivingwMachines, Co-I on @networkingarchives, co-editor of Stanford Text Technologies book series.",1,0,0,0,1,300
1030866847380500480,JoseJSerranoMo1,"Biologist, Master in Cellular and Molecular Biology, Complex Systems Research and PhD student at https://t.co/H88tLdQx2x",1,0,0,0,1,140
498208195,erikwetter,"Undisciplinary economist. Applying large quantities of data and caffeine to global risks and opportunities. Cofounder @Flowminder, faculty @Handels_SSE",1,0,0,0,1,300
843015379983257601,re_milos,"PhD in Political Science from @ceu.
I do research on #politicalbusinessnetworks #statecapture
#rstats #networkanalysis #datavisualizations for work & pleasure",1,0,0,0,1,201
435221803,michellebirkett,Prof @NorthwesternU & @ISGMH | Director @CONNECT_ISGMH | PI @NetworkCanvas | @NewVoicesNASEM Cohort | Complex Systems and Health Disparities🌈🤱🏽,0,0,0,1,1,300
703004177732124672,albertodela80,Senior Consultant and Graph Database expert. Neo4j certified professional,0,0,0,1,1,300
2164789710,matiasarim,"Ecologo, CURE-UdelaR. Estructura y funcionamiento de la diversidad biológica. Ecology-Structure and function of biodiversity",0,1,1,0,2,300
1025221888371511297,LC_Ribas,Phd Candidate and Researcher at ICMC/USP,0,2,0,0,2,64
52210899,outecran,,1,0,0,0,1,300
2743849049,Christoph_hed,Labour/Macroeconomist working at Uppsala University.,0,0,1,0,1,62
112241368,DiogoAMCoutinho,"⚽️ Assistant Coach in Professional Football
⚽️ PhD in Sports Science - performance analysis, task constraints and Small-sided games in association football",0,0,1,0,1,285
1012821658460180483,vatsalecon,DPhil (PhD) in Economics candidate @UniofOxford. Interested in development economics and social/economic networks. Teaching @PembrokeOxford.,0,0,2,1,3,171
580863891,MJFKlewitz,"busy dad | passion for software architecture https://t.co/kuQr90lQYH | following all things economics, politics | not short on humor | RT, ❤️ no endorsement",0,0,2,0,2,300
16002258,ponies,"Steadfast paradise engineer & 2nd order environmental cyberneticist. Loves Bug, 311, Drupal, complexity, epistemology, social physics, and Faustian parenting.",0,0,1,0,1,300
67525148,eduardo_tachi,,0,0,1,0,1,43
44841757,michaelporcelli,,0,0,1,0,1,300
4226832557,LiamDFitz,"PhD researcher | Avian malaria in the Galápagos islands | @ZSLScience & @QM_SBCS & @London_NERC_DTP |
#wildlifedisease | 
https://t.co/FRXTazZQWK…",1,0,0,0,1,300
190502721,NUPoliSci,"News, events, and updates from the Department of Political Science at Northeastern University",2,0,0,0,2,300
1725407928,B_V_Goncalves,"🇵🇹 Department of Sport and Health, Universidade de Évora, Portugal
🧠 Research on collective behavior in team sports",0,0,0,1,1,300
3520032275,DavisBTURBAN123,,0,0,0,1,1,22
320691712,urheterotopia,Urban Designer :: Architect :: Researcher :: Academic :: Scientist • Urban Design Group @FosterPartners | VLecturer @BartlettUCL •  Views my own.,0,0,1,0,1,300
888809680939737090,rezafuturist,PhD in Industrial and Systems Engineering,0,0,1,0,1,43
24391851,kimberlyglasgow,,1,0,0,0,1,300
880773327857561600,ResponsiveOrgFI,"#OpenCollaboration for Teams & Organizations @OKFFI. We're an Open, Learning network seeks to regenerate work that can embrace #Complexity, #Humanity & #Tech.",1,0,0,0,1,300
563291636,JonMQuigley,"Author & contributor many books, speaker, award winning, product development expert & teacher. BS, MBA, MScPM degrees, IP generator, bass player. ENTP",0,0,1,0,1,300
282543610,abstractalgo,"Computation, complexity, AGI, qualia. Ex 3d gfx. Indie hacker.",0,2,0,0,2,300
4729883418,datamapio,"Ask what is necessary. Do it.

Mobility & Climate Crisis & Democracy 
Maps, Apps, Data, AI, Visualization


Incorporated as Datamap AG in Zurich, CH",0,0,0,1,1,300
4811110415,juliankh,"PhD student in physics at Harvard. Deep learning, complex systems, evolutionary dynamics",0,0,1,0,1,2
2938508568,MarxawithanX,"Rites of Passage. Transformation. SPU. I/O Psychology. Culture, Structure, Nature. Differentiation. Humanity. Complex Adaptive Systems. IPE. Global Governance.",0,0,2,0,2,300
471302049,JPNuggets,IT & Innovation Researcher,0,1,0,0,1,300
263150177,pfleurance,Vice-Président du Réseau Intelligence de la Complexité - Membre fondateur et administrateur de Welcome Complexity,0,0,2,0,2,254
999683313873833985,geekbiology,"Biology, informatics and science in general.
Personal: @hachepunto",0,1,0,1,2,295
3311882199,e_sotog,Postdoctoral researcher at @Yale. Pew Latin American fellow class 2017.,0,1,0,1,2,300
94272118,sobadapple,,1,0,0,0,1,189
41846608,CollaborateKing,Inspiring a Better Way to Work.  #futureofwork #facilitation First Fortune 100 Chief Collaboration Officer. Partner @theDiff_erence & https://t.co/kUY1sE2ySY,0,0,0,1,1,300
440244080,G__Paternoster,"DVM, enthusiastic epidemiologist. European, Italian nationality, based in Switzerland and working also in Kyrgyzstan. Curious.",0,0,1,0,1,300
942965125325213697,teammagnify,Engage your community. Reach your goals.,1,0,0,0,1,300
370640384,MaciekLaskus,I'm interested in how we can use technology to build a better society. Drone @hivedotone.,1,0,0,0,1,300
22399655,kanair,"We are hiring AI engineers and neuroscientists! 
Founder and CEO of Araya, Inc.  
Previously Sussex, UCL, Caltech, Utrecht. 
My CV: https://t.co/QLIUiQcNwl",0,0,1,0,1,300
319146897,MattCarella,"I help companies making business in uncertainty. Interested in #complexity, #cynefin, retrogaming & cyberpunk 📷. Still coevolving with 🌎 in a non-linear way.",1,0,0,0,1,300
2802528598,piquergaming,tabletop | boardgaming | design,0,0,1,0,1,300
34097298,ahmad_saeed,"Making networks more predicable and end hosts more scalable. 
Postdoc @MIT_CSAIL, Ph.D @GeorgiaTech, Husband, Father, Egyptian, Human (he/him)",0,0,1,0,1,300
948906165760557056,el_chatz,Quantum and multiple state device physics simulations #densityfunctionalltheory #multiscale #quantumtransport,0,0,1,0,1,223
730077456,baquast,"Economist @ITU | author of ""rnn"" machine learning framwork | working on AI for Good Global Summit & FG AI 4 Health | tweets my own",0,0,1,0,1,300
86095578,nvijayakumar,"Data nerd, coffee addict, social media/technology junkie, fan of useless information, bad tennis player.",1,0,0,0,1,300
39041291,kimrisson,"Design  |  Strategy  |  Data 
Focus on Innovative Tech, Cyber Security, Sport, Health, Privacy & Human Rights.  RT ≠ endorse",1,0,0,0,1,300
132180003,herrera_h,"You know, I’m something of a scientist myself - Flower and fruit development - Protein interaction networks",0,0,0,1,1,300
1113661,hectorzenil,Head of Lab / Assistant Professor / Senior Researcher,0,0,1,0,1,291
476770021,itbint,,0,1,0,0,1,300
847416985235234818,digio_marco,"PhD student at Politecnico di Milano
Data science, machine learning",1,0,0,0,1,6
18503614,davidsarac,"complexity, agency & meaning

""Theory of evolution points to the conclusion that becoming, not being, is the essence of reality""",0,0,1,0,1,300
940718051607105536,ntligntmachines,"Understanding and designing better complex systems || interdisciplinary approaches to business, technology, and the sciences.",1,0,2,0,3,114
954437206114013187,staircasetwit1,"phd student in cognitive science, relational realism, complex systems, language, university of cincinnati",0,0,1,0,1,12
3230028128,Galaktronix,Проектирование и строительство галактических сетей.,1,0,0,0,1,300
386847521,michaelmersky,"Digital artist/designer interested in visualization, computational creativity, complexity, & generative patterns",0,0,1,0,1,93
4082502557,InvariantChaos,#ChaosDuJour #Emergent #Complexity #Nonlinear #Feedback #Chaos #Fractals #SelfOrganizedCriticality #DynamicStructures #AutoCatalytic #ChaosCtrl @ #Invariants,0,0,1,0,1,300
3317444885,deustoDBSHealth,"Unidad de conocimiento e innovación en transformación sanitaria y su implementación. @deustoDBS - Universidad de @Deusto

https://t.co/tP5t3Uw6Y8",0,0,1,0,1,300
1230746966,AdamPloszaj,"Regional & local development, STS, R&D policy, public policy design and evaluation +++ Assistant Professor at EUROREG, University of Warsaw",2,0,0,0,2,300
25260852,cboete,"Willing to connect scientists and the public(s) on biotechnology, development and health issues. @isemevol @ird_fr also @biodivhealth",1,0,0,0,1,300
21689003,dankenney_,Strategy @ EY | Curious,1,0,0,0,1,300
928992056046956544,ComplexityLabUU,The Complexity Lab Utrecht (CLUe) is a hub for interdisciplinary learning and collaboration. We provide training and access to the latest complexity software.,0,0,2,2,4,33
838901889785872385,yveszenou1,Professor of Economics,1,0,0,0,1,300
509585562,Liz90588695,Bored physicist. Thrust into depths of data science and machine learning.,1,0,0,0,1,300
886081,LaBlogga,"The brain as a DAC, Human Brain/Cloud Interface. philosopher, futurist, entrepreneur, trader, traveler. blockchain, machine learning, quantum computing, synbio",1,0,0,0,1,300
2842524831,AliceWi11iams,"Archaeologist, can re-run you some of the past in computer simulations, currently researching the evolution of social complexity, PhD with @amesoudi, she/her",1,0,0,0,1,209
324185417,RRUExecEd,"RRU's Professional & Continuing Studies offers Graduate Certificates, Executive Development, Contract Training, Custom Programming & Professional Accreditation",0,0,1,0,1,300
753497077431369728,cl_murall,"post-doctoral researcher 🇨🇦 studying the ecology, evolution, and epidemiology of infectious diseases",0,0,1,1,2,300
935138553826283522,Anwarul99215286,,1,0,0,0,1,13
1648637414,jacopo_h,"Data Visualisation, Python, Machine Learning",1,0,0,0,1,300
356006641,suchanaseth,Data Scientist | Fellow @BKCHarvard | Open Web Fellow @mozilla @FordFoundation @datasociety alum | Responsible machine learning. Ethical AI. Data for good.,1,0,0,0,1,156
3500154688,filip_daniels,Value Networks Activist & Metadesigner @shiftNGroup | Research Coordinator & Lecturer @HowestNE | Lecturer @LUCASchoolofArt | ♡ pluralist poiesis of Life,1,0,0,0,1,196
735808449313943553,JHN_RGRS,,0,0,0,1,1,96
27907808,SethSrcho,Buzz Lightyear doppelgänger | Nerd | Gay af 🏳️‍🌈 | Persian,1,0,0,0,1,300
3018045583,StarJo87,Ph.D candidate in Statistical physics,0,1,1,0,2,187
859834012378030080,strictlynofun,"PhD candidate studying technological and social networks, interested in decentralized multi-agent cooperation among other things. Currently in Florida :(",1,0,0,0,1,48
546765150,alexpluchino,,1,0,2,0,3,165
403557868,ksadorf,Researcher at CAMS/ISC-PIF (Paris). Also a convinced Mozillian. Working on https://t.co/Mxy1uJ4ZtA,2,0,0,1,3,300
553975651,ZeeCares,"Never Grow Up & Don‘t Try

https://t.co/vlXP7e8kd3",1,0,0,0,1,300
8681442,dmartins,"Professor na Universidade de Brasília, Faculdade de Ciência da Informação. Pesquisador nos temas  #redes #culturadigital #acervos #websemântica #LinkedOpenData",0,0,0,1,1,300
2830882190,agjohnss,,0,0,1,0,1,22
1365455960,tyl3rfoxworthy,CEO Vertex Intelligence. Mathematician. Data Scientist.  Investor.,0,0,0,3,3,300
2849976573,TrevorWilson_WA,,1,0,0,0,1,300
768534203537424384,Data_Plus_More,Building impactful models. Impact & Evaluation Manager @MSsocietyuk. Trustee @BeKindMovement1 & Sch Governor. Data 4 change. Colombian but not salsa. Own views.,0,0,1,0,1,300
790488390361907200,RENOIRprojectEU,#H2020 MSCA-RISE Project RENOIR (Reverse EngiNeering of sOcial Information pRocessing). More at https://t.co/kYFqKfSEFm / #RenoirProject,1,0,0,0,1,120
43807186,brekw22,CTO-AmbreHealth,0,1,2,0,3,246
315880590,ChonteMerengue,Estudiante de Estadistica. Fanatico de la U,0,0,1,0,1,300
2548748646,tm_grd,"Assistant Professor at @SI_Copenhagen of @CBScph. Interested in crowds, contests and innovation. PhD from @wu_vienna.",0,1,0,1,2,113
838503512178851842,SaabSolangi,,2,0,0,0,2,9
847902143428341760,bhorvathb,,0,0,1,0,1,192
48348971,atafti,"Associate Professor of Information & Decision Sciences at the University of Illinois at Chicago.   I like information technology, economics, and science.",2,0,0,1,3,300
1069960399,jdwittenauer,"Data scientist, engineer, author, investor, entrepreneur",0,0,1,0,1,206
855006342339317760,_AliceWittig,,0,0,1,0,1,9
14952948,deadvoid,"intersections
subtexts
hubris

Founder of TaaS (Think-as-a-Service) & Brainless architecture.",0,0,1,0,1,300
3891623673,margueritenyhan,"Lecturer in Engineering @UCC & Visiting Scientist @Harvard/ Via United Nations @UN, @Harvard & @MIT/ Environmental Engineering, Cities & Health / Also🎹",1,0,0,0,1,300
64591635,tehmata,informasi demi inspirasi untuk inovasi dan demokrasi.,1,0,0,0,1,279
240397452,rpachilova,"Architect | Doctoral researcher @UCL PhD topic: hospital wards, social networks and quality of care",5,0,0,0,5,300
838535406140407808,Andrew_Tolston,,1,0,0,0,1,7
175814629,markedwards999,"Family man, aspiring mountaineer (I see you Sagarmatha), consultant surgeon (vascular / trauma), PhD candidate (safety / complexity), opinions never others’.",0,0,1,0,1,300
2891372218,shaarad_sharma,"Double Masters in Public Policy & Admin. Passion for social, public and tech innovation in international development. Views Own.",0,0,1,0,1,160
4874223802,frankjmcdonnell,"Career Guidance counsellor, educational  adviser and  Life Coach. Member of the Institute of Guidance Counsellors",0,0,1,0,1,300
831966756277153793,WaterDoc3,Nelson is a Doctoral student at Royal Roads University.  Mitacs Accelerate researcher and CITI BC research fellow.,1,0,0,0,1,104
2938546498,mario__lavezzi,"Economist, University of Palermo. Economic development, organized crime, social networks, smuggling. Random thoughts on all the rest. RT != endorsement.",1,0,0,0,1,300
828425787208515585,AllyChen19,,1,0,0,0,1,12
735532063546302464,ckathartic,on the fringe,1,0,0,0,1,10
172491059,danmgarza,,1,0,0,0,1,300
828312579311276033,ianmok_stern,,1,0,0,0,1,7
1628042641,sandrajchang,New York University Undergrad Business Student,1,0,0,0,1,53
827238112661237760,DanFAnsari,,1,0,0,0,1,8
827962333511155714,sc4212,,1,0,0,0,1,8
827945991877881856,jl6225,,1,0,0,0,1,10
203159324,daguptaman,"NYU Stern // Finance, Data Science, and Latin // Innovation & Entrepreneurship

Eppur si muove",1,0,0,0,1,24
293669871,DylanQian,snow addict. going through summer withdrawl.,1,0,0,0,1,38
483334108,sasakitwien,https://t.co/uku56uOpk3,1,0,1,0,2,300
742756656614891520,acandee,Notre Dame MBA candidate,0,1,1,0,2,300
1575310278,MihailaBianca,,2,0,0,0,2,37
333612842,David_Clough1,"Assistant Prof, UBC Sauder School of Business. Research on technology, organizations, entrepreneurship. Blogs on strategy and technology at Change My Worldview",2,0,0,0,2,300
14072086,elifkus,Yazılımcı. Hatta @kadinyazilimci . Bilişsel Bilimsever. / Software Engineer. Blogs at @kadinyazilimci . Cognitive Science Enthusiast.,0,0,1,0,1,300
2343077714,YutingLiao1991,"PhD candidate in Information Studies (HCI-focus). Research on trust, privacy and information disclosure in various sociotechnical context.",0,0,0,1,1,29
80397593,sheejamk,,1,0,0,0,1,225
794962790037549059,DjGhilani,Data Analyst & PhD in Social Psychology - Especially interested in how we view the past and how we use it in political decision making,2,0,0,0,2,300
4455521243,fmri_news,,0,1,0,0,1,300
34966843,DrAhmedAHamed,Assistant Professor of Data Science & Analytics@ Norwich University. Proudly listed among FastCompany Most Creative People'2016. I follow back!,1,0,0,0,1,300
4406699183,Bryony_E_Allen,@ACCE_DTP PhD student based at @livuniIIB & @ZSLScience | Behavioural drivers behind the disease dynamics of the amphibian-Bd system 🐸,1,0,0,0,1,211
2214400743,yangliubeijing,"@publichealthumn | @ColumbiaCS | @williamandmary | Ph.D. in EnHS, research fellow @LSHTM @cmmid_lshtm on spatial things, #vaccines and #infectiousdiseases.",1,0,0,0,1,300
716291669814079488,philippschw,"Working on machine learning stuff. Currently @Capgemini Invent, before @TU Delft",1,0,0,0,1,100
2866489102,storybench,Exploring the future of digital and data storytelling from @NUjournalism • Editor @aleszubajak • Managing Editor @NickStoico • Social Editor @MariaSilviaAT,0,0,0,1,1,300
83597642,Antaresblog,Regional and urban development. Applied economic analysis. Tailored data solutions. Territorio e sviluppo. Dati e strategie,1,0,0,0,1,300
920434452,eikrid123,"father of boys, sometimes repeat my father and wonder why, speak german, run, making a difference",0,0,1,0,1,300
1304339504,AvaZydor,,1,0,0,0,1,300
317979646,SarahCherng,"Grilled cheese and pillow connoisseur, aspiring rock climber, data scientist and computational modeler, recovering academic that still dabbles #ForeverGoBlue",0,0,2,0,2,300
2860855715,signorelli82,Freelance journalist (tech & politics) / @LaStampa @wireditalia @ilTascabile @esquireitalia varie ed eventuali,1,0,0,0,1,300
4416082163,RobinNThompson,Junior Research Fellow in Mathematical Epidemiology,1,0,0,0,1,282
1044248377,neuralmodels,Neuroscientist,1,0,0,0,1,300
2273302478,FNALab,The first #graph #analytics #platform for #finance,0,0,1,0,1,300
14561628,nicolascine,"Entusiasta de la imagen, Internet y los datos.",0,0,0,1,1,200
2561773646,ThomasVicino,"Professor @NUPoliSci @NU_PolicySchool Associate Dean of @NUCSSH @Northeastern, @univmiami alumnus, Fulbrighter, Brazilianist, Author, and Global Urbanist.",1,0,0,2,3,300
1377476875,comelluc,L’oggi è presto detto: manager e autore di saggi. Il domani è un paio di sogni: una startup e un romanzo. Il primo sogno ora è realtà: founder @thewinefathers,0,0,0,1,1,300
4850179229,BCOERCC,Unofficial account for the KSU College of Education Research Consortium & community of researchers. Curated by @olgakoz1,1,0,0,0,1,300
768707918,_paigebmiller,"PhD student in disease ecology at University of Georgia | when not thinking about programming and diseases, probably talking about 🏐🏃🏼‍♀️❄️(MN) | she/her",0,0,1,0,1,203
4184845709,MohamedDeaif,"Ceo & founder, Entrepreneur Consultant,Trainer, coach , Sociologist, #SocialNetwork, #Consulting, #Coaching, #management #Leadership, #healthcare, #publicpolicy",1,0,0,0,1,300
4850143819,APS_CLARE,The twitter account of the American Phytopathological Society Crop Loss and Risk Evaluation Committee.,0,1,0,0,1,300
496940818,kamitigris,"composer, electronic and spatial music ۰ https://t.co/hL1DiucC0M ۰ @RBMA 2016 ۰ Radioshow for classical music @TheLotRadio ۰",1,0,0,0,1,300
393352440,RobAckland,Economics/network science/social science of the Internet. Prof at Australian National University. CEO/Founder of @uberlink. Creator of VOSON software.,3,0,0,1,4,300
58018436,trippingly,"Learning by teaching https://t.co/0kFfy2Etyw
Practicing at https://t.co/gFuihlIK5A",0,0,1,0,1,300
2679687798,EPournaras,"Associate Professor, School of Computing, University of Leeds",1,0,0,0,1,199
57418003,wild_boar,,1,0,0,0,1,300
334314667,MarcoLamieri,,0,0,0,1,1,68
173422786,rakeshvijay,,0,0,2,0,2,174
4926201017,SeanLaFontane,,1,0,0,0,1,12
4924257309,moremaur383,,1,0,0,0,1,12
4847595671,mlouie358,,2,0,0,0,2,16
4920702100,jsomboonsong,NYU Shanghai '17  #marketing #bigdata #digital and #analytics gal in the making,1,0,0,0,1,24
227524663,caroline_stf,"Blogger behind When & Wear // NYU Stern // A passion for digital marketing, Shonda Thursdays, and Patriots Football // https://t.co/BtE95rKkEb",1,0,0,0,1,300
300750857,AFilisetti,"DOULIX head of the ICT and computational biology

EXPLORA BIOTECH senior scientist - Systems and Synthetic Biology",0,0,0,1,1,300
4910545114,kriley477,,1,0,0,0,1,10
3003825903,Sparkism_,"Research organisation on Impact of #innovation, #startup & #technology. #BigData sentiment analysis on #trendonomica #AI",3,0,0,0,3,300
538938280,JVRoss_UoA,Professor@Adelaide with interests in mathematical and statistical modelling of biological systems,1,0,0,0,1,300
2771005646,OsondeOsoba,"Researcher at @RANDCorporation. Expertise in machine learning, AI, & statistics; Professor; Capoeirista. Opinions mine, RTs ≠ endorsements",0,0,1,0,1,135
606596335,CriticalCortex,"interested in computers and brains, data and networks",0,0,0,1,1,300
2826359918,pdick10,"Sometime civil servant, public health. Too many interests, too many unread books: history of art, complex systems, various areas of science & public policy.",0,0,1,0,1,300
320629396,hadihafizi,"Data Scientist, strong advocate of #OpenScience #OpenSource",0,1,0,0,1,205
115616368,rhophi1,"Mostly (re)tweets on Physics, Literature, Classical and Jazz music.",0,1,0,0,1,300
38217933,trekkinglemon,"Educator, scientist. Dad+++. I dig data and tweet about autism awareness. Opinions my own.",1,0,0,0,1,300
2897180373,BNPasquarelli,PhD in Sport Science - Strength and Conditioning Coach at Santos FC - Sport Scientist - Coach Developer,1,0,0,0,1,300
22183845,john_atki,"Independent thought and finely honed prejudice on leadership, living systems and change in global and national organisations https://t.co/rNyxJaDsyI",0,0,1,0,1,300
161460697,RReyesLevalle,,1,1,0,0,2,300
398963620,drghirlanda,Learning and cultural evolution,1,0,0,0,1,300
2442716719,AkninP,"Scientific Director. IRT SystemX. Researcher in machine learning, diagnosis and transport. The views expressed in my tweets are mine alone.",0,1,0,0,1,300
3418470254,NDExProject,"Developed @UCSanDiego, NDEx is an open source software infrastructure to store, share and publish biological network knowledge",0,1,0,0,1,300
1913628018,mmvazifeh,"Head of AI & cofounder @AdaVivInc (Cambridge, MA), cofounder @findmyfind (Vancouver, BC), Past: Research Scientist @Amazon - @MIT
Quantum Physics, PhD @UBC",0,0,0,1,1,173
3037027040,ISSSMeeting,"The International Society for the System Sciences. Official Conference News. #ISSS2020, #patterns, #systemsliteracy, #nature, #systemsthinking, #systemsscience",1,0,1,0,2,300
2887864310,voinopoa,"Conservation Biology, Agent based modeling, Geographic Information Systems, Ornithology, Botany, Landscapes, Forests, Habitat change&fragmentation, Volunteering",0,0,1,0,1,215
16105655,furranko,exploring the scientific #egosystem,0,1,1,1,3,300
503750448,mgh_cio,"CIO for Mass General Hospital and Physician Organization...former Military Officer, and long-time Patriots fan",0,0,0,1,1,126
187672633,valerioperimad,PhD student @ ETH Zürich.,0,1,0,0,1,300
3283674812,ginapolo11,Emigrant.... Immigrant,1,0,0,0,1,230
314464118,davidkorowicz,Physicist & human systems ecologist: complex systems; global systemic & catastrophic risk; preparedness & resilience.,0,0,3,0,3,300
400716186,FabioBorsoi,,1,0,0,0,1,300
2290246057,MalloryNobles,Machine Learning & Public Policy Researcher @MITLL | @CarnegieMellon @HeinzCollege @DavidsonCollege alum | #scicomm enthusiast | opinions my own,1,0,0,0,1,121
1127655182,facells,"#datascientist, #CTO, PhD @cimec_unitrento in personality computing",1,0,0,0,1,300
421025395,FrensisBras,"Researcher for the Sustainable Development Goals at ONS. Tweets and comments are my own, not endorsements.  Interested in #inequalities #environment and #stats.",1,0,0,0,1,300
3278914264,briansocintel,"WE IDENTIFY OPPORTUNITIES, BUILD COMPANIES AND SUPPORT THEM TO GROW AND SCALE.",2,0,0,2,4,52
291891944,yagmur_erten,"phd student in evolutionary biology @UZH_science & @uzh_evolution | life history evolution, cancer, cultural evolution | alumna of @MEME_evobio | she/her",2,0,0,0,2,300
2826530741,OPGunther,Data science consultant and owner of Gunther Analytics,1,0,1,1,3,269
1533257304,sociomine,Sociomine is the Social Media Analytics Research Center of the Athens University of Economics and Business (AUEB).,1,0,0,0,1,35
52357408,iterater,"Researcher at eScience Research Institute, @spbifmo_en",1,1,0,0,2,188
3094754813,ComplexSSport,Complex Systems in Sport Research Group.,0,1,0,0,1,300
18078446,rjholladay,I believe in Human Systems Dynamics and Adaptive Action--complexity made simple! My tweets are my own views.,0,0,1,0,1,300
60538824,sergio_cima,Sniffer,0,0,1,0,1,300
1260562644,SVCollaboratory,"Silicon Valley Collaboratory guides Sharing Economy Ventures from Concept thru Series-A Funding, until Self-Sufficiency",0,0,2,0,2,173
3026000440,cw1636,,1,0,0,0,1,19
1898212297,Winter_Ting,,1,0,0,0,1,19
3025871735,yotoch,,1,0,0,0,1,14
3020307292,Emazzino,,1,0,0,0,1,35
2997766236,Sancheev_R,,1,0,0,0,1,9
574249952,ridicholasnick,,2,0,0,0,2,38
1136042827,comokiwi,,1,0,0,0,1,30
3018464014,clopilato2681,,2,0,0,0,2,17
2372023290,gstmartinNU,Senior Editor. news@Northeastern. Northeastern University's Office of Marketing and Communications.,1,1,0,0,2,300
45849641,Commetric,Award-winning #MediaAnalytics for the world's biggest #brands. #InfluencerMarketing|#SocialMedia |#BrandManagement|#PR|#ContentMarketing|#MoreWithAnalytics,2,0,0,0,2,300
804411457,tothbalintjeno,Data mining & network science enthusiast,0,0,0,1,1,4
240723622,jouilis,"R&D Architect, Ph.D Computer Science. topics: data mining, big data, graph theory, machine learning, pattern recognition, http://t.co/Hj2Idaxn",1,0,0,0,1,293
19962647,Mozzcovite,"Experienced international PR / marketing agency mgr, President @SpeysideGroup, Director @Gigplug",0,0,0,1,1,300
2872444685,USI_SoNAR_C,USI Social Network Analysis Research Center,2,0,0,0,2,26
145732738,martin_garcia_a,"SM Management MIT. MEng UC. Head of Division, Social Evaluation Undersecretariat. Assistant Professor, System Dynamics. Tweets are my own.",1,1,1,1,4,219
297684594,GeoffJacquez,"President of BioMedware, researcher, and scholarship focused on geohealth. #spacestat #clusterseer #boundaryseer",1,0,0,0,1,300
56341595,markus23k,,0,0,2,0,2,206
905207737,ThePangeon,A nexus between Language Culture and Design,0,0,1,0,1,300
2308984998,e_borer,"ecologist working on disease, communities, insects, trophic interactions. science is fun. (re)tweeting politics since Jan 2017, too.",0,0,1,0,1,300
236551986,natasagolo,,0,1,2,0,3,87
2720163620,krupplucas,"Real Estate Private Equity, TECH, BIG DATA & SMART CITIES @ PartnersGroup",1,0,0,0,1,177
2709279138,IU_DataScience,Data Science at Indiana University,1,1,0,0,2,300
2533018663,SMResearchChat,"#SMResearchChat is a weekly Twitter Chat @ 8PM EST/5 PST about all things #SocialMedia research related.  An opportunity to host research, researchers & trends.",1,0,0,0,1,148
475998389,boggioa,,0,0,1,0,1,300
70533273,dfazito,,1,0,0,0,1,300
521913963,riccardocampar1,In Twitter only words count. 1 2 3. I'm a word,1,0,0,0,1,300
451294841,matterossini,quelo da san Zenon,1,0,0,0,1,300
60900158,ondergurcan,"PhD. in #ArtificialIntelligence. Working on open #interdisciplinary problems related to #MultiAgentSystems. #Trilingual tweets (#Turkish, #English, #French).",0,0,1,1,2,300
18753446,anhkeen,"art lover, tech addict",1,0,0,1,2,300
870687667,MehdiElmoukhlis,Digital Innovation @TSM_Toulouse #Coopetition #CollectiveIntelligence #Crowdsourcing | PhD from @UnivParisSaclay @IMT_BS | ex @IESEG @ESCPeurope,1,0,0,0,1,300
2457072594,camiioux,"PhD candidate at Stanford. Computational social science +
criminal justice + cyber security",0,0,1,0,1,79
267354244,leaderskills,Thoughts and resources on leadership and complexity. Twitter companion to #MGMT5150 - Skills for Leadership @SchulichSchool #MBA.,0,0,3,0,3,300
2291648288,CmplxMethods,ESRC Seminar Series: Complexity and Method in the Social Sciences: An interdisciplinary Approach.,0,1,2,0,3,300
25807798,sigmundsfreund,"Evolutionary thoughts inspired by evolutionary thinkers, forged by natural & cultural selection to become successfully applied business psychology.",1,0,0,0,1,300
19942399,lottiland,,0,0,1,0,1,300
47448178,JRXFernandes,Likes to think across sciences. Works on distributed systems. Linguistics enthusiast!...,0,0,1,0,1,300
804483812,fasiolo1985,"Lecturer in Statistics at the University of Bristol.  Author of the qgam, mgcViz and mvnfast R packages.",1,0,0,0,1,133
214269469,Economplex,A digest of original and RT content about economics and complexity science. Be a part of the renaissance. Join the discussion. Spread the word.,0,0,2,0,2,176
5646582,AndersF2,"(Eternal) student of work, rest and play",1,0,0,0,1,300
151934168,smr_foundation,"We are a group of researchers who create tools, generate and host data, and support open scholarship related to social media.",3,0,1,0,4,300
284985256,ScTechViz,"I teach at @ESIEEPARIS (database, SNA, GIS, Mapping controversies), and I am a member of LISIS (Laboratoire Interdisciplinaire Sciences Innovations Sociétés)",2,0,0,0,2,225
808824,kmakice,Community experience designer / geek dad / recovering Informatics doctoral student / whiteboard artist / author / feminist / he/him,1,0,0,0,1,300
637044457,digi_socscience,,1,0,1,0,2,300
268641996,imammukhri,"Aller anfang ist schwer, Anfangen ist leicht, Beharren eine kunst",1,0,0,0,1,300
1270014830,alex_yakubovich,"Data scientist @google. 🇨🇦 in SF. Likes statistics, machine learning, data visualization, jazz, and cats. Opinions don't reflect those of my employer.",1,0,0,0,1,300
148006704,kramerroel,Algemeen directeur Sociaal gemeente Maastricht,0,0,1,0,1,300
16108478,ThaisMartini1,"#Science and digital communication lover. Research #mentalhealth and #socialnetworks. Sometimes Journalist, MSc and PhD in Psychiatry and Behavioral Sciences 🤖",1,0,0,0,1,300
17335258,gaberoo,"Evolutionary Micro Eco-Biologist & Ex-Physicist. Also: Baker, Beer Brewer, and tinkerer.",0,0,1,0,1,300
387611652,GCSCS_RuG,"Groningen Center for Social Complexity Studies: working on understanding transition to a sustainable society, innovation diffusion, social dynamics and conflict",1,0,5,0,6,300
16910050,KateEhrlich,,1,0,0,1,2,167
1357892143,NYUSternCBA,Center for Business Analytics,0,0,1,0,1,300
39678851,cxweng,,1,0,0,1,2,181
1907673740,LLoepfe,,1,0,0,0,1,115
199249094,paulvilloutreix,"Group Leader - Turing Center for Living Systems @centuri_ls  
| Data Science, Embryos and everything in between",0,1,0,0,1,300
700603987,salndodlarmario,"cuenta beta y en desuso, por favor sigueme ahora en @PublicPolicyIQ",0,0,2,0,2,300
523173234,YupaNoHakobune,,0,2,0,0,2,300
413238271,reksoadi,Grasshopper - Leidenaar,0,0,1,0,1,300
92563078,chri55c,,1,0,0,0,1,179
188204899,kyrharris,@iesebschool Faculty| AI & Crowd | OSHW & 3DP @madeinopen| @CarnegieMellon & @FollowStevens alum| Smite but hear me since 480BC (Themistocles),1,1,0,0,2,300
181868158,opinioncloud,Statistical physicist / opinion formation dynamics on complex systems (neuroscience/ social systems). Huge advocate of open source. Developer of Textcube.,0,0,1,0,1,184
396556273,Evostar2020,"Official Twitter account for Evostar2020, the Main European Event on Evolutionary Computation, to be held in Seville, Spain, April 2020.",1,0,0,0,1,300
169517609,gkoome05,"Am a Public Health specialist doing systems strenghtening consultancy, dairy farming and bee keeping. I am a student of life and complex systems science.",0,0,1,0,1,256
393395654,PresidentAoun,,1,0,0,0,1,300
1382933797,mascorbem,,2,0,0,0,2,10
449088082,albertlumbreras,Machine Learning researcher @CriteoAILab. Atheist but Bayesian.,1,0,0,0,1,300
14750572,bryanleroylewis,"Computational Epidemiologist. Father. Mountain biker.

Calmer than you are.",0,0,0,2,2,300
258962135,NortheasternCOS,Discover. Partner. Innovate.,0,1,0,1,2,300
1281305245,edoardofcolombo,Little curious PhD student,0,0,1,0,1,35
389617749,DemosZhu,,2,0,0,0,2,31
1154464694,MaxWein30,,1,0,0,0,1,18
537808471,PatrickFrankly,Real life average asian.,1,0,0,0,1,80
14132775,DebateGraph,To change the world you need to look at it in a different way,0,0,0,1,1,300
539280347,CauwelsP,"physics, finance, investment and risk management",0,0,1,0,1,300
70075230,bothra90,"software engineer, complexity explorer, motorcycle rider",1,0,0,0,1,300
269873297,aydoz,"Work: Scientist @berkeleylab, Adjunct Faculty @Berkeley_EECS. Fun: Tango, photography, olympic weightlifting. Opinions are solely mine and not my employers’",1,0,0,0,1,300
134908142,digitalarun,"Professor, @NYUStern. Shaping our digital future. Author, 'The Sharing Economy' https://t.co/yLr8oyVYEH",5,0,0,0,5,300
45808733,jmbromley,"Researcher (information extraction, complexity, neural nets and brains), Carer (of many), Gardener (1st crop of raspberries), Runner (still slow).",0,0,1,0,1,291
595452868,rgmelko,"Professor, University of Waterloo; Associate Faculty, Perimeter Institute for Theoretical Physics; Canada Research Chair",0,0,0,1,1,300
33170356,ACM_CEO,,1,0,0,0,1,300
266044476,NUCSSH,Northeastern University's College of Social Sciences and Humanities (CSSH),1,0,0,0,1,300
16341166,PHAC_GC,This account is no longer active. Follow @GovCanHealth for relevant and practical information to help you and your family stay healthy. FR: @ASPC_GC,0,0,1,0,1,300
48127927,bonabeau,,1,0,0,0,1,300
110511051,JMRParrondo,"Physics Professor at Universidad Complutense de Madrid.
Profesor de Física",0,1,0,0,1,300
1251232761198841858,Ben35846532,Social scientist with a background in finance and technology. Think tanker. Knowledge engineer. Policy wonker. Inferencer. I’m a reader not a talker.,1,0,0,0,1,191
34122426,jadelgador,"Teaching and learning in digital times, artificial intelligence applications & social impacts, quantum circuits in electrical engineering, humans beyond Earth.",0,0,1,0,1,300
510098432,mitch_mooney,Find it easier to understand if there is a sports metaphor attached,0,0,4,0,4,300
770668227219300352,SMirandaField,PhD student in NL studying the metascience community. Aurora's mum. Tweets = data. Mostly qualitative methods. #openscience always. https://t.co/IvWGT5AxEe 🇳🇿🇳🇱,1,0,0,0,1,300
1054925184325435392,keithbensons,Localism. Applied Complexity Science. Soul in the game.,1,0,1,0,2,300
139900809,sbrietz,psychological and brain sciences grad student @dartmouth | she/her,1,0,0,0,1,300
1377292081,jeff_zifrony,Athlete first // Research @Twitter // Behavioral science grad student @Penn // still working on my jump shot,0,0,1,0,1,300
717755749271674880,LiuzhuLiu,"Young Talent Associate Professor @Tsinghua_Uni. Associate @Harvard. Climate Change, Sustainability, Carbon data.",0,0,0,1,1,300
785346816,aaronweinschenk,"Associate Professor and Chair of Political Science @uwgb. Tweets about political science research, politics, and psychology. RT ≠ Endorsement.",1,0,0,0,1,300
49829948,dplusbrains,,1,0,0,0,1,300
938992261,Basak__k,studying a weird mixture of computational neuroscience + mathematical modeling + causality in (mostly 🧠 but also other) complex adaptive systems,0,0,1,0,1,300
2385847278,Brian_Slatts,Asst. Prof. in Psychology @DublinCityUni| Check out @ResearcheHealth ~digital health~eHealth~BehaviorChange~HumanComputerInteraction~StartUps~ Views my own,1,0,0,0,1,300
311263137,t_m_wilson,Writer on ecocriticism and the history of rewilding. Research Fellow in English and Cultural Studies at the University of Western Australia. Views are my own.,1,0,0,0,1,300
973317951561654274,DoctoresseSoso,Postdoc@EPFL | Blanke Lab | I ❤️ #Neuroscience #BodilySelfConsciousness #Interoception #MotorControl #Breathing #Insula #Emotion #Addiction #fMRI #MRS #EEG etc.,1,0,0,0,1,247
881320747586641920,tachi_as,Lazy archiving impressive articles.,0,0,0,1,1,300
3310339238,vazquezc_,Researching decision making in innovation management. A/Lecturer at USYD Business School Dalyell Scholars Program. Tweets are my own.,1,0,0,0,1,300
1194662570218659846,cognav,This is for papers related to cognition and navigation. Join our community on https://t.co/mx9HEh6RuB for more,0,1,0,0,1,96
343668867,QPCN,,0,1,0,0,1,156
1126143680581181440,JacobsenJannes,"Sociologist @DIW_Berlin | PhD candidate @HumboldtUni | interested in migration studies, integration research, survey methods",1,0,0,0,1,94
899720953,SambitPhD,"PhD @ou_nederland Co-located Collaboration Analytics | @tudelft CS alum | 🇳🇱 - 4.5 yr | 🇮🇳 | Founder - https://t.co/ouR5t1C4LR | Study, life - NL, EU 👇 4K+ Sub",1,0,0,0,1,300
912500968092164096,WeikangGong,"DPhil student in FMRIB Analysis Group, WIN, Nuffield Department of Clinical Neurosciences, University of Oxford.",0,0,0,1,1,300
284120528,elvandy1515,Assistant professor at National Taiwan University. Director of the Computational Human-sociocultural Experimental Neuroscience (CHEN) Lab.,1,0,0,0,1,136
1103488207,alecastagnetti,PhD Candidate in Economics - Warwick University. Interested in Behavioral and Experimental Economics. 🇵🇪 🇮🇹,1,0,0,0,1,47
168430417,thriving_places,Centre for Thriving Places is the new name for Happy City. Our groundbreaking wellbeing economy measurement tools are designed to support thriving places.,0,0,1,0,1,300
857238115,keeganknittle,Health Psychologist focused on understanding peoples' motivations for behavior change. What motivates you?,1,0,0,0,1,163
996463324018741248,VeronicaGayarre,,0,0,1,0,1,235
579563750,meghanlmeyer,Assistant Professor @Dartmouth and Director of the Dartmouth Social Neuroscience Lab. Researching how the brain makes sense of the social world.,1,0,0,0,1,165
2297463929,InfoSOD,"Strategy and Organization at @SyddanskUniv, Denmark. #OrganizationDesign #Strategy #Adaptation #Collaboration, #Complexity #AI",1,0,0,0,1,300
3065703778,turliliana,,1,0,0,0,1,89
4883065037,elisa_militaru,"PhD student @CambPsych, @christs_college. Linking personality, geographical psych and language.",1,0,0,0,1,49
891677275799908352,RalfKurvers,"Researcher @MPIB_berlin interested in collective behavior, collective intelligence, social networks and cool animals (including humans)",2,0,0,0,2,300
865547366,steph_stockwell,"PhD student, digital behaviour change interventions, physical activity & sedentary behaviour, older adults & children",3,0,0,0,3,300
810979391048130561,carvalhoprimate,"AssocProf@Oxford_anthro
Head @primobevolab&
PaleoPrimateProject
Primates,Fossils,Tools,Africa,Parallel ideas! Advocate kind, slow milestone science
Views:my own",1,0,0,0,1,300
1171739160224378881,EndOfThePier,'Dr Gee believes he may end up holding his place as the oldest human ancestor' - Daily Mail. RTs aren’t endorsements. Views own. Profile pic by @John_Gilbey,0,0,0,1,1,300
2821010593,Coka_Hoo,"M.D, Ph.D. Functional Neurosurgeon. Ruijin Hospital, @JiaoTongUni, School of Med. Joint PhD Alumni at @FudanUniversity，@mghneurosurg and @harvardmed.",0,1,0,0,1,300
1141195109406523392,BrunoCaforio,"Science lover! Currently working as a data scientist. I've done research in neuroscience and I love anything related to data analysis, ML, data engineering etc.",0,0,1,0,1,212
3230272373,Roger_Beaty,Assistant Professor at Penn State studying cognitive neuroscience of creativity.,0,0,0,2,2,300
755937910508007424,CoxJoleneA,PhD in Cognitive Neuropsychology + Senior Research Officer in Mental Health,0,0,1,0,1,125
150051391,SirBrainer,𝒮𝑜𝓃𝑜 𝓊𝓃 𝓈𝑒𝓂𝓅𝓁𝒾𝒸𝑒 𝑒 𝓊𝓂𝒾𝓁𝑒 𝓁𝒶𝓋𝑜𝓇𝒶𝓉𝑜𝓇𝑒 𝓃𝑒𝓁𝓁𝒶 𝓋𝒾𝑔𝓃𝒶 𝒹𝑒𝓁 𝒮𝒾𝑔𝓃𝑜𝓇𝑒. 𝕯𝖊𝖚𝖘 𝖊𝖝 𝖒𝖆𝖈𝖍𝖎𝖓𝖆.,1,0,0,0,1,300
3971791288,GarimaShukla_,"Demystifying complexity in #battery materials with multidisciplinary theory, experiment, modeling, & philosophy. Promoting science without disciplinary borders!",0,0,1,0,1,181
607207100,TaiChimpProject,"Research on and conservation of wild chimpanzees in the Tai National Park, Cote d'Ivoire, since 1979.",3,0,0,0,3,300
2715358804,hmb2829,PhD candidate in Behavioural and Experimental Economics and BEADS Lab manager @unibirmingham,1,0,0,0,1,300
2645200398,jiamao0106,"@Princeton EEB/ Kyoto Univ. CER 生態研/ Masason fellow/ microbial ecology, eDNA",0,0,0,1,1,300
743114458000707584,siemondl,PhD candidate in network neuroscience. Also interested in technology and design.,1,0,0,0,1,64
3130719057,petticrewmark,"Professor, Public Health, Faculty of Public Health & Policy, LSHTM. Tweets =personal capacity.",0,0,1,0,1,300
607577246,RobinGomila,"PhD candidate in social psychology at Princeton --deviance, research methods",1,0,0,0,1,300
778972013054398464,tiasr2010,Neuroscience PhD student,1,0,0,0,1,31
24177898,UcrosAndres,Trabajando por Bogotá y la Región en @CamaraComerBog / Fellow @Acumen / Recomiendo en #SinAgueroo / Leyendo a @jasonintrator / Opiniones personales.,1,0,0,0,1,300
28443018,nicolepangborn,Sociologist. I like to write about people and places.,1,0,0,0,1,300
499923071,Jlscarlettsmith,,1,0,0,0,1,50
3293362442,singh_aalind,AI | NLP | HRI,1,0,0,0,1,25
931395103884750848,BehaviaBerlin,Behavia - Behavioral Insights Unit | Consultancy | Think Tank | Passionate about Behavioral Public Policy & Behavioral Economics in Europe & Middle East,1,0,0,0,1,300
51247159,SoleillG,,1,0,0,0,1,300
3174594047,zuoxinian,Harnessing reliability for neuroscience research - Read here: https://t.co/gjrqkNoWfk,0,0,0,1,1,300
3239712942,bsimonhsays,"motivated tactician who studies and teaches psych | @UPDPsych @Official_UPD | cyberpsychology, digital politics, collective action 🇵🇭",2,0,0,0,2,300
426723881,Birkbeck_CS,"The Department of Computer Science and Information Systems at Birkbeck, University of London (since 1823)",1,0,0,0,1,51
62290659,nanosanta,,2,0,0,0,2,196
961563414815485952,CCE_Brunel,"Evolution and culture are the two most fundamental and powerful influences on human behaviour, and their combined effects are what we study at the CCE",2,0,0,0,2,284
16139549,HealthEugene,"Serial Intra & Entrepreneur, Founding Board Member of @YourCoachHealth , Health 2.0 NYC & AMS & DUS, Husband, Father to 2 gr8 girls. Views always my own!",1,0,0,0,1,300
23261919,sharon_chen_twt,Social & decision neuroscience PhD student @caltech. Connectomics/ML approaches to intelligence research. Formerly @Columbia @Stanford @RockefellerUniv.,1,0,0,0,1,281
4430110701,kati_kish,"PhD candidate in philosophy of mathematics at @TelAvivUni. Research interests: intuitionism, the foundational debate, cultural evolution and social norms.",1,0,0,0,1,300
839492111603019776,CogNav_RIN,Cognition & Navigation subgroup of the Royal Institute of Navigation (RIN). Follow us for news on the cognitive neuroscience and technology of navigation,0,1,0,0,1,300
873157156408832001,dAryan_dt,"Interested in brain and cognition, specially human decision making! music lover & violin player🚶🏻🏊🏻🎻",1,0,0,0,1,262
865947913817649152,cjschmank,Applied Cognitive/Quantitative Psychology PhD Graduate student at Claremont Graduate University.,0,0,0,1,1,145
1120387313941479425,Lieven_Pauwels,"Personal account. Tweets on human evolution,  behavioral strategies, self-regulation, rule-breaking, group processes, prevention. RT ≠ endorsement.",1,0,0,0,1,300
1123624739774369793,ChrisKrupenye,Evolutionary Anthropologist and Cognitive Scientist || @durham_uni || Origins of the Social Mind | great apes and human cognitive evolution | he/him,4,0,0,0,4,300
2247765476,crewalsh,"🧠  UCLA Psychology PhD student studying memory with @jesse_rissman | NSF GRFP | she/her

https://t.co/m41rZ2WUze",1,0,0,0,1,33
716672584377565184,Justinthebooks,1st Year MD-PhD Student @UofUMedicine Cognitive / Computational / Network Neuroscience Neurosurgery | Consciousness | Neuromodulation,1,0,0,0,1,102
1115967775967674368,UDelCEAE,"We're the University of Delaware Center for Experimental & Applied Economics. We like behavioral, experimental & applied econ.",1,0,0,0,1,300
1029101806234861580,PilleriinSikka,"Researcher, Lecturer & Lifelong Student of the Mind-Brain💡 #emotions #sleep #dreaming #wellbeing #consciousness",1,0,0,0,1,205
844470154318794755,rahyabHR,,0,1,0,0,1,300
1046871610236555264,TomanBarsbai,"Migration, development, culture, and behavior of human and sometimes non-human animals. Associate Professor @BristolUniEcon. RT ≠ endorsement.",2,0,0,0,2,196
1005913748144574465,ArtificialChat,NYC #AWS Partner #DevOps for  #Enterprise #Chatbots #Amazon #LEX  #Chat #Bots #AI  #ML #Appsync #AWSAMPLIFY #DynamoDB #LambdaLayers #EventBridge #DracalDEV,1,0,0,0,1,300
871869837315686400,michael_barlev,Cognitive Science and Evolutionary Biology. Arizona State University 🌵🌞🦂,1,0,0,0,1,300
1102337713171255296,agnus_data,"Associate Marketing Manager. Outreach and Open Research Team @SpringerNature. Views my own, or possibly those of Bruno Latour.",1,0,0,0,1,219
2743768270,VFlaudias,Dr Neurosciences-Psychologue-Chercheur @UCAuvergne-Coordinateur du centre TCA @CHUClermontFD - Conseiller Municipal #Gerzat délégué Enfance-Jeunesse et Santé,0,0,1,0,1,300
1100223393826263040,ERamosPhD,Looking to improve health for the general public at an individual and population level...and everything in between. (Views my own),1,0,0,0,1,300
1105614885608669189,A_M_Espin,Behavioral economist & economical behaviorist,2,0,0,0,2,300
2181316406,awhjr422,"In good soil, the seed takes root and will soon bear fruit.",0,0,1,0,1,300
1010628765150478336,pjvarase,"Why humans (and other organisms) have babies? 👶🤔/ PhD student at @MPI_EVA_Leipzig, alumni from @UvA_Amsterdam and @uchile 👨‍🎓 / ⚽️💙❤️ / Spanglish",3,0,0,0,3,256
19895352,2Nipun,"Just a product manager who is super observant, has a take on everything, likes traveling & is always building something. 🌊☕️👨‍💻🎨",1,0,0,0,1,300
874299223,angiembjm,Passion for creating better health. Action on #NCDs. PhD. Fellow @R_S_P_H.  Views my own.,0,0,1,0,1,300
1624304486,EaSportPsy,"Human. / Bigger than the universe, smaller than a quark.
BSc. in ψ psych.",1,0,0,0,1,206
2211425600,Rus087,Political economy of communication | Jazz is just an excuse to play wrong notes,1,0,0,0,1,300
187622457,giovaninig,Alguém em busca de estratégias melhores!,1,0,0,0,1,300
1080626620044439552,obscureengineer,,1,0,0,0,1,135
1045801806,johannes_d_e,"Historian & Russianist. Author of Soviet Russians under Nazi Occupation (Cambridge UP, 2018). University of Oslo, @CrexUiO",1,0,0,0,1,300
879775522410168321,A__Rankin,Ph.D. student @OCEAN_OKstate | Funded by @NSFGRFP | Friendships. Behavioral Endocrinology. Evolutionary Psychology. Opinions are my own.,1,0,0,0,1,180
958639119701192704,zohyos7,Lab Manager at Computational Clinical Science Laboratory (Seoul National University) https://t.co/U5jid1weDC 🇰🇷,0,0,0,1,1,190
1039527974360547328,DaniellaWatson_,"Trainee Health Psychologist, PhD candidate. Maternal and child nutrition in sub-Saharan Africa @NIHR_INPreP @unisouthampton",0,0,1,0,1,185
1094023530671411201,ErinJBeebe,"Research Asst., Cheer Lab, UMSOM. Aspiring Neuroscience PhD student. Interested in drug addiction, stress, cannabinoids, opioids, & sex differences.",1,0,0,0,1,300
85031506,cotoroki,社会心理学・組織心理学/ 研究に関する情報収集や個人的で息抜き的なつぶやきのためにこちらを利用しています。,0,0,1,0,1,300
592209836,aestheticTerror,,2,0,0,0,2,300
141328091,SaRoseCav,"Psychologist, professor, writer, faculty developer. Occasionally geeks out. Author, SPARK OF LEARNING https://t.co/m1ItIJVL1a & HIVEMIND https://t.co/jMxNiDtf6d She/hers",1,0,0,0,1,300
1087321546602020864,primobevolab,"Researching human origins & adaptations through primatology, archaeology & paleoanthropology.
Paleo-Primate Project Gorongosa
#primateconversations
@UniofOxford",1,0,0,0,1,300
1084173670556196865,SpeciesTypical,evolutionary psychologist @CSUF; on the universality of human nature & the uniqueness of the individual (& culture); tweets belong to whichever module is active,1,0,0,0,1,300
1072755840023781377,tdeincubacion,"Un #podcast de divulgación científica independiente, hecho por investigadores de la @Univcordoba & @IMIBIC https://t.co/VyEItPH5Bt",0,0,1,0,1,300
104303161,SebaValenz,"Prof Asoc / Assoc Prof @fcomuc | Editor https://t.co/SHwHRTPu3k | Researcher @IMFDChile @CIGIDEN | PhD @UTJSchool | Political comm, social media, journalism | ESP / ENG",1,0,0,0,1,300
1051994858,katyalex666,,1,0,0,0,1,270
3300602777,HyperadaptHyrax,"The Hyperadaptationist Hyrax, follows fitness optimizing logic to its inevitable conclusions. it/its. On speaking terms w/ @tintin2sn.",0,0,1,0,1,300
98184831,an_reiter,psychotherapist | research fellow  @MPC_CompPsych @WCHN_UCL,1,0,0,0,1,300
133046759,brungio,"CNRS CRCN, INT, Marseille, France. Auditory neuroscience and psychophysics.",1,0,0,0,1,300
996080367336542208,SVLeadershipLab,Research-based solutions to advance women's leadership. Principal Investigator: Prof. Shelley Correll. @csimard tweeting.,0,0,0,1,1,300
1075340338317967360,JC_Dreher,"Cognitive neuroscientist at CNRS. 
Head of the neuroeconomics lab at https://t.co/7FYdDHsEEb",2,0,0,0,2,35
3593321,gnafuy,adventures of a Dr that can't save lives | 👩🏼‍💻🤔🤓,0,1,0,0,1,300
33423679,KaseyKlimes,"Curious person, design researcher, city planner. Building future systems for ancient minds.",0,0,1,0,1,300
368176337,ying_hojo,PhD in psychology. Research interests are face perception and vision. A professor said 'he has a dry sense of humour.',1,0,0,0,1,86
1710005630,ptrnhealth,"Pattern Health's digital health platform and marketplace lets researchers and clinicians create, manage and distribute evidence-based digital health programs.",1,0,0,0,1,300
1035637382463320064,profjennabednar,"Professor @UMich, external faculty @sfiscience.  Admirer of beautiful things, like human cooperation; curious about how governance spurs those collaborations.",0,0,1,0,1,284
38316394,GravelJ,"Criminologist, Postdoctoral fellow at the Penn Injury Science Center at the University of Pennsylvania",1,0,0,0,1,300
536579769,eugened07,Co-Director Adolescent Health Research Unit UCT | Senior Scientist Cochrane SA SAMRC | Mandela Rhodes Scholar | M&G 200 Young South Africans,1,0,0,0,1,300
124883739,alexgomez3,,0,0,0,1,1,300
3129769150,DrDebs_Oliveira,"PhD, Nurse. Researcher for @STRiDEDementia | Ass. Editor @DementiaJournal @Journal_AD | Ageing, Dementia, Prevention, Long-term care, Inequality, Mental Health",0,0,1,0,1,300
3309942890,hir_kurashige,倉重宏樹/認知神経科学および計算論的神経科学/会津高→名古屋大→神戸大→玉川大→理研→ATR→慶応大→東大→電通大→東海大,1,0,0,0,1,300
1442076794,robbo226,University lecturer. Judo researcher.,0,0,1,0,1,156
984589342784995329,qwerasdf4308,,1,0,0,0,1,300
870893168367030272,EnriWagner,,0,0,1,0,1,300
996821570000736256,StirBSC,"Tweeting about our own research, courses, and events as well as other interesting behavioural science related topics.",1,0,0,0,1,300
104475938,corenapicella,Scientist | First-Gen | Mama |Assoc Prof @Penn | Editor @HumBehEvoSoc & Adaptive Behav & Phys | Dir @SBSI_UPenn | Studies human nature. she/her,2,0,0,0,2,300
4873826663,HuBCEG,"The University of Exeter's 'Human Behaviour & Cultural Evolution Group', Cornwall Campus. See website for people & publications.",1,0,0,0,1,131
1044473360833368070,ethanarshadi,A seeker of knowledge,0,0,0,1,1,238
1205829984,diegoareinero,"Social psychology PhD student @ NYU, interested in empathy and morality. Fan of succinct writing- still learning how to do it. Descriptive stats are underrated.",1,0,0,0,1,300
995877126464303104,alexdaviscmu,"Associate Professor @CarnegieMellon. Engineering and Public Policy. Behavioral foundations of policy, including energy, climate change, health, innovation.",0,0,1,0,1,300
1018130880072683522,LirSamuni,Primatologist & photographer,7,0,0,0,7,270
717435391113084928,TanjaFilatova,"Professor in Computational Resilience Economics @UTwente & @UTSEngage , Member @DeJongeAkademie KNAW, @ERC_Research, Leader 4TU.DeSIRE and Board @4TUResilience",0,0,1,0,1,300
536653638,OpheliaDeroy,"Blending cognitive science & philosophy (and some wine, but there I prefer unblended Pinot Noir). Likes & retweets may be endorsements or not, unpredictably.",1,0,0,0,1,300
4654667776,BorisLeeuwen,Assistant Professor at the Department of Economics of @TilburgU,1,0,0,0,1,256
982359599138377730,HalabiSlieman,"Social Psychologist,
International Max Planck Research School on Adapting Behavior in a Fundamentally Uncertain World
Friedrich-Schiller-University, Jena",1,0,0,0,1,252
510532642,SarahJeanneDC,Curious about drivers of human behavior | Exploring as consultant with @grid_impact @jsihealth | Previously @PeaceCorps @icf | @DickinsonCol alum,1,0,0,0,1,300
1059202250,oatabati,"PhD candidate🤓@EconCalgary.Teaching👨‍🏫@#MRU #UofC.
Data+Economics is😎
Nerdy topics: Empirical IO, Applied Econometrics & Behavioral Econ. Non-nerdy: LFC",2,0,0,0,2,245
606159216,HelenEliz_Brown,"Senior Advisor (Health and Social Care), @B_I_Tweets and @ISBNPA Executive Member-At-Large || Formerly Postdoc Fellow, @CedarUK @MRC_Epid, @Cambridge_Uni.",1,0,0,0,1,300
910307602701176832,claudiatfitz,"Researcher + clinical psychologist, studying the interplay between emotions & physical health. At @HarvardChanSPH / @HarvardCenterHH🇺🇸; from @universitelaval🇨🇦",0,0,0,1,1,300
1025322788788232192,RickZhixuYang,Graduate Student in I-O Psych @Purdue_PsychSci from Fall 2020 via @ZJU_China | He/Him/His,1,0,0,0,1,300
2922173762,Angel_EsparzaOn,,1,0,0,0,1,300
150577330,Scipenelope,,0,0,1,0,1,300
1346714042,SANS_news,The Social and Affective Neuroscience Society | Official News Feed,1,0,0,0,1,300
3084965674,KristinaJessen,"Assistant professor of political science. Political Psychology. Emotions, Public opinion.",2,0,0,0,2,182
781896805441163264,AktipisLab,"We study cooperation and conflict across life: human sharing, multicellularity & cancer, microbiome & behavior, kombucha @ASU @AthenaAktipis",1,0,0,0,1,300
1005329815547805696,KatarinaWarren,"PhD student @UniofOxford studying chimpanzee technology and human evolution. Hodophile, xanthophile, and avid lindy-hopper.",2,0,0,0,2,300
2547766532,mychijourney,B E ➖ H U M A N • Restoring you to your original nature. Check out our learning programs & experiences #mychijourney #behuman,1,0,0,0,1,300
581344342,DrMariosAdamou,"No controversial views here, just sharing what I read and use as journal. RTs do not imply endorsement. Tweets are in private capacity and may be sarcastic.",0,0,1,0,1,300
392814174,Inbal_b,researching the Neurobiology of empathy and pro-social behavior in mammals,1,0,0,0,1,300
382003874,wichinpong,"PhD Candidate in Operations Management @Wharton | @TEDxPenn Marketing | @MIT / @BrownUniversity alum | behavioral economics, people analytics, cities, food",0,0,0,1,1,300
996288143325368320,BeingOne_,A deeper awareness of the relationship between human beings and the natural world to widen our point of view and switch toward a complex system approach.,0,0,1,0,1,300
2884728344,shitPrateekSays,"(he/him) PhD candidate at @falklab, @AnnenbergPenn; improv comedy at @cszphilly; social neuroscience, political humor, machine learning. @IIITDelhi alum.",2,0,0,0,2,300
19210200,footesea,"PhD candidate, @AntiochNewEng #marinescience #conservation #socialscience #socmar #consmark #behaviorchange #scicomm #climatechange #ocean #Hawaii #EuniceFoote",0,0,1,0,1,300
2703285038,derekpowll,Postdoc at stanford,1,0,0,0,1,66
978003856545099776,NudgeDenver,the best of #psychology | innovation in #behavioraleconomics | #publichealth applications | beauty in #communication | power in #behavioraldesign,1,0,0,0,1,300
285824034,salarrad,"postdoc, New School for Social Research, Kahneman-Treisman Center for Behavioral Science & Public Policy, Woodrow Wilson school, Princeton",1,0,0,0,1,127
922172245656600576,schimmelrob,"PhD candidate Uni. Lausanne (Charles Efferson). Affiliate @mmuthukrishna-lab, @LSE_PBS, @FehrAdvice, #humanbehaviour #culturalevolution #socialnorms",1,0,0,0,1,300
3195775136,inpurier,Developmentalist  Genetics  Prevention Developmental methodology Adolescence,0,0,1,0,1,300
27823036,PsychoSchmitt,"Professor & Director, Centre for Culture & Evolution, Brunel University London. Tweets my own & are science communications not endorsements of views/findings",0,0,0,1,1,300
823927020195344385,jespersams,"Data Analyst @Banedanmark | Creating insights with #data and #analytics | I tweet about #coding, #tech and #business #opportunities",1,0,0,0,1,161
2322251619,liligulbert,"Teaching living systems logic, Regenerating broken connections, Making sense of reality, Moving imagination, Building deep cultures, Generating systemic change",1,0,1,0,2,300
465023535,affectivebrain,"We are the Affective Brain Lab – Tali Sharot’s lab at UCL. Updates on our work on the brain, emotion, belief, learning and other interests of lab members",1,0,0,0,1,182
3066077921,sheinalew,"Postdoctoral researcher @SFUPsychology. I look at how culture influences children's learning, and how learning makes us human. @ForagerChildren",1,0,0,0,1,300
181392462,petelivingstone,Navigating the existential dread that the entirety of human knowledge is tenuous. Retired mine engineer. Active risk allocator. Investor. UltraEndurance athlete,0,0,1,0,1,300
98981822,victorshiramizu,"Postdoctoral research on @kinfaces project at @UofGlasgow. Interested in prosocial behavior, decision-making, and wine. Views own.",1,0,0,0,1,300
26257927,gstix1,"Senior Editor, Scientific American",1,0,0,0,1,300
45161771,ni3chate,"Professor in General Surgery, followed by Nikhil Wagle,Raju Parulekar,Piyush Goyal office,Amar Habib.",1,0,0,0,1,300
117571456,JesusSaenzP,Newtype,0,0,1,0,1,300
124133966,simonsaysnothin,"Assistant Professor of Data Science and Public Policy @thehertieschool, Berlin. Public opinion, elections, web data.",1,0,0,0,1,300
975793151146422272,chilbe3,"Math, game theory, and cooperation",1,0,0,1,2,296
60059381,enfilpremraj,"Child of the Living God, husband, father and an evolving HR pro! Blessed to be born an Indian.",1,0,0,0,1,300
975006355437314048,MadalinaSucala,"Behavior Scientist. Working at the Nexus of Behavior Science, Human-Centered Design, and Data Science to Improve Health & Wellbeing Outcomes. Opinions my own.",1,0,0,0,1,258
960493941043888128,legrandni,Postdoctoral fellow @visceral_mind - Aarhus University,0,0,0,1,1,300
749576077,logikbm,"A techie. | Tweet, retweet, or follow does not imply endorsement. I don't follow back. Followers are not vetted. DMs are open.He/him|
ajaykumar.k@protonmail.com",0,0,1,0,1,300
971564146016882688,timi_kehinde,"Training: Chemical Engineering & Biomedical Engineering
Interests: Art (incl. archt.) & Philosophy
Some tweets are random thoughts...",1,0,0,0,1,300
967907694731460608,StuartWilsonPsy,Senior Lecturer in Psychology,0,0,1,0,1,130
251716830,johndinsmore,#Healthcare Innovation Lead/Deputy Director @TCPHI_TCD; https://t.co/3kmQmFLWKa #digitalhealth @tcddublin; BofD @EITHealth_UKI; PI @ProACT2020 Views my own/RT not endorsement,0,0,1,0,1,300
1535864401,KipkechElijah,Senior RA @BRACworld |ex RA @sc_somalia | Prospective Grad Econ Student | Development Econ enthusiast | Machine Learning Novice | Mystery,1,0,0,0,1,300
19575245,hcolelewis,"Interests: behavior science, epi, informatics, mHealth, maternal & child health, chronic disease prevention, Sierra Leone, more bio characters. Views are mine.",1,0,0,0,1,300
393874183,RayDuch,"Official Fellow and Director of the Centre for Experimental Social Sciences at Nuffield College, Oxford.  Director #CESSSantiago. Visitor @IAST1 Toulouse.",1,0,0,0,1,300
304938476,Aiden_S,"Senior Lecturer in Security and Crime Science, University College London.",1,0,1,0,2,300
384213142,UCLanthropology,"One of the largest anthropology departments in the UK with highly rated research, covering broad range of biological, cultural, social & material anthropology.",2,0,0,0,2,300
814275104,kimvanorden,Suicide prevention scientist. Social connections matter. Geropsychologist. Cognitive behavior therapy. Playing outdoors. Coloring. Cat lover. Purple.,1,0,0,0,1,300
756000450176876544,yumakajihara,retweeting machine,1,0,0,0,1,300
915215572069228544,LauraBoxleyPhD,Clinical #Neuropsychologist (ABPP-CN) at The Ohio State University Medical Center. All views are my own.,1,0,0,0,1,179
815933177046908928,NilsKolling,"Interested in how the brain makes decision and generates as well as maintains motivation over time. Junior Research Fellow in Christ Church, Oxford University.",1,0,0,0,1,300
916279315200991233,PalvaLab,"Systems and cognitive neuroscience at the Centre for Cognitive Neuroimaging, University of Glasgow and at the Neuroscience Center, University of Helsinki.",0,0,0,1,1,178
144626914,Journalologist,"Publishing Director, Nature journals. All views my own etc.",1,0,0,0,1,300
2382884058,jeffabrooks,PhD student at @NYUPsych,1,0,0,0,1,300
299842064,matseinarsen,"Data science, psychology and running engineering & product teams. Previously Senior Director of Product at KAYAK, OpenTable, SPO https://t.co/fk1NcLPLX2. 🏨🛫🍽️",0,0,0,1,1,300
3316765444,bvb373,"Vision scientist, assistant professor @TheNewSchool in NYC.",1,0,0,1,2,148
880162381195866112,AjuaDuker,"social psychologist-in-training @yale. dancer, occasional writer, and proud ghanaian-american. (she/her)",1,0,0,0,1,295
937027385505058822,vlasceanu_mada,"Psychology & Neuroscience PhD student @Princeton: Memory, Beliefs, Networks",2,0,0,0,2,87
720144424,FrancisMollica,"Cognitive scientist @UniMelb into language, concepts and contexts with a computational/developmental bent. he/him",0,0,1,0,1,300
2927384352,EcoParyavaran,"Environmental Consultants in Chandigarh, Environmental Engineers in Mohali, Environmental NGO in India, Environment Management Services in Chandigarh,",1,0,0,0,1,165
177911142,LucasBietti,"Associate professor, Norwegian University of Science and Technology; Research methods; cultural transmission, communication, memory & learning in interaction",1,0,0,0,1,212
147650011,yangyang_zhou,"Assistant Professor @UBCPoliSci studying migration, identity, development | @PUPolitics PhD | formerly @supportPSOT | she/her",1,0,0,0,1,300
2776505567,ProfData,"Fellow at Alan Turing Institute for data science and https://t.co/bA0Osp7KmB; Professor of Cognitive and Decision Sciences, University College London",0,0,0,1,1,300
1018846544,NicoleMatejic,"Author. Doctoral candidate: 'The Jihadi Nudge' @USQedu Adj Lecturer @CSU_CTstudies IO, IW, CT, C/PVE , Crisis & EM adviser/scholar. Lover of Acronyms🖖🐾",1,0,0,0,1,300
921323347568463872,DStibbardHawkes,"Anthropologist interested in foraging, signalling, food-sharing and egalitarianism among other things. Tweets and associated spelling mistakes all my own.",1,0,0,0,1,274
88197166,JFelipeMCampos,Economista UBA-UdeSA. Amante del futbol y de la lectura.!,1,0,0,0,1,300
818840325426819073,ynk_socpsy,"Psychologist at Kochi Univ. of Technology, Currently working on Cultural History of Paleo Asia, cultural evolution, folktale, religion",2,0,0,0,2,300
4342671075,Dimi_Tz,"PostDoc @Penn, DSc @AaltoUniversity. Electromgnetics/Photonics/Antennas/Metamaterials/Applied Mathematics. Musician. Philosophy/History of Science! 🏳️‍🌈",1,0,0,0,1,168
893583183630835713,cyb3rist,Software Application Programmer,1,0,0,0,1,300
4833056519,MichaelLouisPl1,"Director, Wharton Neuroscience Initiative and James S. Riepe University Professor of Marketing, Psychology, and Neuroscience, University of Pennsylvania",1,0,0,0,1,300
557057473,Nienke_Alberts,Anthropologist. Research associate @bristoluni. the personal tutoring project | access to HE | primates,1,0,0,0,1,300
2871858771,philipparnamets,"Cognitive scientist interested in social learning, morality, and preference formation.    Postdoc with Social Identity & Morality Lab @ NYU",1,0,0,0,1,300
86716391,edthink,"Professor of Urban Analytics @SoGLeeds and @LIDA_UK. Turing Fellow @turinginst. Cities, transport, and behaviour. Data, models, and maps. Too easily bored.",0,1,0,0,1,300
884741,ehud,"Philosopher and historian of biology at Tel Aviv University. Before that: CS, SE, programming languages. I'm almost always half joking.",0,0,0,1,1,300
388827986,tmwaring,"Using cultural evolution to understand, predict and accelerate the emergence of sustainable behaviors and institutions.",0,0,2,0,2,300
2466897540,sansengsu,Learning for life.,1,0,0,0,1,300
1882998218,KurniawanLab,@kurniachev's lαb ♪ oncology in between biochemistry αnd biophysics & its dedicαtion on nαnomedicine ♪ in love with mediterrαneαn ♪ 📧 kurniawanlab@daum.net,1,0,0,0,1,245
572236501,Loch104,"Areas of Interests: Tactical/Law Enforcement Medicine, Counterterrorism and Violent Gangs",1,0,0,0,1,300
238759415,Kongwel,,0,0,1,0,1,220
2383547119,coglode,We tell you how to apply behavioural research at https://t.co/FGMu549N56. Written by @ribotminimus.,1,0,0,0,1,300
259906731,ekadamer,"CEO @Prolific (YC S19), we’re hiring! Passionate about entrepreneurship, diversity & inclusion, psychology, behavioral & meta science. Feminist ♥️✊ Views my own",1,0,0,0,1,300
780845952504442880,kris_m_smith,"Postdoc @SBSI_UPenn. Psychologist, occasional anthropologist. Studies cooperation, morality, and other social stuff in Hadza hunter-gatherers.",2,0,0,0,2,300
3437502647,Michael_L_Wood,"Assistant prof. at @BYUsociology. PhD at @NotreDame. Culture, cognition, religion, computational text analysis. Contributor at https://t.co/BWF4phY0cA",1,0,0,0,1,300
2412311131,LucaCocchi78,Neuroscientist,0,1,0,0,1,300
1668754213,GrantSeanP,"Assistant Professor @SBS_FSPH. #InterventionResearch, #OpenScience, #BehavioralHealth. He/him/his. Opinions mine, RT ≠ endorsements.",0,0,1,0,1,300
804699913,Bruce_Yin_Wang,"Social Psychologist/Neuroscientist. PhD @notts_psych, Postdoc @nyupsych & @temple_psych. Faculty at IDG/McGovern Institute @BeijingNormalU",1,0,0,0,1,300
1605947262,ISAZOfficial,The International Society for Anthrozoology. Anthrozoös Journal. Advancing the scholarship of human-animal interaction.,1,0,0,0,1,300
1130126262,jordan_w_moon,"PhD student in social psychology. Religion, morality, evolutionary psychology, etc.",1,0,0,0,1,194
2824526028,KatharineZywert,"PhD Candidate, Social & Ecological Sustainability @ers_uw, Health Systems in the Anthropocene | Strategic Implementation Lead @ChangeOpenly",0,0,1,0,1,300
125704379,TarraPenney,Assist Prof Policy Evaluation @YorkUHealth | Visiting Scholar @CedarUK @MRC_Epid @Cambridge_Uni | Transition to Healthy Sustainable Food System | Better Methods,0,0,2,0,2,300
2393750642,RobinNusslock,Professor @Northwestern. All things psychology & neuroscience,1,0,0,0,1,300
33604444,matthewgthomas,Scientist and scribbler. Foresight and research for @BritishRedCross and @InteragencyRAN. Columnist for @SAPIENS_org. Opinions are mine (and sometimes yours).,1,0,0,0,1,300
3393693303,lameira_adriano,"Assistant Professor, University of Warwick, Department of Psychology. Primatologist studying the origins of human behaviour and mind",1,0,0,0,1,300
528778208,socialstriatum,"Psychologist and neuroscientist specialising in social influence, altruism, and choice.",1,0,0,0,1,300
387083690,louiseglew,"is WWF's Global Lead Scientist for Conservation Evidence.  All tweets my own. Retweets are not endorsements, etc. etc.",0,0,1,0,1,300
16172578,thesidb,"society, business, technology, (open) information, analytics",0,0,1,0,1,300
754183353364996096,SCLSightlines,"Helping us live better, longer lives through financial security, healthy living, & social engagement.",1,0,0,0,1,300
857944710501019648,ChowJanette,Developmental Scientist at @OxfordBabylab to understand how #babies build a #lexicon | CDF at St Hugh’s College | #scientistparent raising a #trilingual baby,0,0,0,1,1,76
2296283035,carstmey,Head of Macroecology & Society lab @ iDiv.,0,0,1,0,1,235
200578368,GodwinYeboah,GIS | Sustainable Development | SocioSpatial Data Science | Transport | Geomatics | Social Science | Health | Geography | Energy | Urban Analytics | IT|Business,1,0,0,0,1,300
12455302,amonck,md @wef. just me here.,1,0,0,0,1,300
602680982,tscottphillips,"Scientist • Philosopher • Humanist • Dancer • Author, 'Speaking Our Minds' • Based @ceuhungary • Previously Sussex, Edinburgh, Durham • #istandwithCEU",1,0,0,0,1,300
81621938,barb0101,"Design Strategist, Mayo Clinic Center for Innovation. I care about human-centered technological change and the quest for health care and education for all.",1,0,0,0,1,300
434080901,RyuichiTamai,Research associate at Kochi University of Technology in Psychology / Social psychology,5,0,0,0,5,252
3222063966,kotsukenUT2,"東京大学大学院工学系研究科都市工学専攻都市交通研究室の公式アカウント。
Official account of the Urban Transportation Research Unit at the University of Tokyo.",4,0,0,0,4,213
555012020,ChVanBoven,"Passionate about video, enjoying good Spanish food and more",1,0,0,0,1,300
3288040955,IA_AMB,Ambulanz für Störungen der sozialen Interaktion am LVR-Klinikum Düsseldorf,1,0,0,0,1,300
128947971,thomroulet,"*Economic #Sociologist, theorizing #Organization & #Management @Cambridge_Uni @CambridgeJBS 
*Fellow @GirtonCollege 
*Deputy director @CambridgeMBA",3,0,0,0,3,300
1580103728,TwomeySarah,Brexit Fisheries Analyst #Brexit #IUUFishing #Geopolitics #MarineGovernance #MaritimeBoundaryDisputes #Fisheries Views my own,0,0,1,0,1,300
1040920897,MasonChip,"Engineer, golfer, birder, Red Sox fan. Curious about how our brains work.",1,0,0,0,1,300
830935463271751680,kmpetersson,"Neuroscientist, BSc, MD, PhD  @MPI_NL",0,0,1,0,1,300
14977116,gregsthinking,"At the confluence of human nature, ergonomics, resilience, & critical thinking. See & design invisible influences that drive behaviour. Partner in Thin Air Labs",0,0,2,0,2,300
108006044,carmen_lefevre,Behavioural Scientist | Psychologist | UX Researcher. Associate @UCLBehaveChange. Trying to understand people's behaviours and attitudes.,0,0,1,0,1,300
2173976412,DrewGerkey,"Anthropologist studying networks, institutions, and cooperation in the Arctic. Assistant Professor at Oregon State University.",2,0,0,0,2,298
115490808,manisha_bhinge,Social innovation and impact. Curious about everything.,0,0,1,0,1,300
763304412,bramkaaj,Policy Analysis Section - TU Delft. RT or Like ≠ Endorsement,0,0,1,0,1,300
3061904694,tweetsbyWoodM,"Social Psychology PhD Student @ Griffith Uni, Brisbane. Interested in Relational Norms, Social Networks, Statistics, and other things! 🌈",1,0,0,0,1,43
2976213754,DrAnneMartin,"Researcher @IHWGlasgow & @theSPHSU. Research interest: childhood physical activity, sedentary behaviour, diet, obesity, cognitive function. Tweets are my own.",1,0,1,0,2,300
2954414516,kodate_s,小舘 俊 postdoc /  bioinformatics / science of science / computational social science / network science,3,1,1,2,7,300
4809685105,cogcommsci,The Cognitive Communication Science lab at the UC Davis Department of Communication. PI @richardhuskey.,1,0,0,0,1,245
204721301,mollycrockett,"globetrotting neuroscientist investigating altruism, morality and economic decision-making",1,0,0,0,1,300
535702830,wkeithcampbell,"Social-personality psychologist; narcissism, personality, culture, shamanic medicine🐸🌵🐍, wealth science;
My posts do not represent University of Georgia.",1,0,0,0,1,300
612534082,adamspence12,Human Performance | Behaviour | Human Evolution,1,0,0,0,1,300
2652663877,regilapate,"Affective neuroscientist studying awareness & emotion regulation || Postdoc @UCBerkeley || Next: Asst Prof @UCSantaBarbara Psych & Brain Sciences, Summer 2020",1,0,0,0,1,300
752683668,wahyuwei,"Omnia probate, omnia probanda sunt. Test everything, all things should be examined. In love with philosophy, science, and meditation.",0,0,1,0,1,300
826185843442405381,Wen2hou,周雯. Unfocused psychologist. PhD candidate @DukeU,2,0,0,0,2,300
1861764991,paul1kirby,"Co-founder & CEO @zincvc Views personal, retweets not",1,0,0,0,1,300
3034737415,RedzoMujcic,"Assistant Professor of Behavioural Science @WarwickBSchool, The University of Warwick.",1,0,0,0,1,158
384704570,dacaste1,Biological anthropology PhD student. Binghamton University. Forensic anthropologist.,0,0,1,0,1,300
828771903020097538,hkeetz,@EmoryMSTP student in behavioral neuroscience. 🏳️‍🌈. he/him.,1,0,0,0,1,300
635515942,SGSmith_87,"Associate Professor interested in cancer prevention and control. Particularly focussed on adherence, novel trial design (with #MOST) & behaviour change.",1,0,0,0,1,300
4781723995,ICA_CSaB,The official Twitter account for the Communication Science & Biology Interest Group of the @icahdq https://t.co/OazLRB0PJ6. @richardhuskey at the helm,3,0,0,0,3,300
54734535,fernandopsantos,@JSMF Postdoc at @Princeton. Modeling collective dynamics & complex systems to understand human societies and multiagent systems. Previously @istecnico @InescID,1,0,1,1,3,138
118656046,JAMunozReyes,"Dr. en Biología, especialista en Etología Humana.",1,0,0,0,1,298
1209164154,olgakoz1,"Social Media, Computing, Enterprise, & Learning. Librarian & Associate Professor @Kennesawstate with focus on raising research literacy",1,0,0,0,1,300
407624682,NatRevNeurosci,"Nature Reviews Neuroscience features reviews, perspective articles and the latest research news. Tweets are from the editors.",0,0,0,1,1,300
41775045,naturewonder,Life science links,1,0,0,0,1,300
730298231763161088,EcoNetLab,"Working group @idiv led by Ulrich Brose addressing the structure, dynamics and functioning of trophic and spatial networks",1,0,0,0,1,300
132696617,RobertRose87,"Postdoc at @khoelzle @HPI_DE. Interested in team #innovation, digital #entrepreneurship, and #bibliometrics. Also, untalented windsurfer.",1,0,0,0,1,300
20982118,NatureMaterials,"Cutting-edge research in materials science, also at the interface with physics, chemistry, biology and medicine. Tweets sent by the editors.",0,1,0,0,1,300
29662127,Rex_Lui,Neuroscience | Systems Pharma | Precision Med | Next-Gen Biotech | Neurometabolomics || Triathlon | Surfing || Piano | Painting | Poetry | Go || D-US | Renew-EU,1,0,0,0,1,137
116922669,mrkm_a,"Birmingham Fellow at @Eng_Lang_UoB & Visiting Scientist at @RIKEN_AIP_EN / Interest: second language acquisition, corpus linguistics, quantitative data analysis",0,0,0,1,1,300
261659822,CeliaLahuerta,"🔖 E-learning manager, 💉 e-Health strategist, 💻 WordPress freak and 🌎 travel lover -Work hard, dream big- #digitalsolutions @OrixSystems #ehealth @watsoncme",1,0,0,0,1,300
2852511328,antica_c,"#NWONieuws grantee; manages @SPIbirds; into Open Science, systematic review & meta-analysis, sociality, ecology, behaviour; parenting choices (by necessity)",1,0,0,0,1,300
1566381392,IrrationalLabs,Using behavioral economics to change the world for the better.,1,0,0,0,1,300
139464402,Emily_Emmott,"@UCLanthropology BioAnth: Cooperative childrearing, child/adolescent outcomes, public health. Mixed Methods! PI Adolescent Sociality: https://t.co/b9Mv4BcHrQ",1,0,0,0,1,300
81858285,AB89136792,,0,1,0,0,1,300
113042852,RobWenzel,Consultant and CTO for Visionary Healthcare Technologies,1,0,0,0,1,300
806859396273807361,YvonneCMoriarty,"Researcher @CTRCardiffUni interested in health and wellbeing, young people, vulnerable and marganalised groups, prison health, qualitative and mixed methods",0,0,2,0,2,300
2162635887,EmilyLMather,"Academic interested in language, learning, and development. Teaches developmental psychology and statistics. #FirstGen 🌹",1,0,0,0,1,300
415921374,leedewit,"Lecturer in Political Psych @CambPsych, Author @eandtbooks, Fellow @TrinityHallCamb. Interested in behavioural insights, education and philosophy of science.",1,0,0,0,1,300
317653374,DNApesBlog,"Posting on pop science, conservation, biology, primatology, molecular ecology and genetics, human sexuality, culture, society and general nerdiness",2,0,0,0,2,300
722607412918792193,nspyrl,Neurofeedback and Neuromeditation Therapist,0,0,1,0,1,300
106216566,empowerElle,#Learning #Coaching #Leadership #FutureofWork #EmotionalIntelligence #CollectiveIntelligence #Cooperation #Facilitation #LifeAddict,1,0,0,0,1,300
227642182,DanPowell83,"Lecturer in Health Psychology. Research interests: stress & health, fatigue, self-regulation, real-time methods. Southampton FC fan for my sins. Views my own",0,0,1,0,1,300
3160228771,renzonancia,"Hater del buen café ☕
Enemigo de la lectura 📚🤓
Me caga viajar ✈🧳

                                                          Residente de la medicina interna.",1,0,0,0,1,300
1056298976,sam_macaulay,"Strategy, innovation + orgtheory. Senior Lecturer (~Assistant Prof) @UTS_Business || ex @ImperialCollege @UQBS Enjoys a good chortle.",1,0,0,0,1,300
719798971,yang_yang_feng,@Yale '16 | @wustlmed MD/PhD candidate in @monosov_lab,1,0,0,0,1,89
336871368,ShiraMorGlobal,"Columbia PhD & Harvard Research Fellow.  
Humanist, Academic, Social + Peace Activist. 
Israeli & American Citizen by Law & Cosmopolitan by Choice.",1,0,0,0,1,300
223227579,miquelpaniscus,Professor Serra Húnter a la @UdGEducacioPsic @univgirona. Director Científic a @iprimatologia @fundaciomona. President de @APEspain #PsicologiaComparada,2,0,0,0,2,300
1323310560,JohnJDowney,"Lecturer in health and exercise. Interests include: implementation science, realist evaluation, disease prevention and behaviour change",0,0,2,0,2,300
3141015404,studentofwbeing,Experimental Economics | Complex Systems,0,0,1,0,1,43
788184606763810816,meier_armando,"Postdoc at the University of Chicago. I am an applied microeconomist interested in Labor Economics, Health Economics, and Behavioral Economics.",0,0,0,1,1,300
1041278022,ThaliaWheatley,Social psychologist/ neuroscientist. Dartmouth prof and external faculty at the Santa Fe Institute (@sfiscience).,0,0,1,0,1,300
753648851790114816,STEP_APSA,"The Science, Technology, and Environmental Politics Section of the American Political Science Association (@APSAtweets)",1,0,0,0,1,300
595206056,AnnePisor,"Asst prof @wsuanthropology. Why & when do we build relationships across boundaries? Collab w/ 3 populations in Bolivian Amazon. Poly-methods, poly-stats, big ?s",2,0,0,0,2,300
151389815,existenceofman,,0,0,0,1,1,289
731478516181565440,rei_akaishi,"Decision (neuro)scientist, forager of knowledge or collector of anomalies, likes to push the boundaries a bit more... (opinions are my own)",0,0,1,0,1,300
3837815958,CulturalEvolSoc,This is the official account for the Cultural Evolution Society. Our mission is to promote the study of cultural evolution in research and practice.,1,0,0,0,1,300
1109591706,tavitonst,"Professor of Evolutionary Anthropology at UCL, interested in:   cooperation, culture, life history, family  (what's left?) music!",1,0,0,0,1,300
33383238,aldoluissi,"Sociologist, MBA. Behavioral strategy, evolutionary and philosophical musings. A slight touch of cognitive science. Just Reflecting in plain sight.

Tool fan.",1,0,0,0,1,300
26832834,NatureMedicine,Nature Medicine is a research journal devoted to publishing the latest advances in translational and clinical research for scientists and physicians.,0,0,0,1,1,300
3331110443,rachaelejack,"Computational social psychophysics, social perception, culture, facial expressions, social robotics. Reader, University of Glasgow. ERC funded. Views own.",1,0,0,0,1,300
167832441,dmiglios,"Professor and Director of Neuroscience at Saint Louis University. Tweets typically about science, with forays into beers and politics. #resist",2,0,0,0,2,300
707433649,nicholaraihani,"Professor of Evolution & Behaviour @UCL | Royal Society Research Fellow | Cooperation, punishment, reputation, fairness & paranoia.",1,0,0,0,1,300
605956105,ErinJNash,"Philosopher x Public Servant - political epistemology, ethical issues in #scicomms & free speech theory. Header - 'Cargo Cult' by Martha Rosler",0,0,1,0,1,300
60584150,mmuthukrishna,Assoc. Professor #LSE. Tech Director @ReligionHistory. Researching and spreading the word on how humans evolved & what that means for us today.,2,0,0,0,2,300
12704062,steffenhuck,"economist, opera and tv addict",1,0,0,0,1,300
61001305,freemanjb,"NYU psychology professor and social neuroscientist, studying split-second person perception, social cognition, & bias",1,0,0,0,1,300
2794664691,AHojbota,Confused citizen of Absurdistan,2,0,0,0,2,300
3261462764,ImmigrationLab,,1,0,0,0,1,236
2533800542,psywisdom,"Explorer of folk beliefs, sound judgment, rationality, ways to boost wisdom and miner of cultural evolution and change. Co-host of @OnWisdomPodcast",0,0,2,0,2,300
263359494,issbd,The International Society for the Study of Behavioural Development (ISSBD) promotes scientific research of human development throughout the life span.,1,0,0,0,1,287
1942816200,WSCriminology,"The Western Society of Criminology is a regional professional society devoted to the scientific study of crime.

*Retweets are not endorsements.*",1,0,0,0,1,300
2153427685,InequalityCU,The Center for the Study of Inequality @Cornell fosters basic & applied research on inequalities & the processes by which #inequality changes & persists.,1,0,0,1,2,300
199222248,ICCS_updates,Interdisciplinary Centre for Conservation Science - combining social and #ecological research to address key issues in #conservation.,1,0,0,0,1,300
2519946100,sethalow,"Distinguished Professor of #Anthropology, Geography & Environmental Psychology @GC_CUNY. Dir. of the Public Space Research Group at the GC. #MTAMO",1,0,0,0,1,300
467756681,vanbavellab,"The Social Identity & Morality Lab @NYUPsych. Conducting research on the social identity, morality & politics since 2010. Lab Director: @jayvanbavel",1,0,0,0,1,300
2875939799,TessaWestNYU,Professor of social psychology who studies the dynamics between two or more people,1,0,0,0,1,237
329884447,SocInFocus,"SociologyInFocus is a interesting, fresh, and sometimes irreverent sociological look at the world around you.",2,1,0,0,3,300
63511763,connected_book,Connected: The Surprising Power of Our Social Networks and How They Shape Our Lives -- by Nicholas Christakis & James Fowler. Active at: @NAChristakis,17,0,0,3,20,300
16264965,J_Cacioppo,University of Chicago Professor and Director of the Center for Cognitive and Social Neuroscience,1,0,0,0,1,300
33396367,lauriesantos,,1,0,0,0,1,300
86837398,torwager,"Neuroscientist, psychologist, occasional poet, father. Studying how thoughts and feelings are constructed in the brain, esp. with fMRI.",1,0,1,0,2,300
265933099,cdfrith,taciturn neuroscientist,1,0,0,0,1,300
459294549,SPSPnews,"The Society for Personality and Social Psychology promotes scientific research exploring how people think, behave, feel, & interact. Links, RTs ≠ endorsement",1,0,0,0,1,300
528879758,CogNeuroNews,"CNS is committed to the development of mind and brain research aimed at investigating the psychological, computational, and neuroscientific bases of cognition.",1,0,0,0,1,300
407766714,NatRevNeurol,Nature Reviews Neurology is a clinical review journal from Springer Nature. Follow us for the latest updates in neurology from the journal and beyond.,0,0,0,1,1,300
455082561,CSPO_ASU,"The Consortium for Science, Policy & Outcomes is an intellectual network with goals of linking #science and #technology to desired societal outcomes.",1,0,0,0,1,300
19388345,Limu61,,0,0,1,0,1,300
8561112,theaboutbox,I like to build applications,0,0,1,0,1,300
181096061,hotpaw,"DSP & iOS App developer. Amiga OCS architect & Mac 128k engineering. N6YWU, ballroom dancer, #rwri alumnus",1,0,1,0,2,300
16952180,Hasmanean,aequam memento rebus in arduis servare mentem,1,0,0,0,1,300
220177562,PapaHaapala,"Husband, father, golfer, manufacturing engineer (retired).",0,0,1,0,1,300
16838466,jiludvik,Interested in the world around,0,0,1,0,1,300
7585142,thijsbrilleman,,0,0,1,0,1,300
966264040547864576,sren1337,,0,0,1,0,1,300
1114259648326987776,Learn_Awesome,Community of lifelong learners. Humanity's universal learning map. Awesome learning resources from the Web organized with rich metadata. Open-source.,1,0,0,0,1,256
994231051898834944,TeamMarmot,"Investigating sociality, anti-predator behavior & genetics of Yellow-Bellied Marmots || Blumstein Lab @UCLAEEB and @RMBLGothic",1,0,0,0,1,198
976200176,CMc_PhD,"Academic researcher by trade, contemplator by nature. I love figuring things out and helping others to understand",0,0,1,0,1,300
1219713768231489538,waltertanzmann,The One and Only. Social Distant. King of the Kongo. Don't Follow me!,0,0,1,0,1,112
4420446134,matanature,"Plant-insect interactions, bringing nature back into cities, nature photography | @CAULHub Research Fellow at @RMIT_CUR's @PNP_CUR | Dad of a little monster!",0,1,0,0,1,300
1090698391368200199,_juliocav,culturas antigas e contemporâneas,0,1,0,0,1,300
753038243738836992,ilanabrito123,Cornell Biomedical Engineering Professor developing tools to study the human microbiome and its functions,1,0,0,0,1,300
980401908325199872,ve3hw,"Structural measures on graphs, evolutionary game theory and complex networks, HPC. Retired telecomms engineer. Musician. @InfAtEd",0,1,0,0,1,192
1231264100673638406,FjLaborie,"#Bioinformatics and #cancer #genomics. 
Postdoc in @tklabuk lab -
@gurdoninstitute",1,0,0,0,1,28
1067801045567442944,AashliPathni,a second year grad student at @UofMaryland studying the cytoskeleton in immune cells in @arpcomplex's lab | she/her,0,0,1,0,1,139
44310532,adelynechan,"PhD Student @CRUK_CI @narita_lab interested in cellular senescence and early tumorigenesis. Also enjoys crafting, travelling and knowing random things.",0,0,0,1,1,244
18296223,johnurbanik,"#notanepidemiologist trying to foster healthy cross-disciplinary collab and bayesian methods in epi. Previously @Predata, @palantirtech, @Poptip, @Princeton ++",0,0,1,0,1,300
10837312,csibug,,0,0,1,0,1,300
15098602,ryannadel,"Sr Program Manager @microsoft working on #mixedreality and HL. Former journalist, founder @playbiba and https://t.co/pZZ9WZ44I8. Chair of AR advisory board @aixrorg",1,0,0,0,1,300
127518057,mingos3,relentless restlessness,1,0,0,0,1,300
857214014618730496,nemeth_andor,,0,0,1,0,1,300
1079050669502484480,zspreadzalan,,0,0,1,0,1,300
155691814,craig_tony,Environmental psychologist and head of department (SEGS) at the James Hutton Institute in Aberdeen. Views are my own.,1,0,0,0,1,300
3226394275,ShaunTobikosan,Health Not Fitness Consultant/Trainer,0,0,1,0,1,300
872274950,Tim_Dettmers,PhD Student at @UW. I blog about deep learning and PhD life at https://t.co/ZuZtPMo4CT.,0,0,1,0,1,300
1246087082142887936,jerjerjerjerjer,Nothing extraordinary.,0,0,1,0,1,36
888079310464135169,TxitxoBenitez,"Quant fund manager, lapsed astrophysicist, Russian translator, father of three kids. Freethinker.",0,0,0,1,1,166
79012768,zahari4i,,0,0,2,0,2,122
14524348,wiemann,Adventurer,1,0,0,0,1,300
33843699,taenurpan,,0,0,1,0,1,194
483780067,spintoza,Citoyen ordinaire; chez l'humain tout est entrelacé ; I’m an ordinary citizen; biology and culture are utterly intertwined.,1,0,0,0,1,300
10713022,lsdr,"Software Engineer, Head of Data Engineering and Analytics at Tapps Games",1,0,0,0,1,300
3385300678,michael_e_cox,"Environmental social scientist, associate professor of environmental studies at @Dartmouth College. Co-host of @find_sust_pod at https://t.co/9JswqYSIcG",1,0,0,0,1,300
1273070755,njabulo450,,0,0,1,0,1,300
4188003983,finnthormeier,23-year-old with no clue about life,1,0,0,0,1,300
29011894,wgaluba,,4,1,0,0,5,214
1615259587,PeteMali,that https://t.co/S6E0FWvWEu™,0,0,1,0,1,300
1036744427144990721,pjlehner,Still testing,0,0,1,0,1,300
266523872,ssardoinfirri,"trading, math/physics, flying, languages, localism",0,0,1,0,1,271
149369106,dawoodhashmat,"Learning about E- commerce, Branding, Online Marketing, Cryptocurrency & Blockchain, Mental Models and Becoming Stronger.",0,0,2,0,2,300
2855222812,david_dikker,srWhoopsEngineer,1,0,0,0,1,300
215260835,scotteustace,"Remarks may be fictitious, fatuous, ironic or wrong, especially in hindsight. It is false to say they represent the views of their author.",1,0,0,0,1,300
781025691072684033,Dirk_Hemil,,0,0,1,0,1,300
88751588,tauslu,"Finance, Technology and Aviator",1,0,0,0,1,300
498788414,MFergal,"Uncertainty, Environment, Health, ...",0,0,1,0,1,249
1072554115773947904,PejmanMoghbelz1,Agile Consultant|Digital Transformation|MBA|PMP|SAFe Scrum Master. Head of Project Portfolio Management office.,0,0,1,0,1,300
2998870522,JKenny_47,Former Postdoctoral Researcher at @uniofreading | Materials Science and Chemistry | Fiancé of @YasminLazTEP | Guitarist | 'Dead' languages,0,0,1,0,1,300
818051742071922688,mattigags,"@zeeprimecap

Disclaimer: Optimist",0,0,1,0,1,300
2862269710,Srikar_Vy,,0,0,1,0,1,300
999563728734605312,Miles13089546,,0,0,1,0,1,300
394078978,ChmirouZakaria,Complexity | Homesteading | Regenerative Ag,0,0,1,0,1,272
106947202,vrlonghorn,,0,0,1,0,1,300
831346233813979136,theeclecticseer,"K S Rao Ret'd public servant. Public Interest; Freethinker.

Ideologies ringfence one from reality. 'Isms' close windows of empathy.
RTs not endorsements.",0,0,1,0,1,300
888333676903378945,MauriceMassaad,"Observant mind - Curious about History, Philosophy & Science - Practicing Scientific Thinking カタ - Swimming, Biking & Running.",0,0,1,0,1,300
965458895702503424,Rkksci,"Engineer and scientist with interests in ai, biotech, economics",2,0,0,0,2,122
573687731,vkomissarchik,Artist in a technological domain | Stoic Developer | Founder of @themyclok,0,0,1,0,1,300
974154769,DrewAllen18,"Traveler, Chef, Business development and Angel Investor, speaker and blessed to be married to a Brazilian",1,0,0,0,1,181
39581988,yojobo20,,1,0,0,0,1,300
4830495972,ThereseHernando,Finding Magic,0,0,1,0,1,262
727479053620490240,kindly_ai,"Head of #Innovation #Lab at #BRD @SocieteGenerale. Game Designer, passioned by #ML & #AI. Love my cat",1,0,0,0,1,300
29878067,nabilshadman,"Studying CS @UCSanDiego • Curious about risk-taking, technology, arts, and philosophy • Love adventure, traveling, sports, and (good) books",1,0,0,0,1,300
240587283,FurqanAfsal,Electrical Engineer. Computational Neuroscientist. PhD Fellow @IcahnMountSinai. Former Research Engineer @StanfordMed. Neuroscience/ Machine learning/ AI.,0,0,1,0,1,297
1007859415,JamesNamor,,0,0,1,0,1,300
189603117,ebruenner,"I was a spice merchant.  Very good w/ the ctrl-c, ctrl-v.  Pretty solid servomechanism.",0,0,1,0,1,300
1598780682,josephdevereau,"Interests: Artificial Intelligence, Software Engineering, Mathematics, Healthcare Management, Data Analytics, and Sports Medicine Physician",0,0,1,0,1,300
1114685772739772418,RogrioP29070619,physicist; complex systems; cubesat constellations!,0,0,1,0,1,232
703353159394131968,DaveHerderNL,"Take it all with a grain of salt. Learn how to fish, light a fire and sleep under the stars.",0,0,1,0,1,294
1114019809274949633,DanteNoguez,Ô ma mère Intelligence !,1,0,0,0,1,145
50306546,StoryConnector,Life-long learner dedicated to cultivating curiosity & making the complex understandable; writer at heart; analytical researcher; PR/marketing pro,1,0,0,0,1,300
2326716338,Benoit_Allen,,0,0,0,1,1,300
1447779864,JeroenNieuwkoop,,1,0,0,0,1,91
11785512,rvasa,"Professor @Deakin University. Head of Translational Research, Deakin Applied AI Institute @DeakinA2I2. Software engineering, complex systems, Applied AI",1,0,1,0,2,300
1912791378,Bendzamin100,It's all about the Benjamins.,0,0,2,0,2,300
1231770665646252033,CryptoFarmer5,,0,0,1,0,1,300
2591249664,rleiteritz,"Google Director of Product Management (Maps+Shopping), Angel Investor, startup CEO. Organizer of the Product Management Festival https://t.co/xYn3KGf0sH",1,0,0,0,1,300
60618578,DomJofo,Honey Enthusiast :) - Stupid is as stupid does. FG,0,0,1,0,1,300
2511073098,iamlucasmreis,"Carioca, Economics undergrad, former musician and consultant, currently building software at @Compass 🇧🇷🇺🇸",0,0,1,0,1,300
724031614540353536,SAlhir,"Business Agility/Antifragility & Digital Transformation Leader - Entrepreneur, Author, Coach, Consultant, & Practitioner",1,0,0,0,1,300
917471988750409729,BDufournet,Neurologist. Entrepreneur #Bitcoin Cold Expos. Begin. #IF #LCHF #Keto. Interest. in Longevity - Cognition & Biases - Probability in Medicine. Fighting #COVID19,0,0,1,0,1,300
956495781543981062,sergesapiens,#staythefuckhome. Information revolution artisan. Humbled by complex systems & properties. Favors de-centralization.,0,0,2,0,2,300
1394788638,RealKenMayer,"Northwestern, UNLV & Minnesota alumnus",0,0,1,0,1,300
168880491,mdelucia21,I like learning stuff,2,0,0,0,2,300
436086797,fasinfoxtrot,Technology | Finance | Business | Bitcoin,0,0,1,0,1,300
1087857719846076418,PurushAgni,"New Englander, Bird Enthusiast, Combustion Scientist",0,0,1,0,1,31
42849448,mouneer,CTO @revosuite & @beamkastinc https://t.co/x8WGvgtIQd https://t.co/xUh5J3ZyfL ex-clinical pharmacist ex-tech product manager https://t.co/7HQvVY0xbJ,0,0,1,0,1,300
2231351396,sturdystone,,0,0,1,0,1,300
1058065919161917440,MrFels,"Risk, Resilience, Fragility, Complex Systems, Security, #RWRI",0,0,1,0,1,251
801307789712834560,ismafficionado,,0,0,1,0,1,174
224253155,ambivalentcase,"#vinyl & #p0rn connoisseur 

Trolling around since 1999",1,0,0,0,1,300
2323806770,RobertH90430077,Writer,0,0,0,1,1,57
985646914627620865,YousefIb88,Credit analyst right now/growing up as an economist with high passion to social networks/ ready for any anti gov protest anywhere😀,1,0,0,0,1,11
4707631099,roughfractus02,// Fluctuat / nec / mergitur //,0,0,1,0,1,300
2186859162,vitorcautiero,,2,0,0,0,2,39
806110196175147008,nicospinu,Passionate PharmD Researcher @in3itn @MSCActions PhD Fellow at @LJMU Becoming a scientist in #CompTox #3Rs #animalfree #insilico testing,0,0,0,1,1,124
1012565516,Conor_OW,Scientist ~ ANU brain imaging PhD ~ views my own,0,0,1,0,1,300
2227280802,jerrycueb,Safety Science and Scientometrics,0,0,0,1,1,300
413800955,ZdenekKvapil,"Managing Q4IT, author of DCMM, IT Quality Index, itSDFI conference founder.",0,0,2,0,2,300
1098876570360532992,anjitarun,"PhD Candidate at the EPFL under Prof. Dimitri Van De Ville.   Research topics : graph signal processing, machine learning, neuroimaging, fMRI and diffusion MRI",0,0,0,2,2,25
49024357,Pouriaaa,"Lead Software Engineer. MRSB. Politics aficionado. Python specialist.
Researcher in neuroscience, biomedical data science, AI/ML, and bioinformatics.",1,0,0,0,1,300
179294617,LucyBlakemore,Research & Insights Consultant | Facilitation & workshops | International Education | Listening = fuel for innovation,1,0,0,0,1,300
1011585253423665152,MSlavkovik,Electrical engineer. Computational Logician.  Basic AI researcher.  A loud mouth (≠ philosopher). https://t.co/PrAXhimcml,1,0,0,0,1,300
14291846,davkell,Digital Humanities Manager @nuigalway. Digital projects & data visualisation with researchers from @MooreInst. Interested in creative technology,1,0,0,0,1,300
60947918,basster_,Microbial Ecology & Evolution. Soil & Ecosystems Ecology. Ms. Sc. student at IE-UNAM. | Also a lot of nonsense,0,0,0,1,1,300
149364793,uthamkamath,Engineering@Groq,1,0,0,0,1,172
3029976639,Ann_Qnn,,0,0,0,1,1,300
380993093,MarcRuby,"Former hedge fund manager, now probing the perimeter of my circle of competence.",0,0,0,1,1,300
1091761212596064256,lrvelaa,"A skeptic-flâneur-medical doctor interested in complex systems, randomness, the role of luck. I just want to be less dumb and survive.",0,0,1,0,1,300
1431480506,helenaandrest,"🔬AI & Machine Learning PhD @Cambridge_Uni 
🪐Physicist 
🕸Graphs and complex systems research 
🔆 Ultimate Frisbee",0,0,1,0,1,7
803777,billjohnston,Founder @Structure3c: I help companies activate intrinsic value through virtual communities & human networks. I also make excellent crepes.,2,0,0,0,2,300
183866897,_doctorgaz,I teach physics. I used to be a professional physicist. I'm writing textbooks and worksheets for physics teachers.,1,0,0,0,1,300
943177987,NeenyiA,GOD LOVER,2,0,0,0,2,300
4918620598,IvanIvanpuga,,1,0,0,0,1,28
1025017515997581312,ayanmandal_,PhD Candidate at @psychiatry_ucam thanks to @Gates_Cambridge | Network neuroscience to understand neurological disease | @Georgetown '18 Neurobio & Physics | 🧠,0,0,0,1,1,93
309259968,eisamahyari,Researcher @ohsu @onprc #primate #genetics #computationalbiology #machinelearning #singlecell and wandering interests of my lipid-based #neuralnet. 改善,0,0,1,0,1,300
861963252284219392,MorganKThomp,Graduate Student in History and Philosophy of Science at Pitt. I'm interested in philosophy of neuroscience and feminist philosophy. She/her.,0,0,0,1,1,193
3374351032,Jorge_A_Moncada,,0,0,1,0,1,257
1200099336878735362,AlphaAdder,2005 to Present Applying Complexity theory to S&P500. Milestones; Able to identify (1)Six Sigma Crash Precursors. (2) Phase/Context. (3) Inflection point timing,0,0,1,0,1,300
14216117,harmodio,se regala escombro teórico,1,0,0,0,1,300
103843885,Suvi_it_is,Math | Computation | Indian | Data | emoji guy | Happy,0,1,0,0,1,300
1087489141292613633,pablotalavante,"math, music, art and ai",0,0,0,1,1,195
362403033,dirk6bruin,Fascinated by evolution and complex systems: ' What is a Firm?' Corroborating new Firm Theory with other systems natural and engineered.,0,0,2,0,2,300
3070929651,Inge_vanVugt,"Historical Network Analysis, Disclose reading, Antonio Magliabechi (1633-1714), Republic of Letters. Postdoc @ERC_SKILLNET, Utrecht University.🐢",2,0,0,1,3,149
100647851,adhuerta,,0,0,1,0,1,106
70198432,alicialamalicia,"#SmartCities, #innovation, #sustainability, #oceans. Working @SwissRe using tech for a better world. Personal views here",0,0,1,0,1,300
1099023882630164482,nullsp4c3d,"Data-driven nonlinear dynamics, complex networks, and scientific visualization.  Ph.D. student at Georgia State University in the Belykh Lab.",1,1,0,0,2,91
368052200,alzxy,S̴̰̩̫͔̱̲̘̤̑͌̆͋͝t̸̨̛̛̞̪͎̖͒̒́r̸̢̡̨̪̖̣͖̈́͊͆̚a̷͇̳̓͠ţ̴̖̗͚͓̙͈̫̟̻̄̿̐̄e̸̡̘̘̜̜̗͚̤̳͍̔̽̉́g̵̻̅̇̔̀̍͜ist. Partner/co-founder at Class35. Designing for the bottom line.,0,0,3,0,3,300
25553813,tompeters1,"New Business & Healthy Food stuff @Deliveroo | food | fitness | yoga | sneakerhead | fashion | startup mentoring | music (own opinions, RT/MT not endorsement)",1,0,0,0,1,300
1203244641228926981,MichalShur,"Law Professor at the Hebrew University. Interested in Innovation, Intellectual Property, Networks, Complexity, Meta-Science, and more.",0,0,1,0,1,12
68019192,hoont0107,Assistant Professor @HKUST. Interested in labor markets and careers. Studies social networks.,2,0,0,0,2,300
901698617991348228,bn_becker,"Neuroscientist - my group explores strategies to modulate emotion-cognition brain circuits, now evaluating therapeutic potential",1,0,0,0,1,300
301771633,jchicaiza99,"Ph.D(c) @TU_Dortmund 🇩🇪, Operations & Logistics https://t.co/TRFPL9TdEz. ESPOL, and Ing. EPN 🇪🇨. Urban Logistics Researcher using Simulation and Optimization approaches.",0,0,1,0,1,300
49779808,wamasters,"Professor @tuftsnutrition, @tuftsuniversity, on economics of agriculture, food & nutrition. Teaching blog here:https://t.co/4tDFAlVnBL. Just like this IRL too.",1,0,0,0,1,300
478154330,RawBTC,Still falling down the ₿itcoin rabbit hole  🕳 🐇,0,0,1,0,1,300
1196538180759097345,appliedmagic,.:: complex systems marine scientist :: experiential artist :: mother of submarines :: evangelist of embodied wonder ::.,0,0,1,0,1,23
2321257729,Anarion8,Probieren größer als Studieren größer als Twitter,0,0,0,1,1,98
541812990,amykmcl,Facilitator. Researcher. Ethnographer. Collaborator. Tech. Med. HumSci. Design. Culture. Wellbeing. Policy. Food. @3AInstitute @oxford_anthro @MonashScholars,0,0,1,0,1,300
1189793002488815616,liorhakim1,,0,0,0,1,1,25
14168241,thelucrece,Pioneer in incubator/accelerator/coworking. Building the #RiotoRockies ecosystem w/ @techgrindlabs | @fight4founders | NM native & @Babson bred,0,0,1,0,1,300
2490461,jesusrenero,#AI & #ML @bbva. Professor @ieHST. Curious and continuous learner. These are my personal opinions.,0,0,1,0,1,300
141202493,arinbjornkol,"PhD student @imperialcollege working on ML, tensors, brain MRI and other medical data. Former research intern @samsung AI Cambridge",1,0,0,0,1,144
1236447420,ElePapaleo,We are an enthusiastic group of researchers in computational biology. Our home is at the Danish Cancer Society Research Center in Copenhagen,0,0,1,0,1,300
2999698870,mindreadytools,,0,0,1,0,1,300
2615417334,vanl1m,,1,0,0,0,1,275
36350905,rokamo,Co-creator of Spriteville. Dynamic Art https://t.co/wZ6hXSrZZX / Cofounder CEO of Celly.,2,0,0,0,2,300
36379268,diarmaidupton,Director @blackboxstudio_ PhD researcher in bioregional design @UL,1,0,1,0,2,300
761130610912092160,Wen_Jun_Xie,a chemist using physics and math to solve biology problems @MIT @PKU1898,0,0,1,0,1,247
760068146552156160,karmecon,Cat herder at @openforcefield Initiative,1,0,0,0,1,300
895734457503633408,brunoccast,software dev. right-wing. mostly watching. learning 🇯🇵,1,0,0,0,1,300
3917595395,commandodev,Operational principles from the Royal Marines and 10 years in tech leadership for building world beating tech teams.,0,0,1,0,1,300
3371558375,SFElenaLab,"Evolutionary Systems Virology group at @i2sysbio.
Head of the lab: @SantiagoFElena.
Tweets by @GonzalezRvirus and @SantiagoFElena.",0,0,1,0,1,300
354549167,eszterlikesrain,"PhD in comics / researcher and curator / lover of dinosaurs and coffee / director of International Comics Festival Budapest / she, her",0,0,0,1,1,300
40218183,sgebbie,Software Architect interested in large-scale distributed and complex systems.,0,0,1,0,1,0
801701957681512448,b_sabater,,0,1,0,0,1,300
3432067299,maxbillmann,"Postdoc @UMNComputerSci, interested in computational biology, machine learning, functional genomics, CRISPR screening",0,1,0,0,1,220
519777806,oxbsharp,"Mostly functional programmer; double bassist in a Beethoven cover band; banjo player; failed librarian

https://t.co/h4IxIZ3z4S",0,0,1,0,1,300
1288683445,Robelkbd,learning,0,0,1,0,1,300
2533220215,Jandrade0112,"Biophysics and complex systems grad student @mattertolife | 
Statistical physics and the land value tax |
Co-Founder of the Harvard Science of Psychedelics Club",0,0,1,0,1,300
615681692,rduartegonzalez,Ph.D. student in Political Economy & Government @Harvard & @Kennedy_School. From 🇵🇾,1,0,0,0,1,73
2713955520,WiedenhoferD,"Social ecologist working on sustainable consumption and resource use, investigating barriers and pathways for a sustainability transformation @BOKUvienna",0,0,1,0,1,300
21077317,benhamley,"Changing why, how and where people work. Asia-Pacific Lead: Future of Work @JLL (I tweet for myself)",0,0,0,1,1,300
25174929,panlong90,"night time designer, maker, #toknote, #FrameItAR, daytime PM",1,0,0,0,1,300
4370441597,josue_econ,Lecturer in economics (AP) at @QUBmanagement using economic theory to understand social integration.,1,0,0,0,1,100
4910530625,Conductal,"Through facilitation and advisory, we reinvent teams for the 21st century.  Alignment, focus, scaleability, and adaptability for constant change
https://t.co/gyxKW4yhaF",1,0,1,0,2,300
81428707,admndrsn,"Near Eastern Studies, Cuneiform and Digital Humanities",1,0,0,0,1,179
894598652840300545,joselina_bea,"Rioplatense.
Estudiante de Doctorado en el Centro de Investigación en Complejidad Social (CICS - UDD)",0,0,0,1,1,300
812411768442126336,KeilandWCooper,Neuroscientist who aims to pull the AI out of brAIns; Learning and Memory; ephys and comp | @ucicnlm | @ContinualAI | IU CogSci / Neuro Alumni,0,0,1,0,1,300
462032758,RhiannonLEdge,"Lecturer of Population Health, Lancaster Medical School.
PhD Statistics and Epidemiology.",2,0,0,0,2,206
89283737,utkarsh_amitabh,"@Microsoft, Founder- @netcapglobal, @INSEAD MBA, Chevening Fellow @UniofOxford, @wef Global Shaper (Davos 50), @inktalks Fellow, TED Speaker, Writer - @livemint",1,0,0,0,1,300
798151931336294400,r_ortegaargiles,"Professor of Regional Economic Development, City-REDI Institute, University of Birmingham. Opinions/Retweets are my own.",1,0,0,0,1,300
14083718,CLouvi,I build purpose-driven business systems that transform teams. • 2X Podcast Host,1,0,0,0,1,300
33098821,johnsonwhitney,"We help leaders and the people they work become fluent in the language of growth; personal disruption expert.
wj@whitneyjohnson.com",1,0,0,0,1,300
3320096765,drenarios,probably approximately incorrect,0,0,1,0,1,300
15317166,llocklee,Network Analysis Practitioner; Researcher; Helps you find the 'right' connections. Co-Founder Swoop Analytics,1,0,0,0,1,300
1091313632644870144,ognibit,Idee Digitali,0,1,0,0,1,164
2858607988,socther,,1,0,0,0,1,164
40904201,brennantownley,CEO @ https://t.co/kUY1sEkahy. Views are my own. @theDiff_erence,0,0,0,1,1,300
376537920,davidenko_gye,"Ph.D. Candidate of Sociology at University of Florida. Migration, Health and Social Networks. I also make collages in my free time.",2,0,0,0,2,300
1140133408229617664,Skarding1,PhD studying dynamic complex networks,0,1,0,0,1,0
5811092,slopezlago,Complex Systems Designer. Views = mine. RTs ≠ endorsements.,0,0,3,2,5,300
952228110824628224,EliCornblath,MD/PhD student at @Penn working w/ @DaniSBassett. Interested in data-driven diagnostic tools and network models that link brain structure-function.,0,1,0,1,2,221
924606381369495552,YuanmoHe,"MSc Applied Social Data Science @MethodologyLSE. BSc SocSci @UCL. Interests: social interaction, social networks, inequality.",1,0,0,0,1,17
47368798,andy_draxinger,"Consulting, Transformation, Management, Accounting, Controlling, Finance, Reporting, SAP, Data Analysis, Digital, Tech, Football",0,0,2,0,2,300
957780781757235200,rpatrik96,Electrical engineering MSc student,0,0,0,1,1,62
2221799833,AdelaIsvoranu,PhD NWO Research Talent @UvA_Amsterdam | Psychosis | Dynamical systems,0,0,2,0,2,242
25859232,vivineri_,"In my brain: Biology, Genetics, Bioinformatics...because SCIENCE!",0,0,0,1,1,300
3283901,andrewchen,"writing a new book with @HarperBusiness // general partner, a16z",1,0,0,0,1,300
516912226,USaskSSRL,"The SSRL is a premier research facility that supports faculty, staff and students doing cutting-edge social and applied research.",1,0,0,0,1,300
1036604392043110400,BernardoMemo,"Psychiatry resident // PhD student @ULisboa & @MaastrichtUniversity. Humanism, complexity and simple pleasures.",1,0,0,0,1,25
1127207931336957958,tianqiang7,complex networks,0,1,0,0,1,0
1365707036,JamesRAllison,,0,0,1,0,1,300
1126198450851328001,MeganKonar,"Assistant Professor @CEEatIllinois. Research on water, food, and trade. @UCBerkeley @UniofOxford @Princeton grad.",1,0,0,2,3,299
1104433966638133248,gergelyturi1,neuroscientist,0,0,0,1,1,130
3097437807,claire__aoi,"Mathematician. Curious about how things work, or don't. Along the flaky topology of perishable thoughts. 
Postdoc in RL.
#Berlin - #Shanghai #Another #AI",0,0,1,0,1,110
1110626252015194112,charlesdavihat1,"Previously: https://t.co/gSzkk3aN9N

See below for what I do now.

This is not legal or investment advice.",0,0,1,0,1,300
64761646,rsgonner,Physician interested in application of Complexity Theory to health care and medical education.  Writer and lecturer.  Rocky Mountain enthusiast!,0,0,0,1,1,300
1067494335866945542,keyorgsys,"Full Stack Business Consulting
#BizArch
See all the things | tangents are the path",1,0,0,0,1,300
780828430325600256,artjomshl,"Post-doc @ IJP PAN & research fellow @unitartu. Literary/cultural history, quantitative methods and cultural evolution; sometimes video games",1,0,0,0,1,240
3237071099,nlmedina17,@possefoundation,0,0,1,0,1,186
427759601,LeMarines,"Service & Interaction Designerd @FJORD Mexico City ¶
Guest Lecturer @CENTRO_news | Design Studies Program ¶
Knowmad & Co-Founder @reDsistemico",0,0,2,0,2,300
178906549,_MondoBizarro_,"Informatics PhD @Illinois_Alma (Origin of Life research). 
Coffeeholic. Bibliophile. Love cats.
Awed by all things quantum and cosmic.",1,0,0,0,1,300
1078365600,ShenmengXu,"Ph.D. student @ School of Information and Library Science, University of North Carolina at Chapel Hill. Scholarly communication, scientometrics, and altmetrics!",1,0,0,0,1,247
33807791,nidhiktuli,"User Experience, Interaction Design, Product Design.Amateur photographer, love yoga, hiker, so called runner, a foodie +loves to cook, a geek",0,0,0,1,1,300
1110529961046261761,SysbioS,"Official Twitter page of the Synthetic and Systems Biology Unit, Biological Research Center, Szeged, Hungary",0,0,0,1,1,208
165645132,samleechch,egg enthusiast ~ also a computational biologist ~ he/him,1,0,0,0,1,300
37771231,ayoshiaki,Possui doutorado em Ciência da Computação pelo IME-USP.  É professor na UTFPR de Cornélio Procópio.,0,0,1,0,1,100
1054069115839791104,GrowGiant,"Designer of Rogues to Riches, the Foggy Map and other odd card games. Ask me about Plenty of Go Fish, a game about consent.
He/him.",0,0,1,0,1,300
222442446,arkya_C,Ich bin ziemlich protzig. (he/him),0,0,1,0,1,300
2321493173,DrNaamahagiladi,"#holisticurbanist and #Architect focusing in #urban sociology mixed with Data (Big, small and rich); Londoner, European, Views are mine (I hope)",1,0,0,0,1,300
1054141644772003840,psych_of_tech,Official twitter account of the Psychology of Technology Institute.,2,0,0,0,2,300
1106864803589619712,AukeHunneman,,0,0,1,0,1,239
1638762066,ulgenklc,Tailoring topological tools for the data | Ph.D student in #Math @Ubuffalo | Istanbulite | Tree hugger 🍀🌲,0,1,1,1,3,300
1347789200,rudzinskimaciej,"Neuroscience, Statistics, EEG, ML, founder of BrainAttach & Brain Tracking",0,0,1,0,1,300
1425583374,dannybuerkli,"Co-Director & Founder @staatslabor (🇨🇭gov reform lab), Exploring next public administration paradigm + #selforganisation in gov't, previously @cpi_foundation",0,0,1,0,1,300
133446914,doligalski,,1,0,1,0,2,300
3300384617,MasterAIV,Master program in Interdisciplinary Approaches to Life Sciences - Paris @UParisDescartes @ParisDiderot @criparis #synbio #interdisciplinarity #education,0,0,0,1,1,300
1003152145854562305,singh29_aditya,"Research Scholar, @NCBS_Bangalore",0,0,1,0,1,300
35627847,dechurch,"Northwestern Professor understanding and inspiring teamwork and leadership everywhere, Chair of Communication Studies, Director of ATLAS lab, I/O Psychologist",2,0,0,0,2,300
1096181734515884035,juanchirdc,,1,0,0,0,1,26
950801679133405185,vhranger,"Data scientist. Ex poker pro. Blogging on economics, software, statistics and games @ https://t.co/wLSfuWpsrX

Mod of /r/economics and /r/badeconomics.",1,0,1,0,2,300
1095131138174210049,zfpatny,NYU Stern Class of '19.,1,0,0,0,1,7
1094492544640188416,minyi_1,Possibly the last millennial to join Twitter?,1,0,0,0,1,7
245793741,gorkalasso,"Research Assistant Professor @ Albert Einstein School of Medicine, NYC. Structural bioinformatics, cryo-EM, Systems Biology https://t.co/Idbr9pGOYD",1,0,0,0,1,193
784005264290840576,Jessica_Fritz92,"PhD student @Cambridge_Uni. Interested in mental health, adversity, resilience, transdiagnostic interventions, & psych methods. Also mind-wanderer. Views=mine.",1,0,0,0,1,300
3399792130,essmind,"Eternal student lost in the beauty of complexity in the way to contribute to a better world. Improving my understanding of animals, in gen., and humans, in part",0,0,1,0,1,270
110557285,MarioMonforte,"I create things for the intellectually gifted,
Contemporary Artist at some art museums.",1,0,0,0,1,300
972644006403256326,yixuanpub,Flâneur,1,0,0,0,1,134
1036625409394192384,odysseans,"think deeply, control emotions, love life",0,0,1,0,1,208
47038072,srjit_,Data Science padawan at Network Science Institute | Northeastern University,1,0,0,0,1,300
829588737986289664,mihai_valcu,"Research scientist at the Dept. of Behavioural Ecology and Evolutionary Genetics, Max Planck Institute for Ornithology, Seewiesen",1,0,0,0,1,43
2366752754,PRoberts666,"Systems thinking, consultant, lecturer. OU, CASS, Leeds Systems Thinking in Practice #systemsthinking #complexity #viablesystemmodel #cybernetics",0,0,2,0,2,300
1081311646058897408,OscarCrdoba11,"De físico, economista y loco, todos tenemos un poco. Deseando que la https://t.co/VG9A7nPzOP. se vuelva un pueblo bicicletero. Analizando la vida desde los Sistemas Complejos.",1,0,0,0,1,101
2572864414,BeauchampDr,Professor @UBC | #GroupDynamics #Exercise #Sport #Performance Psychology,1,0,0,0,1,300
2415244422,101HealthRsrch,Email us at hello@101healthresearch.com #Epidemiology #Biostatistics #ClinicalResearch #PublicHealth #DataScience #EvidenceSynthesis #HPSR #CapacityBuilding,0,0,0,1,1,300
18682950,ryanshanks,Sports Agent to Financial Advisors; Founder of @FAMatch and @Finetooth 👉🏼ENFP👈🏼 #Inspire #Empower #Lead #WealthManagement #Recruiter #Finserv #Fintwit,1,0,0,0,1,300
1027621655575752708,EthanShafron,"Into land use, water, people, & data science stuff. [Geospatial] data wrangler w/ @ASU_GDCS. @uvmvermont 2019. Clevelander",0,0,1,1,2,163
20545925,sourcePOV,Thinker. Instigator. Explorer of edges. Author: @collabdna | Passion for #simplerules #futureofwork #digitalworkplace #coffee views are my own,1,0,0,0,1,300
3306459006,Bill_OY,,0,0,2,0,2,300
1068880722662961158,pgupta_ci,Research @TepperCMU: Design of Technology-Augmented Intelligent Teams,0,0,1,0,1,42
174044007,andrekerygma,Organizo cores para agradar suas bolotas gelatinosas captadoras de luz,1,0,0,0,1,300
1072881040270737410,RamonGrasAloma,Urban Innovation researcher at Harvard University. Co-Founder at Aretian Urban Analytics and Design.,0,0,1,0,1,300
811257851012325376,Andrew77919751,,0,0,1,0,1,300
2245207902,aditpandas,"Doctoral Student at University of Cincinnati

#ROS #ML #AI #python
https://t.co/yGGtCqjxy7",0,0,1,0,1,202
75582230,sarajimenezc,PhD student @IGBMC in @Gradwohl_Gerard’s and @Molina_lab’s labs. Passionate about systems and computational biology. Coffee and chocolate enthusiast ☕️🍫🏃🏻‍♀️,0,0,1,0,1,99
726104929711050753,chaitraGopalapa,"Assistant Professor, Industrial Engineering @UMassAmherst. PhDStudent/RA positions available. Details in weblink below",1,0,0,0,1,180
17090308,GerryMoran,#Tech marketer improving the world with better #contentmarketing | Global Head of #SocialMedia at Cognizant | Springsteen fan | #B2BMarketing | #Craftbeer geek,1,0,0,0,1,300
14047537,allisonx,Multidisciplinary artist. 🌱✨ 📷https://t.co/LIR76rd9nt,0,1,0,0,1,300
2842588901,fpazos_bioinf,,0,0,1,0,1,300
899715998890242048,aljabu01,"I´m a little bit of eveything all rolled into one!!😉
https://t.co/lJ9hmW9UtV
https://t.co/1KDxMoME9X",0,0,1,0,1,23
576423157,RaviVarghese,"Flutter all ways, and fly in none. Football, finance & climate solutions",0,0,0,1,1,300
29372089,KBrownianMotion,"PhD candidate @yale studying ecology and evolution. I use viruses & modeling to learn about trade-offs. Also interested in sabermetrics, math(s), and networks.",0,0,0,1,1,300
86260111,ELKHORCHANI,"Tunisian trying to understand the world and its complex systems.
I am Working in Business but thinking to all.",0,0,1,0,1,300
2872853783,TilenGenov,"#Cetacean & #conservation scientist. President @Morigenos_org, PhD student @_SMRU_, teaching assistant @ University of Primorska, member @IUCNCetaceanSG",1,0,0,0,1,300
950809614832033793,CristianCJRuiz,A Humanist becoming a Complexity Scientist 😱💓,0,0,1,0,1,300
779511230,mlevy_,,2,0,0,0,2,300
987199729086820352,__ceox__,Executive Producer,1,0,0,0,1,300
794155358533120001,jnuneztorrijos,"Innovation management & policy junkie, amateur GameDev, and above all, human being. Loved by bots, but i don't love them. Personal account, opinions r my own.",1,0,0,0,1,300
49838176,RachelSkaggs,"Lawrence and Isabel Barnett Assistant Professor of Arts Management @OhioState | Sociologist of creative industries, social networks, & work  | Coffee Enthusiast",1,0,0,0,1,300
1014372022527373312,uos_network,U°OS is a universal reputation system constituting an open-source blockchain protocol. Build to be the standard for evaluation of trustworthiness on the web.,1,0,0,0,1,300
914517340586483719,DelemotteLab,"Computational biophysicist, scilifelab fellow and associate professor at KTH. Loves membrane proteins and all kinds of mathematical models.",0,0,2,0,2,300
2768289021,GencoGerard,,1,0,0,0,1,300
75564946,BohyemianSong,"Sr.UX Designer (Data Visualization) @Microsoft / Bohyemian Lab / Former Data Visualization Specialist @MIT Senseable City Lab, UX/UI designer @Naver, @RISD MFA.",0,0,0,1,1,300
86563553,thelamproject,"Software Craftsmanship, Agile Methodologies, Music Production, Social Justice, Self-Determination Theorist.",0,0,1,0,1,100
196297705,stalfel,"researcher, teacher, activist: recent books: Digital Condition / Kultur der Digitalität, & Digital Solidarity.",1,0,0,0,1,300
49129850,ecolix,Senior Data Scientist @SwissRe - opinions are my own,0,0,0,1,1,300
205112955,DanielRWitte,Diabetes Epidemiologist. Professor at @StenoAarhus / @AarhusUni. Enthusiast for a lot of things.. Generally optimistic 😃,0,0,1,0,1,300
1899081396,afamishedwriter,Freelance writer,1,0,0,0,1,300
45266881,charleswangb,Medicine-Health AI and Smart-Digital Economy @ Silicon Valley,0,0,0,2,2,300
59125818,Wahoo2343,,1,0,0,0,1,300
797858947344568320,tarjanbalazs,"Speech recognition and dictation specialist, Research Engineer at SpeechTex and BME",0,1,0,0,1,48
118604152,bsrvp,"I am an Assistant Professor (Senior) in Dept. of Mathematics, VIT, Vellore working in the field of Mathematical Biology and Ecology.",0,0,1,0,1,300
2374457209,NilsGoldbeck,Researcher @imperialcollege studying interdependence and resilience of urban infrastructure networks,0,0,0,1,1,188
5905362,fixone,"Cryptocurrencies, Blockchain, Big Data; sometimes Economics. Shitcoin minimalist. PGP 0x985D164A3852D8D7",0,0,1,0,1,300
1341365514,philippe_153,I help strategy and projects succeed in complex and uncertain worlds. https://t.co/oRtNnYSYzq,0,0,1,0,1,300
53425989,atwellpaul,"PhD Candidate at @umichpolisci and @fordschool. Collective action, accountability, and voting in developing democracies.",0,0,1,0,1,300
273897154,zubairjmi,"Young Scientist, Computational Biology & Bioinformatics, @Jawaharlal Nehru University, New Delhi",0,0,1,0,1,80
381567625,johnywrites,Fringe Of Learning @ https://t.co/ftarUXH7Ms || How people learn In diverse fields? || Science Of Learning || Entrepreneurial Learning #EntEd || #Learning In Complexity ||,0,0,2,0,2,300
2988003075,jusoneoftoomany,"#math professor & coffee drinker; I am rather silent here; I tweet more about #optimization, #analytics, #orms, #AI, #ML, and #digitalisierung under @mluebbecke",1,0,0,0,1,300
448491645,balanpablo,,1,0,0,0,1,300
305777588,TuftsNutrition,"Gerald J. and Dorothy R. Friedman School of Nutrition Science and Policy at Tufts University. 

RT/Follow ≠ Endorsement",0,0,2,0,2,300
40330468,jfhaynes,"{data, complexity} scientist. sociologist. product developer. svp analytics @starcom_usa | past @cramerkrasselt @nicoatnu | phd @stanford ab @brownuniversity",0,0,0,1,1,184
330523782,Harshitgujral,Data Scientist | Researcher,0,0,0,2,2,300
14846380,paulblaser,"Data visualization, data architecture, data quality, python, SQL, & .net. | If you're into the history of technology, see the other me @postwartech.",1,0,0,0,1,300
3384447538,ArnauMontagud,"Systems Biology / Data Science / Models, 
@BSC_CNS, Life Science Dep,
@Alfons_Valencia team",0,0,1,0,1,300
900381679105314816,XochitlCormon,Marine ecologist at the Institute of Marine ecosystem and Fishery science @ImfHamburg @CENunihh #marEEshift  #resilience #regimeshift,0,0,1,0,1,300
913798315434799107,Najlaa65039117,,0,1,0,0,1,9
1000033965036666882,comsyslab,"The Hellenic Complex Systems Laboratory (HCSL) is a virtual research laboratory, devoted to the transdisciplinary study of complex systems.",0,0,1,0,1,42
58540641,pcisnerosa,"Opiniones personales, RT no significa apoyo.",1,0,0,0,1,300
769103785083998208,supriya_pandhre,"PhD Student at Simon Fraser University, Canada. Working on Computer Vision and Computer Graphics.",0,0,0,2,2,300
86573492,Everdojuan,Complexity explorer?!,0,0,4,0,4,300
1005780411413299201,SocInnFI,A learning community for those interested in social and systemic change using Social Innovation.,0,0,3,0,3,300
839148081622958081,alinicoman,Associate Professor of Psychology and Public Affairs at Princeton University,0,1,0,0,1,72
969646621763006469,Andrea_Texas_82,CFA® Lev 2 Candidate #finance #privateequity #financialmodeling #venturecapital #investments,1,0,0,0,1,300
27889525,ccurtin1,"M&A and Business Valuations. Georgia Tech, tennis, food, RISK, Fear, Greed aficionado. #RWRI Alum Don't trust anyone without skin in the game-#nntaleb",0,0,1,0,1,300
4877987369,CaioVinchi,,0,0,3,0,3,209
52411418,deoncloete,#systemschange curator | embodying #complexitythinking | re-imagining #changeagents | #systemsinnovation | transformational #futures | #becominganticipatory,0,0,3,0,3,300
3295496994,VogtCaleb,"PhD student in Neurobiology and Behavior at Cornell. Social 🧠, social networks, field biology. #UMich #Cornell",2,0,0,0,2,300
28229525,grnsavvy,"Pursuing sustainability in real-world complex systems,  MIT @ClimateCoLab Catalyst, Ford Foundation International Fellow",0,0,3,0,3,300
467279481,kincso_biro,"Marketer and lifelong learner. Interested in marketing, leadership, self-development.",1,0,0,1,2,300
889623108,margaritaz_cy,I love science but most of all I love the brain. Applied Mathematician & Neuroscientist.,0,1,0,1,2,300
48997022,mrmohaxi,"Citizen of Mitteleuropa (Zürich, Milano, Budapest) | Artisan of Words",0,0,2,0,2,300
456893017,PolicyBookClub,"Join us to discuss the latest books, articles, and podcasts in public policy.",0,0,1,0,1,300
445032968,FredHasselman,🦋 Complex Systems Approach to Behavioural Science 🌊 | Transparency & Openness in Science  | Born-Again Apathist #BAAH! | Pointless-Polarisation Intolerant #PPI,1,0,0,0,1,300
129074553,torresmateo,"postdoctoral researcher at @FGV. working on Computational Biology, network science and network medicine 🤓. Interested in AI to combat climate change!",0,0,0,1,1,300
557841580,KristofferNiss,"Postdoctoral researcher in network science, systems biology, single-cell NGS, bioinformatics @TheBrunakLab @NNFCPR @UCPH_health",0,0,0,1,1,184
4125093183,JLefortBesnard,"Researcher - Brain mapping | Psychiatry | Statistical learning | Programming
PhD in Computational Neuroscience",1,0,0,0,1,300
2300215363,SaurabhKBose,"Love: Picking pickable brains, Research on computing like brain, Food, Novels, some photography, ... Oh and newbie gardener, produced tomatoes and potatoes. 😄",0,0,0,1,1,67
860434733779603457,ceuilab,@ceuhungary's #startup incubator named best #incubator/#accelerator in Hungary at @cesawards 2017. A bridge between academia and business in #Budapest and #CEE,0,0,0,1,1,84
307555371,clacalderon,UWC | Development | World Traveler | Intelligence | Tweets = own | RT ≠ endorsement,1,0,0,0,1,300
763024767863709696,ULSiamsc,Twitter account for the University of Limerick SIAM student chapter,0,1,0,0,1,124
709767126530265088,dora_biro_,"Professor of Animal Behaviour, Department of Zoology, Uni Oxford",1,0,0,0,1,120
957503983,DrMZanin,Researcher,0,2,0,0,2,51
38076046,depistemology,"I have more questions than answers. speculative philosopher interested in systems theory, causal emergence and epistemology.",1,0,0,0,1,300
827502528,MartinlabUSF,ecophys and disease ecology professor and co-host of the Big Biology podcast,1,0,0,0,1,300
2846987907,brilherman,"“Sustainable Investing: a path to a new horizon”, edited by H. Bril, G. Kell and A. Rasche (Foreword by M. Carney). Routledge (September 2020).",0,0,1,0,1,300
14218850,williamdchoi,🇰🇷🇺🇸🏳️‍🌈,0,0,1,0,1,172
445002965,Physical_Prep,S&C Coach - SportSci - Data Analyst - Author - #ComplementaryTraining - #AgilePeriodization #HIITManual #StrengthTrainingManual #bmbstats #RStats #AthleteSR,0,0,1,0,1,300
14309034,pauldatta,"I am trying to acquire knowledge and walk worthy. Technologist, Amateur photographer and guitarist - https://t.co/cMBBUOi6qP",1,0,0,2,3,300
14315969,DonnieMacNicol,I help business and project leaders improve delivery and teamwork. Speaker. Author. Keen cyclist #iMAPraxis #TPC256,0,0,1,0,1,300
2445040946,Safa_Fanaian,"The more I understand, the less I know! Studying overlaps in urban geography & water governance. Geography, Univ. of Oxford #rivers #complexity #DPhil #PhDlife",0,0,2,0,2,300
992227477387792384,JieLi198973,"PhD Candidate, Complexity Science, Data Science, Medical Ultrasound & Digital Signal Processing, IST-ICN, Hokkaido University",0,0,2,2,4,123
55419349,zaktomich,Former Capitol Hill and Governor staffer. Building a good way for people to lead and citizens to engage @thegoodpartyorg.,0,0,2,0,2,300
362549705,ercagpince,"Postdoctoral Fellow at Harvard University. ""And you will find someday that, after all, it isn't as horrible as it looks"" - Richard Feynman",0,0,1,0,1,300
4376595219,Future_Ethics,"Nordic Marketing & Communication Manager at @funderbeam
| Seeking funding or investments in the Nordics?
daniel.danielsson@funderbeam.com",0,0,1,0,1,300
309212859,pbrunese,Nothing to note.,0,0,1,0,1,300
39330574,stevesharra,@AFIDEP #Evidence #EdPolicy Past: CatholicUofM| UofBotswana| UIowa | MSU | LSE| uMunthu| Nkrumah PanAfrikanist |TEDx https://t.co/whXAZVE4kz,1,0,0,0,1,300
988896822369423360,gustavodietz,,0,0,0,1,1,95
2255387306,MihaiUdrescu,Computer engineer and libertarian,1,0,2,0,3,300
3417257051,AkosNyerges,"#SyntheticBiology, #GenomeEngineering & #DirectedEvolution |
Research Fellow at @harvardmed, George M Church @geochurch's lab | previously Csaba Pal's lab, HU |",0,0,0,1,1,300
13238822,lukostaz,"Knowledge graphs, machine learning, and explainable AI researcher at Accenture Labs. I don't believe in umbrellas.",1,0,0,0,1,174
960868584,AustinIsabel,"Talent whisperer, storyteller & mom. I think a lot about decision-making, behaviour change, and performance. Learning data visualization. INSEAD. Views my own.",0,0,1,0,1,300
142605645,king_Paulie,Co-founder @drvfc & @cloud99clothing || #BlockCHAIN #CRYPTO #FinTech #Insuretech #BigDATA #AI #Automation #IOT #Connectivity #Fashion #Sports #ART #renewables,1,0,0,0,1,300
866253144149430272,sse_data,"Interested in #networkscience, energy, and housing. Especially keen on #OpenData #rstats. Doing a PhD at @UCL @BartlettUCL.",0,1,0,0,1,203
153161109,meier_flo,Adjunkt in Information Studies @ Aalborg University Copenhagen | R and Tidyverse enthusiast | Bavaria in the heart ... oh and I like to run long distances,1,0,0,0,1,300
468784726,matthew_ashburn,entrepreneur: @Shopping_SAAS / @DTC_category / @resort_pop / @ResortPopWear / @futurs_market  / @PersonsAssetCL,0,0,1,0,1,300
1241871,tomhigley,"Founder & CEO X Genesis & 10.10.10: people, problems & process designed to give entrepreneurs a lever and a place to stand so they can move the world.",0,0,1,0,1,300
1622318749,inmediaref,"Data science and all that stuff. Python, Scala, ApacheSpark enthusiast",0,0,0,1,1,300
20474356,MARTYneumeier,"Author of THE BRAND GAP, THE BRAND FLIP, ZAG, and the new business thriller SCRAMBLE https://t.co/QHvF61U5gL",2,0,0,0,2,300
972990376142430208,seanshiverick,Lifelong learner | looking for patterns in the data,1,0,0,0,1,167
47650635,dr_mshafique,"Assistant Professor.
Tech change, R&D, Innovation and business strategy.",0,0,1,0,1,300
14867044,ptigas,AI/ML DPhil student @OATML_Oxford / machine learning tutor @BartlettArchUCL / [space is the place],0,0,0,1,1,300
857970652149579777,eitl_blog,"The blog journal – Bold ideas and critical thoughts on science.




// Sign up for our newsletter: https://t.co/2OvXuf3VQF",1,0,0,0,1,300
975717633373933568,provenanceuser6,I am a member of provenance analytic project.,1,0,0,0,1,62
1178915204,bcschiffler,"Data scientist with a PhD in Cognitive Neuroscience. Passionate about AI, post-rock, Python and learning languages.",1,0,0,0,1,300
961965322789113856,AnnaLichtwarck,"Ass Prof Developmental Psych, iamYu",0,0,0,1,1,254
3325161386,albina_gib,"MA Student/Incoming PhD Student @UBCgeog Political Economy, Financial Geography, Corporate Networks. Currently researching #Financialization #UnevenDevelopment",0,0,1,0,1,300
884066594724483072,euconomistul,"Centenarul trece, noi ramanem.",0,0,0,2,2,300
52731151,chenavin,,2,0,0,0,2,300
466522217,jonmarkwalls,Amateur adult | co-Founder @GovFaces | cool stuff @UN @WHO @UNCTAD | ideas on #tech #democracy #innovation #startups,1,0,0,0,1,300
2971231013,WeiZhang0209,"Complex systems, social networks, computational social sciences",1,0,0,0,1,0
140799023,LauraHRussell,"Precision Research & Communications: Precision Health. Economics, ethics & efficacy for health. Ed, AcciDental Blow Up in Medicine: Battle Plan for Your Life.",1,0,0,0,1,300
1386947317,SteveTeachPhys,"Physics Teacher.
Pretensions to being a scientist.",1,0,0,0,1,300
767659609,unlimitcycle,"Department of Information and Communication Engineering, Graduate School of Information Science and Technology",0,4,0,0,4,300
12169762,JessieNYC,"Writer. Professor. Innovator. Change Agent.  

Represented by Katie Kotchman, Don Congdon Associates.",1,0,0,0,1,300
2986435107,Domburnsburns,"PhD student working on networks of wood ant nests at University of York. Tweets about social insects, complexity research and fieldwork.  Also sometimes climbs.",0,0,1,0,1,300
167160825,fjesteban,Tenured Researcher and Lecturer @ujaen. Main topic: Systems BioMedicine; and interested in Maths. 🦎 Climber of mountains and metaphysical rebellions.🦋,0,1,0,0,1,300
4280941,devnag,"Founder/CTO, @WavefrontHQ (funded by @Sequoia, acq by @vmware). Previously Google, PayPal, Stanford. Oregon-born, universe-raised",0,0,1,0,1,300
3193800447,LauriePoints,"Glasgow PhD Chemistry student using robotics & AI, passionate about sustainability, policy and education. Ex EPSRC policy fellow @LordsSTcom and squash fanatic",0,0,1,0,1,300
2709158431,delfinietois,"PhD in Medieval Cultures. Medievalist and physicist, or vice versa. Heresies, inquisitors and social networks: me in a nutshell #firstgen",1,0,0,0,1,300
5842852,haig,,0,0,3,0,3,300
483034227,aaronjgoodman,PhD Student at Stanford. Former Lead Data Scientist at Custora,1,0,0,0,1,300
132546928,marcorifo,,1,0,0,0,1,260
19504269,mnukala,"Startup hacker, astrophysics enthusiast, dad to 3 amazing kids",0,0,1,0,1,300
2385746970,jsegoviamartin,Cognitive science | Cultural evolution | Collective behavior | @CCiL_UAB | @ISCPIF | Profe |,1,0,0,0,1,300
2940474915,m_emilian,"Philosopher, Research Centre in Applied Ethics, Faculty of Philosophy, University of Bucharest",1,0,0,0,1,300
3910958534,gscumming,"Ecologist of the frontiers... based at ARC Centre of excellence for Coral Reef Studies @CoralCoE and tweeting on ecology, conservation, philosophy",1,0,0,0,1,300
349987889,desaadi307,.,0,0,1,0,1,300
1444637977,AnnemarieBridy,"IP & tech lawyer. JD, PhD. Nonresidential Fellow @StanfordCIS & Affiliated Fellow @yaleisp. Erstwhile law prof @UIdahoLaw. Speaking only for myself.",0,0,0,1,1,300
930535963150954498,S_Canchi,Engineering researcher in neuroscience @UCSD interested in #Bioinformatics #Functional_Imaging #Epigenetics #AlzheimersDisease #TBI,0,0,0,1,1,300
70469623,RussContreras,"@AP reporter in US Southwest, #immigration #latino #race #poverty #travel. #MFA @ColumbiaSOA @UHouston grad. Writing #JFK book #typewriter fan rcontreras@ap.org",1,0,0,0,1,300
868822489677410304,mirusx,"Researcher (network science, privacy, social computing, ML)| CS PhD from @tuvienna/KTH alumna| Tweets in EN/AL/TR/MK/DE| Mostly about technology and politics",1,0,0,1,2,300
197382885,cooldosesrini,"Founder , CEO Daily Dose Digital and upcoming flagship portal https://t.co/C0X9WChDcy Venture Investor",1,0,0,0,1,300
68877817,_NoMan2000,"I'm a 3d artist, a web designer, a video editor, photographer, videographer, and lighter.  I'm awesome right?",0,0,0,1,1,300
884745562146430976,JACarrilloV,Economist @UdeGuanajuato | PhD from @UniofNottingham | Dad | Interested in #GameTheory #Politics #Networks | Football Fan | Food and film lover,1,0,0,0,1,157
223082225,ahmetfcoskun,"Assist. Prof. of Biomedical Engineering at @GeorgiaTech BME'19; Trained at Stanford, Caltech and UCLA",1,0,0,0,1,300
384359826,globalyzer,The GLOBE project: new scientific workflows that accelerate global collaboration to understand local change globally.,1,0,0,0,1,300
143643166,ReputaTheButa,There are known knowns. There are known unknowns. But there are also unknown unknowns...the things we don't know we don't know...,0,0,0,1,1,300
483766568,GabKrouk,"I'm a grant proposal writer and on my left-over time I try to do research 😉.
I share cool stuff in Science at large and Plant Science in particular.",0,0,1,0,1,300
16208513,lizrykert,Lover of great #design from #meetings to #bicycles. Committed 2 #green living and #local #food. Working on #complex #problems from #superbugs to #inequality.,0,1,0,0,1,300
4257990077,ifjmbur,PhD Student in Software Engineering at @mcgillu,0,0,0,1,1,120
819809653580120065,CmplxFloorball,Coaching collective & #floorball blog. Tweeting about complexity in team sports.,0,0,4,0,4,300
756519168787099649,SMukhtarlab,"Associate Professor of Biology at University of Alabama at Birmingham. Genomics, Bioinformatics & Systems Biology. Note: Opinions are my own & not my employer's",1,0,0,1,2,300
61502457,marinkazitnik,"Assistant Professor @Harvard. Previously, postdoc @Stanford CS. #machinelearning, #networks, #data, #genomics, #medicine",0,1,0,0,1,300
933784816008548352,AlisaPuustinen,"Erikoistutkija / senior researcher @peo_tutkimus, dosentti / adjunct professor @mpkk

#kompleksisuus #verkostot #toimintaympäristö #complexity #networks",0,0,1,0,1,300
828911046068944897,Sysbiogr,Our group is interested in understanding how pathogenic bacteria interact with host cells from a Systems Biology perspective,0,0,1,0,1,240
39815829,walter_colombo1,,1,0,0,0,1,231
6144162,snowded,"Founder and Chief Scientific Officer, Cognitive Edge, Director Cynefin Centre Wales",0,0,2,0,2,300
2184644084,CharlesHeuvel,,1,0,0,0,1,240
1494062065,DanBoches,,3,0,0,0,3,300
154969387,DrPaulK,Clinician-Scientist at Lausanne University Hospital - Melbourne & Monash University - Neuroimaging - Psychiatry,1,0,0,0,1,300
56843433,josephreisinger,hi @facet_ai _/▔﹀\_︿╱﹀╲/╲︿_/︺╲▁︹_/﹀\_︿╱▔︺\/\︹▁╱﹀▔╲︿_/︺▔╲▁︹_/﹀▔\⁄﹀\╱﹀\︹▁︿▁︿/\︿╱\︿︹_/▔﹀\_︿╱▔︺\︹╱﹀▔╲︿_/︺▔\╱﹀╲▁︹_/﹀\_︿╱▔︺malebranche was right,0,0,1,0,1,300
2180768821,erikphoel,"Scientist studying emergence, consciousness, & complexity. Author of THE REVELATIONS (out fall 2020). Sign up for new essay alerts here https://t.co/41hISCny5Z",0,1,0,0,1,300
3377071083,JeppeHansgaard,"CEO @InnovisorInc, #Change #Communities #Collaboration #Networks #OrganizationalNetworkAnalysis, #Keynotespeaker, Proud dad of 3, Enjoy athletics & traveling",1,0,0,0,1,300
18736285,AyalChenZion,Applied #microeconomist living in #Seattle. PhD from @UCSDEcon. Working at @Amazon. all opinions are my own. Avg = OLS = ML = AI,1,0,0,0,1,300
255157495,azayhara,"Neuroscientist at Columbia University. Memory, brain dynamics and a little bit of everything. From Alcañizo.",0,0,1,0,1,300
14715307,jaime_alvarez,"Uncertaintologist, Anti-realist and word-player. ""Uncertainty is an inexhaustible source of innovation"". Working at @cnid_cl.
Tweets are personal.",0,0,1,0,1,300
92609356,journal_indecs,Interdisciplinary Description of Complex Systems - scientific journal,0,0,10,0,10,300
160470820,tor_jossang,Tvitrer iblant.,1,0,0,0,1,300
3303571,Odegard,"Founder & CEO, Post-Lean Institute; Objectivist, GTDer, traditional (Iwama style) Aikido, Global Entrepreneur. Founder, Post-Industrial Forum.",0,0,1,0,1,300
18279735,dpbarnaby,,0,0,1,0,1,122
12526272,atakante,Bay Area Hi-tech Product Management Executive || Currently @BigMLcom || Investing Enthusiast || Soccer | Equine | World Travel Fan,0,1,0,0,1,300
205933447,joestare,"I am interested in complexity and adaptation in organisations and nature. I blog, give talks and collaborate with scientists and artist James Robert White.",1,0,0,0,1,300
80820013,anton_dasgupta,"🇳🇿🏳️‍🌈 BSc(Phys)+BCom(Econ)-UoA 👍: current events, breakfast foods, comedy. 👎: racists, 'reality' tv shows, pokey t-shirt labels. Master's (Econ) student.",0,0,1,0,1,187
92829423,kedarpaul,"But seriously, don't panic.",0,0,1,0,1,218
724959726279233538,NatasaPrzulj,Prof. Przulj designs algorithms for integration of heterogeneous  biomedical and molecular data to aid precision medicine. Details are at her web page.,0,0,0,1,1,35
3237503894,ZeroMeridianEdu,"We empower with skills, knowledge and amazing life.We want to create true leaders of tomorrow. Especially in our  Digital environment. Starting NOW!",0,1,0,0,1,300
2384866087,sfatinfo,Eu în Irealitatea imediată,1,0,0,0,1,60
1045622364,Dr_Photonics,Physicist. @ Eastern Washington Univ. Lasers & Complex Systems. Outreach. https://t.co/zKH9AkBKvO. Author of Small World (SciFi) https://t.co/5Zsh9ccpHC He/him/his,0,0,1,0,1,300
747758986921918464,Limits2Growth,"We live in a world of stocks, flows and feedbacks. At 330 ppm CO2 we launched a book. Free download. Read it. It will change our life.",0,0,1,0,1,300
731212774462902272,jvarga92,PhD student doing structural biology,0,0,0,1,1,300
87511989,gabthinking,"strategist, thinker, investor, entrepreneur, and author of The Strategy Toolkit",1,0,0,0,1,300
267301528,juanccas,"Chairman, Space Time Ventures",0,0,1,0,1,300
55579428,aneveu,"Economist specializing in macroeconomic volatility, macro policy, and financial markets.",1,0,0,0,1,300
37520417,PaulMRichard,,1,0,0,0,1,300
20716224,jcmonroy,"A little bit of everything: Design, usability, IA, nonsense, creative things, and other stuff you may find in fantastic people.",0,0,0,1,1,300
818907239612379136,ShizukaLab,"Assistant Prof. @UNLsbs: ecology, evolution & social life of birds; Board President @AsianCenterLinc; dad of 2; he/him",1,0,0,0,1,300
236889159,martinmanelli,,0,0,1,0,1,101
3200670107,0apfa,"GIS student, Interested in everything related to Complexity Sciences",0,0,1,1,2,300
3927585196,JuliaFuredi,Igniting sparks of inspiration in #finance and beyond. Let's make #FinTech about the people not the #tech.,0,0,0,1,1,180
112179348,RobertoOtarola,Born in Brasil; living in Chile. BSc in Economics @uchile; MEng in Energy @ucatolica. Career: @Abengoa @BoschGlobal @CAMCHAL @EsolarCL @Dictuc Solar Energy Geek,0,0,1,0,1,300
816371664,CCabb91,PhD student @QueensU | Comparative political economy/Canadian politics | 🔬🏌️‍♂️NW |,0,0,1,0,1,300
1732122120,RG_Barcelona,RG Civil Engineering is a Barcelona-based technology firm focused on urban innovation analytics and design.,0,0,1,1,2,300
1281581,riordan,modernist | Elinor Ostrom Devotee | ❤️ @kaythaney | ex @nypl_labs @mapzen,1,0,0,0,1,300
16682271,jurisulmanis,"Innovation, entrepreneurship, machine learning, quantum science and technology",0,0,1,0,1,185
2896910647,UliZue,Purveyor of some fruits of rational thought. Allergic to people wearing ideological blinkers.,0,0,1,0,1,300
3226398959,v_douros,"Post-doctoral Researcher, RWTH, Aachen. Tweets revolve around informatics and telecommunications.",1,0,1,1,3,300
3121739771,AntifragileACC,"Licensed Mental Health Counselor...demonstrated hx of excellence in Therapy, Coaching, Associate Hypnotherapy American Society of Clinical Hypnosis.",0,0,1,0,1,156
1884724176,dtsouma,"Associate Professor. Distributed, large-scale Systems and Data Management. Ionian University and NTUA",0,0,0,1,1,300
51761158,esalvaj,"Full time Professor @negociosUDD 
Visiting scholar @UTDiTella @Macquarie_Uni @HarvardHBS
#Strategy #socialnetworks #InternationalBusiness #corpgov #diversity",0,0,1,0,1,300
19693552,litomd,"Teacher, researcher, usability and programming languages enthusiast. A dreamer that cannot renounce his dreams, http://t.co/Ru8nepvg8B http://t.co/rrIfoQ1vMN",1,0,0,0,1,300
3662819055,dann_benjamin,"Research scientist @DPZ_eu interested in the interplay of population response, communication structure, and neural coordination in relation to behavior.",0,0,1,0,1,300
17341731,nadyaivanova,"Telling the future of finance, energy, clean tech. Also COO @latelier. Alumna @anthemis @circleofblue",0,1,1,0,2,300
576226627,AjHanninen,Assistant #Floorball coach @KooveeM1. Writing for @CmplxFloorball blog.,0,0,1,0,1,300
19763597,AfonsoHenriques,,1,0,0,0,1,289
823460106687782912,DauwelsL,"We design  algorithms for Big Data Analytics, derived from the theory of statistical inference. Applications: autonomous systems, human behavior and physiology.",0,1,0,0,1,133
6810492,lievesofgrass,"Personal account, my own views, etc. postdoctoral researcher working on early modern communication and correspondence, digitally and at scale",1,0,0,0,1,300
2978797834,KITE_eng,KITE's a leading Technological #Design & #Project #Management Co 4 industrial facilities power head plants #IOT #IKEA #ChinaPavilion Cofounder/CEO @_ChiaraBi,1,0,0,0,1,300
722174322530365441,VRtices,Immersive Data Visualization with Virtual & Mixed Reality,0,0,0,2,2,300
985066760,AlonBenAri2,,0,1,0,0,1,166
3002127958,Kurtosis_,,1,0,0,0,1,300
24771988,ChrisJelly,Technologist. Founder Jelly Consulting (https://t.co/Cx7yX5imZ7) and Jelly Incubation Fund for @Northeastern (https://t.co/kXiBZeujAe),0,0,1,0,1,300
393542959,max12elliott,Clinical Neuroscientist | PhD Student Duke University | https://t.co/5coOQTzyuI…,0,1,0,0,1,167
790376282244591616,CurandiHealth,Applying system science to healthcare delivery,0,1,0,0,1,42
803940165853073409,peternealtaylor,"Computational neurology, epilepsy, neuroimaging, connectome, nonlinear dynamics, brain injury, complex networks",0,1,0,0,1,97
1252144297,GeoSocialWM,Harvesting geosocial information from social media feeds in order to reveal and analyze the invisible links that connect us.,1,0,0,0,1,300
23685336,thiberio,"wannabe scientist;
PostDoc @MIT;
Opinions are my own, but I agree that some shouldn't...",1,0,0,0,1,300
17396579,heisss,"Digitalization, Smart Manufacturing, Open Innovation, Knowledge Networking, Complexity Management, Cyber-Physical Systems. All views are my own.",0,0,0,1,1,300
2318979729,profeta_g,"#datavisualization #interactiondesign, #webdesign",0,0,1,0,1,300
734065274,mnaranjol,Presidente. Asociación de Bancos del Perú  🇵🇪,0,1,0,0,1,300
2802870305,amir_feizi,computational biologist/bioinformatician interested in translational science/drug discovery @ OMass therapeutics | part-time kamancheh player.,1,0,0,0,1,243
71647024,djp1974,"Prince of #Serendipity. #Publicsector #shadchan #mystic #poetry #pataphysics #facilitator #counsellor-in-training. Lone tod, 3 cubs ☿🦊 #कवि #kaví #vātēs #poet",0,0,1,0,1,300
8819662,robmay,"General Partner at PJC (@pjcventure) focused on AI -  Author at https://t.co/cToo9wYmjb and https://t.co/7jKilo6YGm , previously cofounded Talla and Backupify.",0,0,1,0,1,300
2726806519,AaArechar,,2,0,0,0,2,300
2341277918,esjayben,"PhD student @ UT-Dallas. Phonological, lexical, and speech motor bases of word-learning #devlangdis #phonology #networkscience",1,0,0,0,1,223
782029214975418368,MiikoSokka,"Postdoc at Brown University
DNA Replication Origins in Eukaryotes",0,0,1,0,1,21
17601379,Kristen_Guth,"I research technology, organizational change, and start-ups. Tweeting research & press about tech.",2,0,0,1,3,300
776129585612099584,Signa_Lab,"Laboratorio interdisciplinario del ITESO para la generación y gestión de conocimiento libre, análisis de redes y repositorio abierto #Tecnopolitica #BigData",0,0,0,1,1,300
3012495750,pevans_c,"Charting forces shaping the platform economy. Managing Partner, Platform Strategy Institute. Prior Partner KPMG | CGE | GE | IHS/CERA || MIT, PhD.",1,0,0,0,1,300
486812051,ASmedlund,Chief research scientist @FIOH with interests in #platforms #ai #social_networks #service_science,2,0,0,0,2,300
2260576540,brianjdermody,Interdisciplinary Assistant Professor @UUCopernicus with an interest in sustainability and complex systems @ComplexityLabUU,0,0,1,2,3,300
3147145875,yangjiera,"Scientist at Amazon. Bettering AI with human involvement. Lived in CN, NL, CH, and now in US.",1,0,0,0,1,238
318622360,PepFriday,"Applied Mathematics 💨Reader, Drifting Systems Enthusiast!",0,0,0,1,1,300
124363822,MBroecheler,Chief Technologist @DataStax. Database Specialist. Researcher. Technologist. Entrepreneur.,2,0,0,0,2,269
1583262253,jimat944,im curious so how will we define the public good i.e. #righttotheurbancity ..don't die in a crosswalk. BTW solar now costs 6¢ kilowatt hour #imagineeringatlanta,1,0,0,0,1,300
756221500051615744,bobby_burning,...,0,0,1,0,1,248
1943726035,btillay,Artiste incompris reconverti dans le risk management. @ScaledRisk.,1,0,0,0,1,159
851058162,T_Deguilhem,Associate Prof./MCF - U. Paris - LADYSS - Socio-Economics | Development & Institutional Economics | Networks | Labor Markets | Social Policies | Latin America,2,0,0,0,2,300
34305795,ao001,,1,0,0,0,1,119
400151277,MetaboNews,A monthly newsletter for the worldwide metabolomics community -- free subscription. Subscribe via https://t.co/Me7ZT1bUz6 #Metabolomics,0,0,0,1,1,300
761562709703979008,nggprojectucd,"Twitter account for the Nation, Gender and Genre Project, based at the UCD Humanities Institute.",2,0,0,0,2,300
477798251,BenedettoLig,"Post-Doc on Early Modern History and  History of Eastern Europe at Sapienza University of Rome. Interested on ethnic minorities, migrations and social networks",1,0,0,0,1,300
762976,phraktle,"Technology entrepreneur. Founder of https://t.co/SVjO1oazpf, Scarab Research and EU Edge.",1,0,0,0,1,300
573746740,stauho,electron jockey,0,0,1,0,1,300
142797549,nocheinnick,Professor at University of Applied Sciences Ravensburg-Weingarten. Tweets on #software | #ITStrategy | #cloud | #computerscience | #society in case of any news,1,0,0,0,1,300
7387922,ericaeyoung,"Design, food, Hong Kong, kayaking, networks, people, robots, startups, trailrunning. These are a few of my favorite things.",0,0,1,0,1,300
4689106926,gircardano,de perfil,0,0,0,1,1,300
295581503,asantos_ispa,Adeus ó Esteves!,0,1,0,0,1,300
368836524,blockdevice,Knight of the Routing Table. Data donor. Indoor enthusiast. Textually active. Eskalationsbeauftrager. 451. пливе кача. Nerdic Walker. Googlestoßer. Sudoringer.,0,0,1,1,2,282
132112504,gtyrelle,Bioinformatics Special Circumstances EMEA for @iontorrent & @thermofisher. Opinions are my own and not the views of my employer. 🇳🇱 🇹🇼 #drumandbass,1,0,0,0,1,300
2464649564,n_lazzarini,Loud Italian data scientist,1,0,0,0,1,203
18043192,JessKropczynski,"Asst Prof at Univ of Cincinnati School of IT using technology to improve information, communication, & engagement in community networks",1,0,0,0,1,300
14664847,danielfullmer,"PhD candidate at Yale in EE. Focusing on distributed computation and control.

sumo / high bar",0,0,1,0,1,300
2897519482,Sloka611,,0,0,1,0,1,300
7766812,GiuseppeB,"Global Head of Innovative Data Science @Bayer. ML/AI Author @PacktPub. #AI, #MachineLearning, #DeepLearning, #BigData,  #DataScience, #Mind",1,0,0,0,1,300
3081907311,anquantarbuile,Data Architect @myclinic365. Organiser @kerrydatasci. Chief of Staff @theirishnation.,1,0,0,0,1,300
18899917,kavlata,,1,0,0,0,1,300
1818841,i_am_camilo,"one thousand projects, one of these days I will finish some of them. SaaS is an interest but really it is just now basic IT literacy. FOSS but for URM. He/him.",0,0,1,0,1,300
149706579,euanashley,genomes/hearts/technology/medicine,1,0,0,0,1,300
21745565,positivearrow,"Some Math, some Computer Science, some Physics...",0,0,1,0,1,300
238759309,kyleratner,"Experimental social psychologist, Assistant Professor of Psychological & Brain Sciences at UC Santa Barbara.",1,0,0,0,1,300
18417931,jeffbaumes,An analytics and data vis guy @Kitware.,0,0,1,0,1,300
99090489,janinevhacker,"Assistant Professor @bpm_li @uni_li & postdoctoral researcher of #informationsystems @UZH_ifi, interested in #socialsoftware #FutureOfWork #BlockchainInnovation",1,0,0,0,1,300
50626888,maulikkamdar,"Senior Data Scientist @ Elsevier Health || Stanford BMI PhD, IIT KGP, GSoC || Biomedical Informatics, Web, Visualization, Art, Travel || Opinions are my own",1,0,0,0,1,300
3002337567,YaleUgSS,The Yale Undergraduate Sociological Society,2,0,0,1,3,117
309877536,AmyV91,Sir Henry Wellcome Postdoctoral Fellow in the #WCMRmuscleteam @mitoresearch. Mitochondrial biologist. Views my own. Supporter of #womeninSTEM and #LGBTinSTEM,0,0,0,1,1,300
131487160,MignonWuestman,Data scientist @Shintolabs // innovation PhD @UUCopernicus // Cello + books + DIY // feminist // NL/ENG,0,0,0,1,1,300
23315775,kc2519,"I create data-driven visuals at https://t.co/SQU7CLZU4p, https://t.co/25yn8SYZnv, https://t.co/FCAiN0HaXb, and https://t.co/hFz8sWEMAP. Residing in the #D since 1995.",1,1,0,0,2,300
46131106,pcastells,Associate Professor at Universidad Autónoma de Madrid,1,0,0,0,1,300
64728622,lathurler,"Gestão do Conhecimento, Open Data, Big Data, Ativos Intangíveis, Network Science.",1,0,0,0,1,300
18836358,jcberry,,0,0,0,1,1,300
279083549,yuksel_gunal,IBMer/Part-time instructor at @UniBogazici_en Physics Dept (online courses)/Adjunct instructor at @Marist.  Tweets in EN/TR.  RT ≠ agreement,1,0,0,0,1,300
2593213488,rlaurentiu1,Conservation planning @ University of Bucharest,1,1,0,1,3,300
7563272,trunghlt,"Founder of @ActableAI

ML NLP PhD, Xoogler",1,0,0,0,1,272
274199427,ChicoKaefe,Data Research. Bona fide expert in offscourings. Alea Jacta Est!,0,0,0,1,1,300
187662149,alejandrorodgnz,"Associate Professor
(Universidad Politécnica de Madrid)",0,1,0,0,1,300
704504419392557056,WondrousNet,A wonderful network aiming to bring together scientists and science enthusiasts to discuss big ideas for their own sake.  retemirabileblog@gmail.com,3,0,0,0,3,112
117901044,d_i_s_p_e_r_s_e,"A fan of Boston, baseball, boardgames, and my two boys.",1,0,0,0,1,281
943817701,pmarquet10,Professor of Ecology at the Pontificia Universidad Católica de Chile and Associated Researcher at the Institute of Ecology and Biodiversity (IEB),0,0,1,0,1,246
365601032,AbeKazemzadeh,I use twitter for fun and work at times.  For fun I like to keep up with news friends and marine weather.,1,0,0,0,1,300
29096549,MTsiaklides,I work in the interdisciplinary @SocialNetNeuro lab at @WUSTLmed. We study the impact of social networks on neurological illness.,1,0,0,0,1,300
193683712,gbstan,Professor of BioSystems Design and Engineering,0,0,0,1,1,300
293766616,_jessie_roberts,"Manager, Industry Engagement (Data Science), Office of Industry Engagement, QUT",0,0,1,0,1,300
226024604,katospiegel,"Neuroglialover, I play with Neuron-Glia simulations and Bioinformatics. Data Visualization. Science Hack Club. @_impaciencia_ Staff. UNIL.",0,0,2,0,2,300
1154481145,6Bacon,Reassembling the Early Modern British Social Network at https://t.co/amaNxoG4dr.  Blog at https://t.co/qx1orVEjNd.  Tweets by @ChrisVVarren.,4,0,0,0,4,300
1468702604,mlla_cc,IT Developer • data & interactive graphics • #luxembourg • ☀️,0,0,0,1,1,300
1927176097,_jafshin_,"PhD Candidate, Healthy Liveable Cities Group, Centre for Urban Research, RMIT, working on transportation system simulation and cycling",1,0,0,0,1,31
463659624,lzbair,,1,0,0,0,1,96
312026483,dem0sh,data stuff,1,0,0,0,1,37
14251304,mantruc,"""Form is Emptiness, Emptiness is Form""",1,0,0,0,1,300
14090003,PatrickNYC,,1,0,0,0,1,115
17420692,emmv,Teflon status,1,0,0,0,1,300
3976341281,Yeison_SGarcia,"Soft. Dev. Interesado en sistemas complejos y simulación basada en agentes. Cinturón negro I Dan, Taekwondo wtf @complejidadud @complejidadfuac",0,1,0,0,1,218
560379003,BarbaraBisignan,,0,0,0,1,1,257
3673916417,diktiolabsls,We deliver measurable impact on the efficiency and effectiveness of  commercial operations in the  Life Sciences industry.,0,0,0,6,6,160
416040278,Ram_Bioenergy,CFO (SA) @ISOC-ZA-GP Ph. D in information systems. Creator of Crypto network effects model. Developed the RRSA Management Framework. Published author.,0,0,1,0,1,300
2316039206,sparkcollab,"Randomised Coffee Trials made easy! Spark pairs employees within a company to meet for coffee each month. Build connectedness, employee engagement & innovation.",2,0,0,0,2,300
123082504,JingwenZhang,"https://t.co/4UDjBiJNMZ social networks; health communication; persuasive technologies; Assistant Professor at the University of California, Davis.",3,0,0,1,4,300
268971832,IvanVSavin,"A social scientist working on innovation economics, complexity theory, optimization and climate change",1,0,0,0,1,300
305606256,PieterDenHamer,#AI #Analytics #Complexity #Ecosystems #ContinuousIntelligence #Gartner #UtrechtUniversity #Europe 🇪🇺,0,2,0,0,2,195
521347279,AndersKMunk,"Associate professor in #technoanthropology #aaucph, visiting researcher @medialab_ScPo, ex @oxfordgeography @TechNatures, #digitalmethods for #socialscience",0,0,0,1,1,217
253098981,fran_rom_cam,Researching and Teaching Molecular Systems Biology at @unisevilla studying plants and microalgae at @IBVF_Sevilla 💻🌱🍅,0,1,0,0,1,300
65276982,ocadslab,Strategic Innovation Lab (sLab) co-creates research in possible #futures #foresight #design #innovation @OCAD University. Codirected by @gregvan & @redesign,0,0,1,0,1,300
16039165,PaulFairhurst,"I help organisations & individuals become more successful using latest ideas from cognitive, system & data sciences. Consultancy, coaching, research & analysis.",2,0,0,0,2,300
262508935,PavelSolis,"PhD Student at @JohnsHopkins | International Finance and Macroeconomics, Econometrics, Financial Markets",1,0,0,0,1,300
630483830,OpenMarabunta,"Swarm creativity & open innovation
Curated by @orladediez",0,0,1,0,1,300
101945112,terrologic,"Deputy director @info_radical & research affiliate @CICCTweet Researching violent extremism, terrorism online/offline & P/CVE. Tweets/RTs are mine.",1,0,0,0,1,300
20508239,judithmp,"User & Innovation Researcher, Service & strategic design, conducting generative research for innovation and responsible tech, PhD in innovation management. /she",1,0,0,1,2,300
92343293,edumace,"Serial entrepreneur, multimedia software pioneer, startup mentor and technologist.",1,0,0,0,1,300
2356684783,XDiscoveryWorld,Mapping Human Knowledge,0,0,1,0,1,300
8656582,phume,,0,0,1,0,1,300
3134844703,jessicatysu,ML engineer at @Facebook,1,0,0,0,1,300
3118596257,ArtOfNetworks,,0,1,0,0,1,25
196100496,Doc_Soc,Prépa de la 7e conférence Document numérique et Société pour 2020 !,0,0,0,1,1,300
6886122,148,"In lockdown. Writes words of crisis, shapes acts of solidarity with @ULesCommercants @Panzani... Remote teacher @SciencesPo. Cooking something up @AVersailles_",1,0,0,0,1,285
11412092,jonts,,1,0,0,0,1,300
1520426029,MZabielskiPL,Web designer & student at Military University of Technology in PL | http://t.co/8DrwGbGVBE,1,0,0,0,1,94
3028895979,CompSysMed,"Team leader of Computational Systems Medicine Lab @uconnhealth; Mathematician, Computational Systems Biologist, ❤️ #Algorithms, #STEMadvocate, Made in Mexico.",0,0,0,1,1,300
130269789,redchurch77,Nord from Minnesota. Game Developer. Audio d00d. Beer.,0,0,0,1,1,300
2856120141,bmackphe,"Blue seas, data streams, and fast machines",0,0,1,0,1,300
43904362,JasonSilva,Storyteller | Futurist | Hosted @natgeo’s BrainGames | Creator Shots of Awe | keynote speaker | https://t.co/oPjOHCcKo2 https://t.co/V54Xrloh2S,1,0,0,0,1,300
2964680459,rich_jolly,"Leadership at the intersection of data science, business strategy and complexity science",0,0,4,0,4,300
434454638,ZoltanMatyas,4 lingual 2.0 Green Managing Director managed by 5 women at home and at work. I can print on anything! #personalization #3DPrint and #print #Remanufacturing,1,0,0,0,1,300
2819255259,iam_internet,"We design alternative learning experiences, tools and platforms to change how the digital economy is changing Everything: 🌍 👉 https://t.co/wXPC8ndNa7",0,0,1,0,1,300
1407614106,HelloSisu,"Real-time social media intelligence via Natural Language Processing, Machine Learning and a whole lot of elbow grease. Makers of @sentoapp.",1,0,0,0,1,300
34597270,mikolajhnatiuk,"Sociologist, statistician, programmer, data sci",1,0,0,0,1,44
1095684055,DXNetworks,"DX Networks. Nossos produtos digitais são para a nova mídia: televisiva, interativa, ilimitada e mobile.",1,0,0,0,1,55
49574951,arashyazdiha,Not willing to ever drop the Social from Social Networks...Marketing and Econometrics PhD student at @ESEerasmus and @ResearchTI,1,0,0,0,1,232
38136903,robipalo,"DM&ML, recSys, social networks",2,0,1,2,5,300
50796520,isamarcelle,"Work with leaders & their organizations to solve critical issues, align individuals with strategy  & build agile, resilient & entrepreneurial organizations.",0,1,0,0,1,300
1565623927,Yomguithereal,"Research engineer at SciencesPo's médialab. JavaScript, Python & Shawarma.",0,1,0,0,1,300
75078962,lynnlayman,"I tweet on economics, complexity theory, nonviolence and peace theology. I love the things that make for peace.",0,0,1,0,1,300
38402791,ffurci,"Great design solves a problem that a user didn't even know existed - UX first, Service Design as a mantra",1,0,0,0,1,300
256946497,charles__perez,"Charles is associate professor @Psbeduparis. Engineer, doctor & entrepreneur in computer science. He is holder of the Chair disruptive, Digital, Data.",1,0,0,0,1,300
3035,kenthompson,"Bioteams, high performing teams, virtual teams, collaboration and business simulation games.",2,0,0,0,2,300
2491445959,ba_davies,"Archaeologist of deserts and islands, but rarely desert islands.// Archaeology, digital arch, complex systems, simulation, Oceania, Australia, Africa",0,0,2,0,2,300
22470410,bramvermeer,"Science writer, reporting on physics, technology and their social aspects",1,0,0,0,1,300
40170223,wiznick,"Data Science and ML leader, enthusiast, travel hacker. Moving energy forward through #AI #MachineLearning #DataScience #DataProducts",0,0,0,1,1,300
2611719048,bharathrangar,"Data Scientist @ Target. Machine Learning and Algorithms, Optimization Methods, Computational Methods and Numerical Analysis. Tweets reflect my views only.",0,0,1,0,1,272
192131177,EliMiron,"Ph.D in Chem. Physics
Directed a gov. technical info center for 8 yrs.
 Set up a successful KM initiative - CKO for 2 years.
Currently teaching KM at BGU",1,0,0,0,1,300
188937484,alexhantman,Idea Engineer | Creative Technologist | Curious Human,0,0,0,1,1,300
301544509,Maha2s,Purity Prevails ....,0,0,0,1,1,75
394534362,ChCariou,R / datavisualisation / freelance / Chargé de recherche au Labex ICCA,0,0,0,1,1,300
309541068,JuergenMusil,"collective intelligence systems, software architectures, social computing",1,0,1,0,2,256
385034615,WMichaelJohnso1,"Research architect, modeler of collective intelligences, cultural evolution, and fun in education.",1,0,0,0,1,46
2485689126,Falcon91Andrea,Viviendo sin prisas...,0,0,1,0,1,47
10429382,geneweng,,1,0,0,0,1,300
18099967,thinkepi,Grupo formado por profesionales y académicos provenientes del mundo de la Información y Gestión documental.,1,0,0,0,1,300
54335195,evanildo_,"Brazilian, physicist.",1,0,0,0,1,300
424939547,yangdempe,,0,0,1,0,1,77
390761131,legoviews,Inquisitive mind | Co-Creation | Digital Transformation | System Thinking | strategy | innovation | Privacy | UX | CX | Creativity  | Accessibility |  Europe,0,0,1,0,1,300
28007091,cognitivepolicy,"Working to integrate complexity research, cognitive science, and cultural evolution for the good of humanity!",0,0,2,1,3,300
523939489,Cesarecarvajal,"Ambiente, derechos humanos, interculturalidad y desarrollo.",0,0,1,0,1,300
7937452,Stanm,"Lover of all webby things since 1996, never disconnected since",1,0,0,0,1,300
384534521,jtchd,Promovierter Philosoph und praktizierender Informatiker. Science Media Center Germany. Privater Account,1,0,0,0,1,161
267044093,jbrandoff,"Complex systems engineer, dad, and digital nomad. Head of Data @reifyhealth. Co-founded @wadeandwendy. Formerly @storjproject @harmonylabs @momath1",0,0,1,0,1,300
116491267,sierra326,"Físico por UNAM, Master en Psicología Cognitiva por ITESM y Doctor en Educación por UPN. Coach ontológico. Tecnología para el Aprendizaje y el Conocimiento.",1,0,0,0,1,300
9069682,sjudd,IT guy for UNH Cooperative Extension,2,0,0,1,3,300
205383932,SocialInSilico,"Spinning together the threads of the social web - people, science and technology. One of @LouWoodley's current projects.",1,0,0,0,1,300
2372348492,GeoffClarke0917,,0,0,1,0,1,90
403281688,chadwcarlson,"Florida Atlantic University, Center for Complex Systems and Brain Sciences",0,0,1,0,1,118
166978793,jaiswal_ok,"Researcher @ The Broad Institute of MIT and Harvard, studying Inflammatory diseases",0,0,1,0,1,300
2283467851,Wuzzin_,Precipitate serendipity to aggregate intelligence.,0,0,1,0,1,300
1395507097,jvelcin,,1,0,0,0,1,300
104577923,dietoff,"Prof. visualization + urban informatics @northeastern. cities, infrastructures, autographic visualization. Author ""Waste is Information""(MIT) @MITdusp PhD",0,0,0,1,1,300
47114833,mohsenvand,extending my mind and body @MediaLab.,0,0,0,1,1,121
464118977,MaryGuettel,Mathematician. Data Scientist. Coffee drinker. Wine lover. Travel geek.,0,2,0,0,2,295
48724537,robfsouza,Biologist/bioinformatician working on sequence analysis at the University of São Paulo,0,1,0,0,1,191
981315553,herschelfthomas,"Assistant Professor of Political Science at @UTArlington. Studying policy processes, agenda-setting, interest groups, lobbying.",0,0,1,0,1,139
1981691,santoshmaharshi,Product & Content #DigitalInnovation #SocialNetworks #Startups   #Accessibility #Inclusion,1,0,0,0,1,300
1151506357,BaudotAnais,Networks and/or/of/if/so networks,0,0,1,2,3,300
431448592,tayfunhalac,"PhD at #NaturalLanguageProcessing and #SemanticWeb. Loves #OpenData, #ArtificialIntelligence and #MachineLearning. @GalaksiyaBT",1,0,0,0,1,300
2260093056,B_Anbar,"Hacettepe Üniversitesi, Geomatik Mühendisliği",0,0,0,1,1,288
148895716,auremontano,"Interested in social research, cybernetics and innovation.         Marketing Manager in retail business.",0,0,1,0,1,130
74796161,RainerLuedtke,"Technologist. Systems Thinking Advocate. IBMer. Optimist. 'The reason you must never ignore systems, is because systems never ignore you...they assimilate you.'",0,0,5,0,5,300
60395717,dtrentedwards,,0,0,1,0,1,300
2223665502,GripComplexity,,0,1,5,0,6,109
50301717,Wizary,,0,0,1,0,1,193
819380640,nidhi225,"Data Scientist at Philip Morris International, MSc. from TU Delft, diving deep into data with #rstats, #Python, #ApacheSpark!",0,1,0,0,1,208
1249427791,philMultiples,,0,0,0,1,1,11
46789090,Medemel,RI native that loves a good challenge. Passionate about data and a great book.,1,0,0,0,1,263
15570920,zmughal,"biomed engr, neuroscience, signal processing, image analysis, machine learning, CS, maths?, HCI.

Hacking in #perl, #prolog, #c for FUN!",0,0,1,0,1,300
15335156,afauno,Just trying to follow ≠ horizons of social media revolution. Intermittent du tweet & occasional smartass.,0,0,0,1,1,300
1230943206,os_soc,"A growing community of volunteer scholars, librarians, and open science enthusiasts working together to improve scholarly evaluation and communication",1,0,0,0,1,300
437660451,martenduering,Assistant Professor in Digital History at @C2DH now mostly @impressoproject & @hnr_org,1,1,0,1,3,300
89787687,itaih,,2,0,0,0,2,300
1687822944,enjoycloud,"Postdoc in Section of Ecology and Evolution, University of Copenhagen. Seeking universal principles underlying endless forms.",0,1,0,0,1,164
1020415484,gg816,,0,0,1,0,1,69
36333739,MatthewMezey,Growing The Health Foundation's 'Q community' of healthcare improvers. Co-author 'Anti Hero'. Co-founder 'Enlivening Edge - news from next stage organizations'.,0,0,1,0,1,300
1604120323,AngeliePeterson,"Marine scientist turned (marine) social scientist.  Island living, coffee drinking, occasional SUP surfing, PhD candidate.",1,0,0,0,1,194
21048756,MrVada,"Social systems, evolution & complexity, governance",0,0,1,0,1,49
119397731,npalaciosopazo,"Chile 🇨🇱, #generationX, #maker, #seriousgames #misfit, #science, #illustrator",1,0,0,0,1,300
13257922,manovich,"Director, https://t.co/GtaWT91sHh. Data science, digital humanities, media theory, visual culture. Professor, @GC_CUNY. https://t.co/GfGDiFlpnY
·",1,0,0,0,1,300
1567869163,annazhang418,"editor,publisher, from cheerspublishing china",1,1,0,0,2,300
1514096642,mmeierer,Leveraging data to build more customer-centric organizations. #DataScience #MarketingAnalytics #UniversityOfZurich,1,0,0,0,1,300
48582037,keddens,"Research Scientist, networks are everything, health comm, technology, promoting health equity, musician, mom. Crushing the patriarchy. Opinions are mine alone.",3,0,0,1,4,300
1434124465,frances02432596,"Ph.D., Senior Researcher and Professor in Sociology, Dipartimento di Scienze Politiche Roma Tre",1,0,0,0,1,190
554600169,golnazq,"PhD student interested in social networks and collective behaviors, economics, art, literature.",1,0,0,0,1,29
228568098,relax_n_tone,"~70% agua,  ~20% jamón y queso; un pocasbarbas cualquiera.",0,0,0,1,1,300
953121620,gursakal1,"Big data, machine intelligence and social networks",1,1,0,0,2,300
183242592,takayaarita,"Professor@NagoyaU Pubs: https://t.co/hYdCY0TSvn, GamifyAll!: https://t.co/RKzHeaEGB0",0,0,1,0,1,300
92413185,canalsinruido,Web Analyst | Análisis - Reflexión - Acción.,1,0,0,0,1,300
13896292,themobilecity,"International platform for new media, urban culture and urban design: http://t.co/XN6h0MmZVF. Tweets by @martijndewaal and @mdelange.",0,0,1,0,1,300
132964473,SukleAgency,"We are a small but mighty advertising agency. We take on some of the toughest problems for businesses, 
non-profits and government organizations.",1,0,0,0,1,300
17446365,bradd_libby,"I help companies & other organizations understand the impacts that rapid changes in technology, the climate, economics & society might have on them & the world",0,0,1,0,1,300
17862234,mcpcmcpc,livin la vida loca?,1,0,0,0,1,66
255629923,piranha032,"Software designer and developer.  Senior researcher at @GeorgeMasonU, @GMU_COS @GeoSocialMason @CINAatMason",1,0,0,0,1,300
995133259,DanBumbarger,Microscale Connectome-ologist. Large-Scale Electron Microscopist. Network lover. Nematologist living in a mouse world. Listen to the kids! Fight climate change!,0,0,1,0,1,300
414233212,taikeetoh,"Networks, Organizational Dynamics and Leadership",1,0,0,0,1,20
16728208,elhamrose,,3,0,0,0,3,152
318335269,zella_king,"Promoting simple, practical ways to understand and use networks. Speaker, writer, creator of @myBoardroom",2,0,0,0,2,300
17083959,kshameer,Senior Director @AstraZeneca. Data Science & Bioinformatics for Drug Discovery & Healthcare. Ex-@MayoClinic @MountSinaiNYC @Philips @NorthwellHealth #TEDx,1,0,0,0,1,300
1132337330,31stofNeveruary,#nmc13nyu,1,0,0,0,1,20
380587236,SocialMirrorApp,"Social Mirror is a @theRSAorg tablet application that you can use to measure, visualise, and see the potential for change in online and offline networks.",1,0,0,0,1,219
17483886,Diolia,D.I.O.L.I.A (Digital Intelligent Observation & Logical Infiltration Android). Internet advocate. PhD candidate  ஜ۩۞۩ஜ    Too old to rock'n'roll too young to die,0,0,0,1,1,300
17687374,rbsamp,"Doutorando na FCI da UnB, Pesquisador da FIOCRUZ, Analista de Redes Sociais",0,1,0,0,1,22
28116115,clarapelaez,,1,0,0,0,1,300
189062599,jankatins,"Data Engineer @zenjobcom | Python enthusiast | Jupyter R kernel | Ex PHD student (research productivity, social networks + capital) | former name: Jan Schulz",1,0,0,0,1,300
148186143,arsdeportes,Análisis Deportivo.,0,0,2,0,2,300
709506727,JasonJohnAnon,Ame-rican,0,0,1,0,1,99
21399603,tysukarna,"Microbiologist. Loves Writing, Art, Literature, Poetry, Music, Spiritual Enlightenment.",1,0,0,0,1,300
756258752,puertoinnova,Red de Innovación y Complejidad para Valparaiso.,0,1,0,0,1,106
14220249,juneholley,"Network Weaver https://t.co/cDkGeJzdah

Helping people co-create system shifting networks.",0,0,1,0,1,300
625043813,CivFromScratch,"On the idea of restarting civilization from scratch. Insights from fiction, myth, Big History, development economics, complexity, world history...",0,0,0,1,1,300
28333413,mgrani,"Interested on everything that makes machines smarter when they interact with humans == kdd, visualisation, information retrieval, machine learning ....",1,0,1,0,2,300
567282639,sittonomy,Open science project to develop a classification of sedentary behaviour. Combining expert opinion and folksonomy.,0,0,1,0,1,300
165254467,caikjaer,"Co-Founder at SWOOP Analytics, Social Networks Analysis, Social Business Analytics, Workplace and Connectedness. #SNA #socialbusiness #socbiz #collaboration",3,0,0,0,3,300
482098539,ecologyJMB,This is my account used for ecology and science related stuff. My account for less academic stuff is @eldromedario,0,0,1,0,1,126
595486855,derekruths,"Professor, father, husband, human",0,2,0,0,2,144
590436009,mcadeiras,,1,0,0,0,1,300
37887146,marnixvb,"works at @HuygensING, affiliated with @HumanitiesUU and @DHLabHuC || on #digitalmusicology, #earlymusic and #networks  || all opinions are my own",1,0,0,0,1,300
29100600,SandiKEvans,"Associate Social/Behavioral Scientist @RANDCorporation. Opinions mine, RTs ≠ endorsements.",2,0,0,0,2,144
36108390,ricardobcp,"Lecturer, Informatics Center, Federal University of Pernambuco, Interests: Artificial Intelligence, Machine Learning, Social Network Analysis, Text Mining",1,0,0,0,1,280
101939550,AlphaVu,"AlphaVu specializes in advanced network science. Our technology empowers you with competitive intelligence, message control, and smart engagement.",1,0,0,1,2,300
481276583,mmagmario,me,6,0,0,1,7,300
15364275,shalineemattoo,"Learning Sciences, Northwestern Univ
Research interests: Adult/social/workplace learning, learning and Improv, Learner-centric design,social network analysis",1,0,0,0,1,300
491627654,log2ex,Graduate student at Ben Gurion university . Working on network biology and machine learning,2,0,0,0,2,33
112417545,MJBells,,0,0,0,1,1,212
229188639,koondada,Guides for contemporary life.,2,0,0,0,2,88
25107327,plosee,"B2B Food Industry Marketing professional passionate about technology, business, food and the fusion of all three",1,0,0,0,1,300
418806837,AmrMabrouk7777,"this is my husband's photo. Exposure of his fall from faith to Allah, his deceit to gain access to America, and his desire to abuse women on social networks.",1,0,0,0,1,42
17714678,depijama,"Father, engineer, university professor and blogger. Interested in data mining, complex networks and deep learning",0,1,0,0,1,300
157853568,jockmcglinchey,Full Stack Software Engineer (Consultant),0,0,0,1,1,162
115022430,adamperer,professor at Carnegie Mellon University @cmudig @cmuhcii @scsatcmu https://t.co/0hHQ5pLWow,1,0,0,0,1,157
8333032,erdogan,"Designer, engineer, table tennis player. @prointeractions @itemology @ideo @georgiatech",1,0,0,0,1,300
336250261,PhillipBonacich,"A retired academic, I'm interested in social networks of all sorts.",1,0,0,0,1,0
334105417,GSCUPM,Grupo de investigación en Sistemas Complejos: research on complex systems.,0,0,1,0,1,19
15057368,arayadujisin,,1,0,0,0,1,300
316897219,ptitroch,"Sociologist @MemorialU and lover of chows. Researching social networks, inequality, culture and Indigenous/settler relationships.",2,0,0,0,2,300
14713264,joostrobben,Consultant @ Tulser Business Improvers | Human Performance Improver | Communities of Practice | 70:20:10 | Networked Performance Support | Tenor Sax | Hiking,1,0,0,0,1,300
308418615,SieciSpoleczne,,1,0,0,0,1,30
10656812,kindageeky,geek in all things,1,0,0,1,2,300
270254366,lbuzna,,0,1,1,0,2,7
155275081,mmedina00,"🇮🇨🇪🇸🇪🇺
Una mentira puede viajar por medio mundo mientras que la verdad está poniéndose los zapatos (Mark Twain)",1,2,0,0,3,237
143096221,zincointment,"sociology phd student (online components of social capital), infrequent user of capital letters and twitter.",1,0,0,0,1,31
41731386,Akrams,,0,0,1,0,1,247
14055621,aazout,,2,0,0,0,2,300
23118465,shawnfielding,"Knowledge Manager, Information Architect, Taxonomist, Project Manager, Team Manager, Librarian",1,0,0,0,1,256
19491781,carlos_pais,"BSc Mathematics, MSc Maritime, PhD Economy...To describe what ants, neurons, currency, society and containerships have in common is my field of work...",0,1,0,0,1,300
18898115,pmehra,SamsungVP.SNDKSnrFellow.CTO@FIO&Whodini('10-13).Dist.Tech.@TDM/CPQ/HPQ('96-10):Chief ScientistHPLRussia;Led https://t.co/UE5S91Tlue.IITD&UCSCfaculty. NASA. UIUC,1,0,0,0,1,270
7170942,raquelrecuero,"Professor and Researcher @ UFPel & PPGCOM/UFRGS. @Labmidiars coordinator. Research interests: social networks, social media, discourse raquel@raquelrecuero.com",1,0,0,0,1,300
35026490,5thAmendment,,0,0,0,1,1,100
58713845,scbaek86,Truth makes us free...,1,0,0,0,1,300
163264105,taka_iba,"Interested in creation, complex systems, autopoiesis, pattern languages, network analysis. Assoc. Professor at SFC, Keio Univ. Visiting Scholar at MIT, 2009.",0,0,2,0,2,300
64650455,evegood99,,1,0,0,0,1,111
8104332,esthr,"Assistant Professor of New Media and Digital Culture, UvA. Digital Methods Initiative. App Studies Initiative. NWO Veni: Apps and Data Infrastructures",1,0,0,0,1,300
1168651,arikan,Machine readable artist. @graphcommons @arikantr,1,1,0,0,2,300
11613152,molnarpal,,1,0,0,0,1,300
588596248,EricBeinhocker,"Institute for New Economic Thinking and Blavatnik School of Government, Oxford. Author of The Origin of Wealth. Against mass extinction, for human flourishing.",0,0,1,0,1,300
3010570270,exotic_options,,0,0,1,0,1,61
561542628,keepmving,"#Marine, Geologist and overall curious guy. #Strategy, #Policy, #Logistics, #Innovation, #Technology and #Data keeps me interested. RTs & links ≠ endorsements",0,0,1,0,1,300
3731273059,hidogeee,,1,0,0,0,1,233
1109099392043282438,jim_nelson_ai,PhD in Sanvito Group. Interested in Machine Learning in Nanoscale Physics,0,0,1,0,1,110
50720673,ZachScragg,🛰️,1,0,0,0,1,159
1251339713375621122,raphaelnagao,"Professor of Chemistry at UNICAMP and a science enthusiast: electrocatalysis, energy, materials science, nonlinear dynamics, self-organization, complex systems",0,0,1,0,1,2
576584432,dermot_lyons,"Small business owner - trying, failing, succeeding. Following my curiosity!",0,0,1,0,1,300
103187641,subashpathak,Statistician,0,0,1,0,1,221
1011271872904941568,TrendWatcher6,,1,0,0,0,1,300
1024556569,LChirgadze,,1,0,0,0,1,300
2423912846,PMTatSogeti,"Innovation Leader, passionately involved in all technologies that help better understanding of complex systems like socio-technical systems... (words are mine)",0,0,1,0,1,300
550089345,pythagodzilla,,0,0,0,1,1,55
245492030,Ekambos,Connecting the next billion people @DikaloMessenger,1,0,0,0,1,300
907399884742914048,SteelmanPodcast,Launching soon. [Too soon.],0,0,1,0,1,300
336410444,cesar__guerra,,0,0,0,1,1,34
759384737597296640,chini_mattia,"PhD student working on neurodevelopment @HanganuOpatzLab
Serial user of the 😂 emoji",0,1,0,0,1,232
1248728898633961472,ShashankaMadhu,"Founder and Chief Scientist, @incconcentric",1,0,0,0,1,81
1972106216,writetoAritra,Just another human being in the history of human beings,1,0,0,0,1,300
363544157,arun_lakshman,"Engineer @AmazonIN, Ex @WalmartLabsInd and @Zoho
Graduated from Madras Institute of Technology",0,0,1,0,1,300
1052645673206603776,JasonCmplxFtrs,"Complexity demands navigation.
Discernment... find the signal!
Decision intelligence.
Adaptation.
Stillness.
""Faster alone, further together."" -said many",1,0,1,0,2,300
43941974,esibeem,Leading @PEN_ed to scale #handsonscience across #Ghana. Teaching #engineering @Ashesi. Trained as #MechE designing nature-inspired tech @MIT.,0,0,1,0,1,300
257613238,EGY_PALESTINE,Muslim / Egyptian / CSE TUM / Mechanical Engineer  / Dreamer / People change and so do I.,1,0,0,0,1,300
456847092,aravindbattaje,Boom-de-yah-dah!,1,0,0,0,1,300
3221562564,putmands,"#ConsumerProtection postdoc @poverty_action. Ph.D. candidate @UCDavisARE studying development, networks, and risk. He/him/his.",4,0,0,0,4,300
982601882668556288,astro_centar,Astro-Tarot centar koji vam rado stoji na raspolaganju sa svim svojim stručnjacima i majstorima s nedvojbeno velikim znanjem i dugogodišnjim iskustvom,1,0,0,0,1,300
115796691,EnriqueCF,#localismo #lvssd,1,0,0,0,1,300
1220563159162834944,Sneha__Ka,"Dressing and interrogating data, making it confess! Navigating grad school with complex networks. Astrophysics buff.",0,1,0,0,1,141
138365208,manosalex,"BSc Physics Senior, hopefully starting a PhD by summer 2020",0,0,1,0,1,29
750396679069761538,DrJAConway,Founding Director of Waldencroft - Foresight | Agility | Culture | Leadership,0,0,1,0,1,193
1204112868922286080,watcherofflames,My name is Zeferino.,0,0,1,0,1,300
14719715,clasala,"Aprendo todos los días. Me gusta la fotografía, la tecnología y la música, sobre todo la de mi generación. Socio Director de MEDIAX - Gente de Medios",1,0,0,0,1,300
410624664,KSchmidt222,statt einer Ballade,0,0,1,0,1,300
1243966963757580288,BharatiVigyan,"Want to do my bit in promoting rationality, critical thinking, skepticism and scientific temper in the community",0,0,1,0,1,11
1098044969116418048,vineettiruvadi,MD/PhD @EmoryMSTP @GeorgiaTech; #Neuroengineer ∈ Neurosurgery ⋂ Control Theory; Tweets⟶{#brains #medicine} x {#geometry #smalldata} | my views; https://t.co/4CYEmYq2H6,0,1,0,0,1,279
105278779,juanfmarinm,"PhD. Venezuelan physicist. Interested in complex systems, soft matter & non-linear dynamics. Guitarist & Languages lover.",0,0,1,0,1,300
23774141,akmalariff,"geek out, trip out.",0,0,1,0,1,300
307236949,TangoRedDevil,"Data Scientist, Statistician, Machine Learning Enthusiast. Liberal and a Proud Hindu. Hate appeasement and religious fanaticism of all sorts.",0,0,1,0,1,300
3028713803,cryomath,Mathematical CryoBiologist,0,1,0,0,1,175
15325810,mokkaiputter,| Musk & Einstein Worshipper | Cracks PJs | Compassionate & Multipassionate | Sports Metal Adventure Travel Tech Photography Wildlife Space | Humanitarian |,1,0,0,0,1,300
762484770,Joao_Rezend,,0,0,0,1,1,300
939510933532975104,Faris_Spear,"Aspiring creative director and mathematician.
Huge fan of Imagine Dragons and Coldplay.
Read my further biodata on my website.
Turnips Stew.",0,0,1,0,1,300
4205138421,rjogallagher,"Interests: Org Network Analysis, Org Culture, MUFC, Hiking, Cooking | My_mission: improve human connection b/c we r #bettertogether | Views are my own",1,0,0,0,1,300
376520398,adhritutkarsh,but not yet,1,0,0,0,1,300
1237787589052182528,nabjrkr,,0,0,1,0,1,273
1000887830980292610,aljoshoh,PhD Candidate at the Institute of Computational Biology - Helmholtz Zentrum Munich,0,1,1,0,2,118
35065346,domingorex,un tal por cuál más ...un pringadete,1,0,0,0,1,300
87159799,NzRv,Wisdom of even and odd. #KTBFFH,1,0,0,0,1,300
911418141359534081,Wonjeong_J,"Sociology PhD student at Cornell - Gender inequality, Labor Market, Demography, and still exploring. This is not my cat.",0,0,0,1,1,51
759932047120969728,ImagineTraffic,"Build wealth by hacking business, trading and investing. Get the newsletter: https://t.co/QrjyAxKwLM",1,0,1,0,2,300
986843527,abhiatsunysb,"A dabbler of sorts. Loves travel, photography, books, movies, cricket, tinkering with technology... And oh yes,  am an economist and mathematical modeller.",0,0,2,0,2,300
426095664,jivelasquezt,"Spatial Ecologist @TNC_Colombia. Biodiv. modeling, global change and develop. of open workflows and web apps for data analysis and science comm. Own opinions.",0,0,1,0,1,300
905901552023609345,berkOezer,"CS Student, interested in financial markets and complexity science",0,0,1,0,1,300
1166381020926623744,diranlou,"Mathematician, Blogger, Web designer, Educator",2,0,0,0,2,300
80245218,hgdoebereiner,https://t.co/LpsNeyLCMO,0,1,0,0,1,107
410217634,bedwardsokc,,1,0,0,0,1,72
1205120041206927362,idm314,A worldwide celebration of mathematics every year on March 14. Proclaimed by UNESCO. Official account.,1,0,0,0,1,38
4423326263,juandaanieel,"Physics student at @UniYachayTech - Musician - Citizen of the World 
No le crean a los políticos, créanle a los científicos.",1,0,0,0,1,300
43864286,d_ramsden,"Finance, networks, markets. Views more or less my own.",1,0,0,0,1,300
2601811489,gajju3588,Entrepreneur. Engineer. Co-Maker of https://t.co/xlP29wjAmm,1,0,0,0,1,300
209246728,DavidChrisGer,,0,0,1,0,1,121
1200470186161258497,Nicholastrand,Physics student at University of Pisa. Passionate about physics by day and enthusiastic about space exploration at night. Writer for https://t.co/PIlQUFLho6,1,0,0,0,1,13
764629,DavidGurteen,"Conversational Leadership consultant, speaker, and facilitator. Founder of the Gurteen Knowledge Community and Gurteen Knowledge Cafes.",0,0,2,0,2,300
3344253089,davidsaidthis,"physics teacher
purveyor of snark
phd '17
he, him

#satire
#science
#art

#biophysics
#photography
#fiction

cashapp: $davidsaidthis",0,1,0,0,1,300
4815080079,Hajarology,"Passionate about People Analytics and Building Capabilities. Travel, Movies, Music, and Sports are my sweetest joy",1,0,0,0,1,196
4301915071,shrish1995,Young India Fellow,0,0,1,0,1,300
970362379564437509,Sandra_RoPi,🇵🇪 PhD student @harvard - Uchida Lab  - Previously Bioengineering MSc @epfl,1,0,0,0,1,275
1184465987372048384,the_simon_v,Skin in the game || Student of life || YouTube + writing || Nonteleological Tinkering,0,0,2,0,2,255
31595854,nikolaygb,To Cloud or not to Cloud? What are the obstacles to adopting Cloud Computing?,2,0,0,0,2,300
1165971367046635521,KashtanLab,Systems Microbiology & Microbial Ecology,1,0,0,0,1,63
778630404144181248,MrMgvs,sharing tips and tricks for the math community 💡,1,0,0,0,1,300
836383701701394432,TradeBoston12,,0,0,2,0,2,300
16697997,ratzlow,"Tech Lead, finance",1,0,0,0,1,300
980875692719165442,AlexGCabanillas,PhD student at @StrathMathStat modelling Scottish #Kelp forest dynamics. Funded through @SuperDtp1,1,0,0,0,1,300
17387043,garamirez,"Electronic Eng. Working at @grupodot, Cloud tech, Machine learning, AI, Bigdata and Fintech fanatic. All opinions are my own.",0,1,0,0,1,300
1103281976142950400,logicsoup,"🔮Game engine,graphics & game programmer, prev. embedded; math
🌿Making a plant growing sim & ecological reconstruction game w/ @epcc10
🐛@rusttallinn organizer",0,0,1,0,1,300
49628824,AdinoyiSadiq,"Software engineer, AI learner. I build intelligent things.
@Colab_kd alumn. On the hunt for quiet places and big ideas.",1,0,0,0,1,300
4637195357,SamRNolen,"ML Eng @ https://t.co/MWljvCHL1Z, prev. Google, Airbnb, Stanford math PhD. Writer, story collection in progress. Likes languages, philosophy, cats, books, socialism",0,0,1,0,1,300
16802290,_davidturnbull,SaaS & ecommerce growth 💻 📚 🏋🏼‍♂️ 🎧,1,0,0,0,1,23
4637020513,Duesgottjules,,0,0,1,0,1,143
19338634,scott_pdo,"complex systems, agent-based modeling, visualization. creator of flocc.js: https://t.co/65UWWARakN
he/him #スムチー",0,0,1,0,1,300
952365161909706753,bajwa_jamal,Physics. Probability. Economics.,0,0,1,0,1,186
805765919624544256,izzetkalic,"Full-stuck developer

https://t.co/Hh1cdcgdbV",1,0,0,0,1,248
779717852,AJohnBotha,More ideas,0,0,1,0,1,77
1734770006,GalaneJLuo,Researcher https://t.co/JEUt3dHfr8. Applied maths/plant modelling/biophysics/quantum mechanics/complex systems. Publishing as J Luo. Views my own & pretty worthless.,0,0,1,0,1,37
1199276108220289027,TheAviatorFrame,"Student pursuing PhD at IISc, Bangalore in Computational Systems Biology. Artist as well. Like to explore the symbiotic relation between art and science.",0,0,1,0,1,24
319700136,MsRenuGrover,"Strategy @SFBART; an interdisciplinary via finance, mgmt consulting, tech, nonprofit, government. Running is my freedom.",2,0,0,0,2,300
95463163,ArtDijk,"Management cybernetics, complexity, safety science, sailing and golf, thats what I like.",0,0,3,0,3,259
359051743,EliotPence,head of international @anduriltech | sr. assoc. @csis | mentor @TsaiCity | sr. advisor @mclartyassoc,0,0,1,0,1,300
233359622,pinkertonsplash,PhD student in Urban Information Systems @MIT | Co-Founder @bitsenceio | Studying Cities & Technology | Researcher @senseablecity and Urban Economics Lab,2,0,0,0,2,300
1002839536601198593,Mahendarsonii,"learner! 
web and Graphic designing, video editing.",1,0,0,0,1,289
1202311940,ERDekhayser,"Rice University '21, CS/Math | Soon: @twosigma | Previously: @Apple, @NYTimes, @iOSDevWeekly, @rwenderlich",1,0,0,0,1,300
564004166,ge_miak,Programming - Software and Web development🕵️‍♂️💻 Science Enthusiast🧪 Travel🗺✈ Adventures🚣‍♂️ Amateur photo📸,1,0,0,0,1,300
1085381489435435008,probabilish,Grad student @ UCSD CSE. somehow. I like probability and counting,1,0,0,0,1,292
1214962829964521474,ugotcucked,,0,1,0,0,1,254
2664444458,colecjones,,0,0,1,0,1,136
186550622,plemoineA,,1,0,0,0,1,300
449001585,RaymondRyan3,"Money manager. CFA. Adjunct Professor of Finance. Husband, father of two. Huge Rush fan. Go PU!  PU Football!  PU LAX!  Go Cards!",0,0,1,0,1,300
349094385,PrinzMangoRobot,.... did somebody say Mango?,0,0,1,0,1,300
38387578,Iammattaustin,"Entrepreneur, investor, space geek, veteran, father. Multiple successful startups. Not a power ranger.",0,0,1,0,1,300
548472727,goldollarch,,0,0,1,0,1,98
585025526,SumanPeel,,1,0,0,0,1,300
1146602493750710273,SaterAmy,"Developmental biologist - cell fate determination, genomics, chromatin, glial development, astrocyte superpowers (plus politics & the middle east).",1,0,0,0,1,180
14171809,steeleprice,Thinking is the best way to travel.  I generalize abstract nonsense...,0,0,1,0,1,300
1019934768597790720,RobertBajko1,"Universities, Education, Intellectual Property, Innovations, Technology Transfer, Start-ups, Incubators, Accelerators, Entrepreneurship, Investors, ...",0,0,1,0,1,241
1171526114004496385,LerchEcoEvo,Theoretical ecologist and evolutionary biologist studying social and reproductive behavior at UNC Chapel Hill,2,0,0,0,2,126
998975139936112640,sarahhsolomon,"Postdoc in #CognitiveNeuroscience @Penn Psych researching semantic learning and memory using behavioral, fMRI and computational modeling 🧠she/her",0,0,0,1,1,87
997148958,esraa_nob22,"https://t.co/TRFPL9TdEz. in molecular biophysic, interested in oncology, immunology and computational biology ❤ 

Seeking a PhD position in computational biology.",0,0,0,1,1,300
1135416025,BhavKhatri,"Theoretical physicist/biologist working on evolutionary theory with an interest in how viruses, mosquitoes and transcription factor-DNA binding evolves.",0,0,1,0,1,300
222192493,AutumnPenaloza,"Marketing & Community Lead for global blockchain tech company @shEOS_org | Partnerships @SenseChat | Soccer Mom | ❤️building companies, slow food & fast beats.",1,0,0,0,1,300
19709767,rafacm,,0,0,1,0,1,300
859583381155217408,MichaelHirson,"Practice head for China and Northeast Asia @EurasiaGroup. Formerly with US Treasury in DC, Beijing and Kabul. Prodigal New Yorker. All opinions my own.",0,0,1,0,1,38
3184250232,livecitizen1,,0,0,1,0,1,300
1437257072,AledSmith,"Trainee consilient observer, joining the dots, buying cultures not stocks, trying new things and riding off into the sunrise. Views are my own.",0,0,1,0,1,300
1204544826592518144,zalqt1,nothing original to see here,0,0,1,0,1,240
974881006267305984,curious_siddy,"Perpetual Learner.📚
Business Enthusiast.💼
Movie Buff.🎬",0,0,1,0,1,300
244496688,Zushauque,,1,0,0,0,1,300
14681731,thiagoricieri,👨‍💻 Lead Software Engineer at @PlutoTV (#iOS #iPadOS #tvOS #macOS) - opinions are my own🏋️‍♂️✈️💻🇧🇷🏳️‍🌈 he/him,1,0,0,0,1,300
542333820,CaseyDowdle,Life is just one big optimization problem.,0,0,1,0,1,300
104605178,DCMAraujo,less is more. more is different /// retweets or ❤️s do not imply political endorsement.,0,0,2,0,2,300
10655692,robvanroessel,sentimental bastard | changing man | extracting simplicity out of complexity | design thinker | bakkenist | option trader | antifragile | ambivert | bluegives,1,0,0,0,1,300
340593830,jacobalder,"""The difficulty lies not so much in developing new ideas as in escaping from old ones."" - JMK",0,0,1,0,1,300
434387843,carcarortega,🌻 Don't look back in anger. Científica en construcción. 🦉,0,0,1,0,1,300
520143405,BarrySlaff,"Software engineer. Interested in cloud computing, data science, and math. Athlete, Paddler. Math boards: https://t.co/jdSDM77spE",0,0,0,1,1,300
2688462513,SecretOriole,this is just so I can look at some funny tweets,1,0,0,0,1,163
52467464,kashifshakoor,,1,0,0,0,1,300
18211136,artzandy,"Married to @pink_ketchup. Work @socialcapital. Army Brat. Half-Mexican, Half-Nebraskan.",1,0,0,0,1,300
20715259,baarvaaz,Loves: Wife & Daughters; science & technology; entrepreneurs. Views are my own. Dont use them to guide your investments.,1,0,0,0,1,109
1649839933,nimblel,"Be resolute, fear no sacrifice and surmount every difficulty to win victory (Mao Tse Tung) #SmartCity #BlockChain #Finance #Leadership  #MachineLearning #AI",1,0,0,0,1,300
899323808494039040,YochayJ,Mathematics,0,0,1,0,1,83
19952367,fartashh,Python enthusiast with big passion for Data Engineering and Data Science. CTO & co-founder of https://t.co/eM47JcV2Ia and founder of https://t.co/7HKSQm9MRF,1,0,0,0,1,284
1032112826,jananth60,An eventually consistent guy 💻,0,0,1,0,1,152
79160417,Zoubir03,"Developer, Industrial Robots Programmer, photographer, bookworm, blogger & polyglot. #Robotics #Space #Bitcoin",0,0,1,0,1,300
1126032260103172097,JuneHua71214380,,0,0,1,0,1,203
103264126,grkkarthick,"Lead Software Test Engineer at Qube Cinema Technologies
I test micro services than APIs",0,0,1,0,1,240
996775452889919488,placebocoder,"code, physics, mathematics",0,0,1,0,1,261
773965925955604481,indimishra0811,"Aspire to Inspire.
I make YouTube series for Reinforcement learning",1,0,0,0,1,182
1035382651,Shauiib,Writer,1,0,0,0,1,299
1175041921510776834,SecularMystic,"Promoting conversations about living non-religious life in today's world.
Especially about things like building #secularcommunity, practicing #meditation, etc",0,0,1,0,1,300
1183549910047547392,JunjieJiang4,"I am studying complex systems right now. However, I am trying to study computational neuroscience in the future.",0,0,1,0,1,23
9992882,josereyero,Freelance Consultant / Drupal Developer,1,0,0,0,1,300
141311034,artix41,Quantum computing and machine learning @DTU_Compute. Incoming PhD student @UCLQuantum,1,0,0,0,1,285
2331867139,computoloco,PhD-ing 🧐 Amante de las ciencias de la computación ⚛️ Investigar e informar. Soy de los que cree que los seguidores de cristo no se parecen a él. MNMLST & Rolo,0,0,1,0,1,300
2335907222,languagejones,Computational sociolinguistics. Psycholinguistics. Phonetics. Statistics. African American Language. Chinese. Persian. Zulu. Linguistic discrimination.,1,0,0,0,1,300
2840744001,JCBeique,,0,1,0,0,1,76
1171493632571924480,FionnMcglacken,"1st year BA Data Science with Psychology @nuigalway. Actor, performer. Criticise me honestly. Stay home.",0,0,1,0,1,298
963092985683390464,JeffScript,Human Computer Interface,0,0,0,1,1,300
249564617,posijon,"💻 🐻 🎾 ♠️ 🥈 
            🐢
            🐢
            🐢",1,0,0,0,1,29
958032072341258241,relentlessmb23,Seeking legend ⚔️,1,0,0,0,1,300
93312183,alphalo,just visiting from another universe #gameb commons approach to climate change. Social permaculture.  Complex systems applied to society & permaculture.,1,0,0,0,1,300
3354648345,maniatisgiorgos,,1,0,0,0,1,25
232439599,recborg,,1,0,0,0,1,300
4425997992,LaughingRonin,“the real enemy is the man who tries to mold the human spirit so that it will not dare to spread its wings”                                 -Flexner,0,0,1,0,1,300
1172846539263434752,MaybeRealJames,"An ad-hoc, informally-specified, bug-ridden, slow implementation of half of a research software engineer. Author of Super and MMLigner. #RSE #VIB",0,0,1,0,1,133
2381348239,warren_k_miller,Quant insights on the asset management industry and investing. CEO of @FlowspringInc. Fmr Head of Quant Research at Morningstar. Father of 3. Science/data geek.,0,0,1,0,1,300
1056985898,baserema,,0,0,1,0,1,86
25655371,wanyixue,街頭混混,2,0,0,0,2,119
1145641108183166976,realJaapBennen,"#Geopolitics, #Hardware, #HUMINT, #OSINT, #Philosophy, #Robots, #AI, #Ethics, #Defense, #StrategicStudies, #Security & #Society. 🇳🇱 🇺🇲 🇦🇺 🇷🇺 ✨",1,0,0,0,1,300
1047893124083802112,CCiL_UAB,Cognitive Science and Language at @UABBarcelona. We study different areas of cognitive science using multidisciplinary approaches.,1,0,0,0,1,295
15001916,hazar,@partzonex,1,0,0,0,1,300
12685362,ejalm,"prof of biological eng at MIT, co-director center for microbiome informatics and therapeutics, co-founder finch therapeutics and biobot analytics",1,0,0,0,1,300
885722868,melsreallife,The truth is not simple it’s just profoundly clear.,0,0,1,0,1,300
786707,tquinlan,"Chief Storyteller, Narrate. Complexity, narrative, collective intelligence. Working with UN, governments, NGOs and private sector on wicked challenges.",0,0,1,0,1,300
28980216,adulong,Love to learn and on a mission to make it fun to learn for the new generation with @apptembo 🧁,1,0,0,0,1,300
1679233585,OmkarChandra,🧬🧫🔬👨‍🔬⭐👨‍🚀,1,0,0,0,1,300
120161886,R9Rahul,,1,0,0,0,1,34
788181127584423937,hersh_patel,parsing through garbage 🗑. wonder what my run time will be. did enough math to know I can’t be Bauss like Gauss.,0,0,1,0,1,77
863998320695312384,compsocsys,"complexity science. cities. poverty, inequality, segregation. social security. localism, decentralization. @kreauniversity, @imperialcollege. views personal.",0,0,2,0,2,154
2845711157,curateitforme,,0,0,2,0,2,300
17844189,hnaik,Senior Software Engineer - HERE Technologies; AI Researcher; Ph.D. Student at University of Illinois at Chicago,0,1,0,0,1,300
1009617669790818304,CTropini,Assistant Professor at the University of British Columbia studying the gut microbiota in health and disease.,0,0,1,0,1,15
120414103,tyskevdb,Assistant professor at VU - #DataGrant - Slacktivism - coordinator ResMa -Home brewer - Proud dad,1,0,0,0,1,300
97027078,ctastan,⛔SOSYOLOJİ BİLMEYEN GİREMEZ⛔ Sociologist. J. Lacan reader. Interested in xenophobia.,1,0,0,0,1,300
3123373786,achveto,"Business Manager, Investor, Dad, Painter, Weights lifter, Eternal Learner",0,0,1,0,1,111
137783168,alanyoshida,I'm a very curious person that just want to learn everything. Working as SRE at Dafiti Group.,0,0,1,0,1,300
101611802,skajster,Neurosurgery & spine. Medical devices. Entrepreneurship. New technologies & inventions. Truth matters.,2,0,0,0,2,300
22262188,cmpscabral,software engineer / partner @ https://t.co/H3CELDhzKS & https://t.co/3Xa9h15Ky8,0,0,1,0,1,300
224224934,EmanuelUbert,Org Learning & Evolution. (Climate) Disruption & Adaptation.  Property Insurance. Risk vs Uncertainty. Alternative Futures. Postdoc@USI. PhD @UWSoc. #rstats.,1,0,0,0,1,300
243263553,HCorderoGuzman,"Teach at CUNY (Baruch-MSPIA) & care about education, work\labor, demography, migration, philanthropy, social policy & NGOs. These are my personal views\opinions",1,0,0,0,1,300
790940902546108416,0xZoomer,hacker & painter,1,0,0,0,1,300
785107323433943040,Yalllllah,"Farmer, AnSci PhD candidate at Cornell, sheep, grazing",0,0,1,0,1,60
1165834271367618560,ParthGirdhar_,"Theoretical physicist currently @Sydney_Uni
Quantum+Gravity",0,0,1,0,1,145
1067329832969748480,tumultivariable,Learning to human. Mostly rational. Often on the fence unless the gravity pulls me down on a side!,0,0,0,1,1,125
402033488,krishnadusad,BS-MS @IllinoisCS ‘19. SWE Money @Uber. Tweets are mostly notes to self :),0,0,1,0,1,300
70769707,benwansell,"Professor of Comparative Democratic Institutions, Nuffield College and University of Oxford, Co-Editor CPS, FBA. School governor.",0,0,0,1,1,300
1004818385182642176,Abel_TorresM,"Research Scientist. Machine Learning. Building general algorithms with common sense reasoning. Looking for collaboration on robotics, drug design",0,0,1,0,1,300
251788197,moarv2,,0,0,1,0,1,300
844212848796581888,christianwknapp,"Digital, strategy, and growth @cmgpartners. Believer in community. Award-winning carnival game operator. Love empowering low-code/no-code tech. Opinions=my own.",1,0,0,0,1,300
1015452562944770055,willemissa,,1,0,0,0,1,112
1056522236360822786,FinnTimber,Guitarist and singer for the progressive rock/metal band Cantor https://t.co/tPHXEdXNAQ,0,0,1,0,1,300
706326777476444161,EricRicePhD,Associate Professor at USC in Social Work. Founding co-director @CAIS_USC. Working with communities around the country to help end youth homelessness.,2,0,0,0,2,300
605623467,rmyeET2001,,0,0,1,0,1,300
763092,darth_mall,"Existential there
Preferred: 🐘 https://t.co/AFy1odayMT",0,0,1,0,1,300
1516768171,jm_aburto,"demography, population health, violence, data, maths, #rstats, 🇲🇽 | demógrafo",1,0,0,1,2,300
999176623386591232,fermatandtheory,"Maths guy, Data and Law are love. Civil Servant",0,0,0,1,1,300
2766062334,amartindelrey,"Spanish applied mathematician interested in security, cybersecurity and complex networks",0,1,0,0,1,300
2417991280,NoNeedForHandle,We who cut mere stones must always be envisioning cathedrals.,0,0,1,0,1,196
3302087857,CjMurphy_,"Software developer, dreamer, and lifelong learner. Interested in math, economics, finance, and technology.",0,0,1,0,1,300
966298270799683594,sherajilir,"PhD Candidate. Flâneur. Mol. Genetics & Data Analytics. R & Python. Cancer Metabolism. Science, History, Philosophy, Stoicism. Big fan of The Vienna Circle",0,0,1,0,1,300
899976394435735552,arpansview,"Cognitive neuroscientist | failed astrophysicist | wannabe blues aficionado | ex-psychedelic rock enthusiast ;-) | Dad |

Tweeting in personal capacity",0,0,1,0,1,300
884827710610132993,_JesseMorton,"Former #jihadi. Expertise on jihadi ideology, foreign affairs and #CVE. All things #ISIS and #alQaeda related. Cofounder Parallel Networks. All views my own",0,0,0,1,1,300
933294497907089408,jovanjuravlea,https://t.co/ySSjBLGhjD COMING SOON,0,0,1,0,1,300
1109016430895394817,ConsultingAqp,"I have a head for business and a heart for people. Writing about human capital management, critical thinking and making better decisions. It’s art and science.",0,0,1,0,1,227
2314625370,sravUpp,"Teaching Biology, Studying Development, Learning everything (there is so much!)😊",0,0,1,0,1,153
104177478,JBruineberg,"New to Twitter, more generally late to parties. Post-doc at TU/Eindhoven and AMC Amsterdam. The more interdisciplinary the better.",0,0,1,0,1,286
2573509820,ChiaHoL,Research assistant in the Psychology Department at National Taiwan University #EEG #fMRI,0,0,0,1,1,187
1087573665162485760,musler_r,Enjoy reminiscing with people I don’t know,1,0,0,0,1,23
239672582,schadballs,bird in the midnight falcon lookin ass,1,0,0,0,1,300
471020521,maleitner,,3,0,0,0,3,154
1003691411915431936,Sur3_Altus_7Qua,"A mad scientist envisioning & building utopia, through greenovating & creating other technologies that lead to that vision. Ad Astra, Memento Mori, Tempus Fugit",1,0,0,0,1,300
24902338,anandvemuri,Cofounder @91springboard,1,0,0,0,1,300
1147482551834906624,khoribe3,Ph.D. student/ Theoritical Biology/  ITU Game AI Group #CSSS2019 #ALIFE #Biophysics #gameAI,0,0,2,0,2,142
99307877,muratgurel,Game Developer at Gram Games,0,0,1,0,1,300
2983258320,KazemiAlex,"Father & husband then intensive care doctor & aspiring writer. Likes hanging out at the intersection of science, poetry and sharp pencils.",1,0,0,3,4,300
839839092594499585,joshiamitabhevo,"Evolutionary biologist, population ecologist and poet in urdu and english (and occasionally, farsi)",1,0,0,0,1,300
873937024562208769,Iqbal62Sajid,,0,0,1,0,1,184
17354357,stevequezada,father of 3 | constant learner | tech enthusiast | mixer of fine martinis | https://t.co/OZDzfGaSn9,1,0,0,0,1,300
445522148,inpursuitofvoid,"⚠️UnderConstruction! Tech, OpenSource, Analytics, Market, Finance, Chess, Adventure, Eat, Sleep, Music, blah! *Personal views*",0,0,1,0,1,300
1104024379225190401,BerkYigit__,"PhD @MPI_IS @CarnegieMellon. Robotics at the microscale, swarms and self-organization.",0,0,1,0,1,47
21795118,rahdilarum,"Data Scientist, ML/AI Engineer. Values, architecture, design & open source. Thinks, membership is the key to health & happiness; not dominion 🌎🌻🐝🌱🐾💕♻️🖖🏼",1,0,0,0,1,300
14255819,J_wilkinson,Growth @lucidchart,1,0,0,0,1,300
1035887523380088834,cuhkhailiang,"computational social science, social media, political communication",1,0,0,1,2,200
79123130,krishnanpc,"#HCI #AI #IUI. Masters @Uni Hamburg, Intelligent Adaptive Systems.
Ich bin kein Roboter.
Palakkad, Kerala / Hamburg.",0,0,1,0,1,300
366709216,spant_18,"PhD Candidate @Illinois_Alma, @tcbguiuc, @BeckmanInst,
Beckman Institute Graduate Fellow, Computational biophysicist interested in transporters, ion-channels",0,0,1,0,1,300
1087677515072716801,Vinh_CFD,My name is Vinh Vu and I am a PhD researcher at the University of Sheffield. My research is on fluid flow through an array of obstacles.,0,0,1,0,1,17
1136179294265327616,RandomPandey,"ML PhD researcher @ ESAT-STADIUS, KUL",1,0,0,0,1,38
27121427,elpetay,"Husband, Dad, Mechanical Engineer, student (more Mech.Eng.), runner, biker, Biker, swimmer ...",1,0,0,0,1,300
474984731,Fergus_Connolly,Corporate | Sport | Tactical  -  Keynote | Tedx | Speaker | Author,2,0,2,0,4,300
9864482,lutherlowe,SVP of Public Policy at Yelp,1,0,0,0,1,300
1038979640663126017,EebNaven,"PhD student | Theoretical Ecologist | Eco-evo dynamics, species interactions, range expansions | University of Minnesota | Past: IISER, Pune",0,0,1,0,1,92
17294753,chrisbrockphoto,"Life Coach | Author 📚 Shine Manifesto 📚 Do The Thing, Have The Power 📚 Outpost | Photography over at @chrisbrockphoto",1,0,0,0,1,300
577629252,LowellHennigs,,1,0,0,0,1,300
551705709,MathigonOrg,"Discover the Textbook of the Future: more interactive, personalised and engaging than ever before. Created by @philipplegner",1,0,0,0,1,300
1533381692,JRRiebling,,1,0,0,1,2,46
240666745,petergarnry,"Peter Garnry, CFA is Head of Quantitative Strategies at @SaxoBank. Responsible for the bank's tactical asset allocation strategy Stronghold.",0,0,1,0,1,300
311942906,bocahsoto,"having fun w coding | mostly sci-tech, economic & life | twitter as notetaking & meme bookmark | mahasiswa in comp sci ugm",1,0,0,0,1,300
42874778,ch_b,,0,0,1,0,1,57
153276720,BlackSamrat,,1,0,0,0,1,300
869683043388325888,Mikonos_sea,"Gamer ,Programmer",1,0,0,0,1,135
993915372062601216,davidgarza95,The University of Texas at Austin Class of ‘19 McCombs School of Business 🌃 New York City SC: davidgarza953 Instagram: davidgarza95,1,0,0,0,1,228
909276094292934657,ldvcde,,0,0,1,0,1,139
758873394553118724,TopBandito,"Smol weewee Big heart  6'9 || 
UWM Applied Mathematics & Computer Science",0,0,1,0,1,300
9335602,Basheir,"Interested in product development, education, financial markets, Fintech and philosophy",1,0,0,0,1,158
1844376104,DavidElliottNI,"Climate/energy policy & econ. May tweet N. Irish politics when homesick | ex-UN NGOer and @Demos & @jrf_uk alum | pianist, film geek, social democrat, Irishman.",1,0,0,0,1,163
1103395910866878469,ManaHeshmati,Strategy doctoral candidate @MichiganRoss. Interested in behavioral strategy & all things tech.,0,0,1,0,1,76
324203377,pvmichaels,Quant at CIBC Asset Management. Opinions are my own. RT doesn't mean endorsement.,1,0,0,0,1,170
52393154,agostbiro,Software Engineer (ML & Full Stack),1,0,0,0,1,300
3317230737,MarcoFaggian18,"Physicist, PhD in Statistical Physics of Nonequilibrium Phase Transitions, Lover of Photography and Videogames",0,0,1,0,1,183
1516282950,arpit_gogia,Just an engineer,0,0,1,0,1,300
1664602957,I_Seek_,"A counter for incoherent speech. Wanderings of a conscious, sometimes semi conscious mind.",0,0,0,1,1,300
17028262,loriabys,"Dominicana 🇩🇴  
Director, Software Engineering 💻
@Marvel Dev Illuminati. 
Tweets are my own 👀",0,0,1,0,1,300
3291546188,jungjongyun83,"Research on the intersection of genomic data, machine learning, Ph. D student in @Biostatistics at @UNLV, all opinions are my own.",0,0,1,0,1,300
864608682,pato_0816,Architect l Founder R-Ex | PhD in Human-Robot Collaboration @WSofArchi | Course Master @AADRLab,1,0,0,0,1,300
49202698,jrieffel,"Associate Professor, Computer Science, Union College. PGP Thumb 24A3 9B7C 
D67C 54B9 4889  A06F 56B0 687A 19D6 378E",0,0,1,0,1,300
3749328498,LaFille_Etrange,"almost human 
*insert a quote that would resonate with you*",0,0,1,0,1,300
2588383794,MarkLehman9,Proud deplorable - tired of all the winning!,0,0,1,0,1,198
1914330152,LydiaDenworth,Science journalist and speaker. Contributing editor @SciAm Blogger @PsychToday Author of FRIENDSHIP (@wwnorton). In stores now.,1,0,0,0,1,300
92771328,diegomacrini,Computer scientist @Proximify working on disruptive web tech products. @UofTCompSci alumnus in #AI. 🇦🇷🇨🇦,0,0,0,1,1,300
745629900648947712,jasinjames_dev,here we go again,0,0,1,0,1,210
60998488,bartleeten,"Enterprise IT Architect, Offering Manager - DXC Technology (HPE, HP, EDS, Praktos before), deadly curious (opinions are mine)",0,0,1,0,1,300
907380488360341506,slramirez646,"Program Director, Data Scientist @InsightDataSci | Machine Learning | NLP | Applied Math",1,0,0,0,1,184
363055948,Charitonas,Research Scientist | Head of Quants| Previously working on Rosetta Mission (European Space Agency),0,0,1,0,1,300
300081306,bcaessens,"Psychologist, creative mind, husband, father, science geek not necessarily in that order",1,0,0,0,1,300
318065879,GarnettGriffin,,1,0,0,0,1,43
21328708,Clearingfog_,Private equity investor trying to better understand how the world works. I write long form at https://t.co/Q4YpMIxYnB. DMs open,0,0,1,0,1,300
3037665311,kimfuge88,,0,0,2,0,2,300
2191048585,montori_m,"Exeter '12, Princeton '17. Spent 2.5 years at Princeton University Investment Company, now starting something new!",1,0,0,0,1,300
2308539301,TamirGuy1,,1,0,0,0,1,300
2403273728,rgpatsy,,0,0,1,0,1,300
2522209639,HarshaGurnani,"Neuro PhD in progress. Love talking about the brain, math, and any odd bit of science+arts. Striving for kindness. Thinks animals are cool, really cool. She/her",0,0,1,0,1,285
983392295646126080,IftachN,Researcher at Tel Aviv University. Likes to play with embryoid bodies to understand development.,1,0,0,0,1,89
1094184466367447040,chaiyi_lin,i am ali,0,0,2,0,2,300
480959060,thedanigrant,👾 @USV | 🕵️‍♀️ Send me a mystery https://t.co/ELmGEzcVQQ | 🌏 Offset CO2 with me https://t.co/DT61v8bLPO,1,0,0,0,1,300
859906554853773312,ThirdActor,,0,0,1,0,1,300
2322060133,MustafaVora712,,1,0,0,0,1,5
848076644,DeShawnVaughan,University of New Mexico Math and Econ (2019). RA at the FRBG. Views are my own.,0,0,1,0,1,300
2665361222,rramariano,🌹| Junior Physicist,0,0,1,0,1,300
34671756,petrom_,"picking nits.
My (bad) opinions.
How to lose friends and alienate villagers",1,0,0,0,1,300
887247166120624128,jstotero,"Helena Normanton Fellow at the EPic laboratory, University of Sussex.",0,0,1,0,1,235
196464449,satoverma,Committed to Engineering. Having affairs with Philosophy. Aspiring polymath.,0,0,1,0,1,300
1320073063,drsaidl,What do I do if I do not know what is going on?,0,0,2,0,2,300
142686700,_ekohan,,1,0,0,0,1,300
2576179145,pwsh_guy,"Наш путь извилист, но перспективы светлые
#Powershell #Azure #Automation #Microsoft and other technical stuff!",1,0,0,0,1,300
986495402,AIsakovic1,"Physicist, professor & researcher. RTs & Ls don't necessarily imply endorsement. Staying positive matters.",0,0,1,0,1,300
1287350712,psarygin,running II bouldering II reading II into self-driving cars,0,0,1,0,1,300
207463880,tweetcaroliine,"Knits, thinks, does maths",0,0,1,0,1,300
200878604,EloiTelesh,Ambiguous kid from the former colonies.,0,0,2,0,2,300
938261318355709953,troyjcoleman,"Software Engineer. Trying to bring about the rise of the machines, but instead they seem to keep raising productivity and improving human living standards 🙄",1,0,0,0,1,300
356578335,christine_owl,Societal Computing PhD Student at @SCSatCMU researching disinformation online,1,0,0,0,1,300
13557952,leocorgy,,0,0,1,0,1,300
192483735,G_Singhal,Co-Founder & CEO of https://t.co/0HHw6JjG2l | Former Lead #DataScientist  @WFP @UN. #AvocadoToast aficionado.,1,0,0,0,1,204
740395354701582336,werner_bartl,Therapeut und Sinnsucher in einer immer verrückter scheinenden Welt,0,0,1,0,1,300
834322127637585920,UlrikBeierholm,"Assistant Professor at Durham University, UK
Researching computational neuroscience, cognitive psychology, machine learning etc....",0,0,1,0,1,230
152216709,mberth,"Ideas, Lean, Lean Software Development, Continuous Delivery, Business Agility, Systems, Mathematics #{firstname}@#{firstname}#{lastname}.com",0,0,1,0,1,182
870426072571146241,V_Bainton,Chief Medical Officer @Havaslynxeu | scientist & medic | erstwhile clinician | technophile | policy puzzler | art-fiend | insatiably-curious questioner,1,0,0,0,1,300
17216089,MarkLeBay,UX Designer at Epic,1,0,0,0,1,300
737293781553254401,d_brueckner,PhD student in the theoretical biophysics group of Chase Broedersz @LMU_Muenchen. Opinions are my own.,0,0,1,0,1,250
391633864,pawarsurajpawar,what man is a man who does not make his world better,0,0,1,0,1,300
360904373,ycanaybas,stanford 🌲 econ phd student,0,0,0,1,1,300
703908181123211264,WayneRostant,Evolutionary Biologist. University of East Anglia. Views are my own.,1,0,0,0,1,300
440719857,cabralestweet,"Professor of economics UCL, part-time Sith Lord. Opinions here those of the dark side, not of my employer.",0,0,0,1,1,300
796394294005219328,JeetJain420,reality outran apprehension,2,0,0,0,2,300
961675859588534272,WickedOoloi,"Blogger, Mental Health Advocate, Environmentalist, Anarchist, Bisexual, Insatiably Curious",0,0,1,0,1,300
880158859716853760,elibpollock,"MIT PhD student interested in the intersection of neuroscience, computation, and cognition.",0,0,1,0,1,151
700592709287809025,jay7yagi,Flaneur,0,0,3,0,3,300
875188155095371776,denismazurak,,0,0,2,0,2,197
49335600,kananajmera,"Founder, CEO Builders Patch. @builderspatch. Architect, entrepreneur and twin mom superhero!",1,0,0,0,1,127
1000019520596082688,nicelyonarg,"Math, CS, Physics, Economics, Finance and Political Philosophy.",0,0,0,1,1,257
2272801142,EloyChristophe,Rocket scientist wannabe,1,0,1,0,2,188
484333502,eamon_mcandrew,NUIG masters student studying Biomedical Genomics.,1,0,0,0,1,300
2576431,cbasturea,"Digital Customer Experience Manager with EY. Interests: CX, big data, journalism, visualization. Opinions are my own. Favorites = to read later",1,0,0,0,1,300
151969013,Azozfaris,‏الأحلام لا تتحقق في الليل,1,0,0,0,1,300
17982443,kariemali,"Only a pauper, whom nobody owns.
وإني وأيم الحق لأعرف قدر نفسي",0,0,1,0,1,300
108630157,JuergenKanz,,0,0,3,1,4,300
3434015399,jankuiper87,Researcher @sthlmresilience & @NatCapProject & @Envision2050 | @IPBES Fellow Models & Scenarios | views my own,0,0,1,0,1,300
18625105,thiebes,#Chemistry PhD student using #ultrafast #laser #spectroscopy to explore #physics and charge carrier #dynamics in lead-halide #perovskite,1,0,0,0,1,300
1030333992619438080,NathanMerrow,"science writer, financial admin, obsessive autodidact, mediocre musician.   

Always looking for mentorship, conversation, and new things to write about.  📔✍",1,0,0,0,1,300
15238695,isterin,Human becoming. Family man. Wannabe stoic. Programmer. VP of Product @tweddlegroup. Previously co-founder at ChronoTrack and @athlinks services. Bird by bird.,0,0,1,0,1,300
1472134819,bohra_harshit,"~EPICUREAN~
||Manutd||Pizza||Books||Podcasts||",1,0,0,0,1,300
123026977,flickettone,Questo spazio potrebbe essere tuo!,1,0,0,0,1,300
59253538,scottcapener,designer. building something social @meetparallel,1,0,0,0,1,300
29238976,real_donald_duk,,1,0,0,0,1,54
41127561,shrey7,@Foreignpolicy contributor; @Saishopkins; Dosco; IIT Kanpur. // views are my own,0,0,1,0,1,300
908981788122296321,Sharma4685,"Man + Machine. 
Not, Man v/s Machine.
Medium: @ShubhamSharma_7191
LinkedIn: @ShubhamSharma7",1,0,0,0,1,300
2289799902,jljlaredo,Spinning in a pale blue dot.,0,1,1,0,2,300
801465065455108096,FlatironInst,"A group of computational centers exploring galaxy formation, genomics, and other fields. @FlatironCCA @FlatironCCB @FlatironCCQ @FlatironCCM",0,0,0,1,1,300
1083966126504038400,selimozeI,Student of technology & humanities.,0,0,1,0,1,300
1561645766,DKampjut,PhD student at IST Austria. Views are personal and facts are universal.,0,0,0,1,1,150
986991945007460352,cybersyn2068,,0,0,1,0,1,11
1029093075195518976,ManishJ54617250,,1,0,0,0,1,300
745840711900225536,ChristinaYLuo,"Reading to write and writing to think. Behaviour, culture, strategy, complex systems, and (re)design. Using Twitter as a learning library.",0,0,1,0,1,171
1075114065486327808,AdamCogan3,"Bio-anthropologist from @UCL. Interested in primate and cetacean culture, social networks and communication. Formerly a classicist (What happened?!)",2,0,0,0,2,22
303888750,Indraneeldesh,"Finance, Probability and Statistics

Experiencing",1,0,1,0,2,300
1048308834811482112,anasfrh,Chronic IBS & Insomnia,0,0,1,0,1,300
995309634,magnetcoop,We build next generation digital products. #Clojure,0,0,1,0,1,300
876041918026620930,Incept_shawn,"Ambitious 20yo Learner, Thinker & Builder. Hacked a few side projects. Fellow @NovaSemitaHQ.  https://t.co/NJ9EmwaEiM

Tackling COVID-19 with @endcovid19",1,0,0,0,1,300
286490721,theBraestro,"aperiodic;nonlinear;emerging;perturbing; turbulent;bifurcating;fractal;system. While you’re obsessing about your hot take, everyone is obsessing about theirs",0,0,1,0,1,300
85352012,matthewblumberg,,1,0,0,0,1,135
1464176352,Spiderxbass,Bass player (sometimes singer 🎤) * Scientist * We're progressive rock & resistance is futile! Climate Change 🌎 progressive rock project 🤘🏽 with @mundokumo,0,0,1,0,1,300
805778015812722693,AppKnomee,Self-Tracking with sense : iPhone application - track whatever you want to develop insights about yourself !  Mixing full privacy by design with embedded AI.,0,0,1,0,1,300
92241752,royam0820,"Entrepreneur Interested in AI, Machine Learning, Education, Social Media, Philosophy, World Affairs and much more ...😃",1,0,0,0,1,300
1046419633501360129,protphyslab,"Things we read and write, often dealing with proteins",0,0,1,0,1,109
30366941,kenmogi,Neurscientist. Writer. Broadcaster based in Tokyo. The Ikigai book published in 31 countries and 29 languages. Facebook: https://t.co/khcyll2foc Research: https://t.co/uUCiMIwbN8,0,0,1,0,1,300
9162442,iamwil,"1/ News about the edge of programming languages
2/ A Data exploration application
3/ Early stage startup quips

Pebble, YC W11, JHU/APL",0,0,1,0,1,300
51530122,MingqingCai,,0,0,1,0,1,300
2232063890,2plus2make5,"CS PhD student at Stanford, Rhodes scholar. I write about statistics at https://t.co/AIDq3ieiQ6",0,0,0,1,1,300
529494629,Komplexitet,"PhD, Lektor Malmö universitet. Vuxenutveckling, komplext tänkande, jagutveckling, ledarskap, utbildn. https://t.co/kTwTM5IPtP https://t.co/XiXKgcXVZ2",0,0,1,0,1,300
29756721,jlhrzn,Data & AI/ML at @unit8co. I like to solve relevant problems with a quantitative edge. @EPFL PhD.,0,0,0,1,1,175
2764189599,DeelyThomas,Community and Business Development @Unqork @KGConference Investing in the human supercomputer. Father of two kids.,0,0,0,1,1,300
75078009,rojedamena,DCM Group + SUPER Agency + https://t.co/SktkXVOlM5,1,0,0,0,1,300
1075986246944608256,Hiram_Murray_IV,Civil Engineer. Multi-Disciplinary thinker. My mission is to envision and enable the creation of complex systems from tangible building blocks.,0,0,1,0,1,0
737372724255825920,michael_rahil,,1,0,0,0,1,252
244119875,sorkwlsdldi,Statistical physics of ecology and evolution,0,0,1,0,1,241
635991955,cillikoenig,"Mitglied beim ruhmreichen 1 FCN !Ansonsten ein ganz normal bescheuerter Mathematiker, Segler, und Quant",0,1,0,0,1,300
25109592,CatLovesFish,Graduate student in Computational Neuroscience.,0,0,2,0,2,221
4297101072,McGinnis_Casey,interested in cognition,1,0,0,1,2,165
2305304263,viv_anand,FREE.THINKER,0,0,1,0,1,190
17591734,afekz,half a polymath,0,0,1,0,1,300
284130396,dhanshusharma,"Economist at @The_IGC || Reviewer, LSE Review of Books",1,0,0,0,1,300
184498262,s_thai,Software engineer at Opendoor.,1,0,0,0,1,159
246421002,youssef_kh,"22 y.o, bad at physics, bad at coding, hopeless uni student, hopeless but 🌹",0,0,1,0,1,300
834032481959567360,aritrayam1,Scientific Assistant-C  @ RAJA RAMANNA CENTRE FOR ADVANCED TECHNOLOGY ; INDIA.,0,0,1,0,1,300
576745426,Johnson37975725,"”Hahaha. Y'know, it's funny ... this situation. It reminds me of a joke”, I muttered helplessly in a bunch of junk.　http://t.co/I5tRQg4cUr",0,0,1,0,1,300
9729972,michaelgarfield,Philosophical #mindjazz practitioner & midwife to new myths 🎙️ #FutureFossils https://t.co/dThHa3tU6p 📝 #SciComm @sfiscience #ComplexityPodcast,0,0,1,1,2,300
68841012,gonzpen,Research Scientist,1,0,0,0,1,57
627719444,Trangucc,,0,0,1,0,1,300
14688296,bhus,Coder for a local charity.,1,0,0,0,1,300
324484413,Zulzarander,"I do it only for the appreciation of my lord,Allah S.W.T",1,0,0,0,1,300
1026527789803950080,UOSciDivDean,"Hal Sadofsky, Divisional Dean for Natural Sciences in the College of Arts and Sciences at U. of Oregon. Also an algebraic topologist in our Math Department.",1,0,0,0,1,300
1060240730805932033,EydaniMo,"Postdoc @Boston_University. Interested in granular materials, composites, and experimental mechanics.",0,0,1,0,1,107
2583169034,alexthayworth,I like to figure things out.,1,0,0,0,1,300
1055847204429152256,NanehApkarian,"Math & STEM HE researcher via SoCal. Food, people, math, social networks, travel, inst. change, ed advancements, and water polo. She/her/hers.",1,0,0,0,1,300
961046333967798272,MarielleMonts,"Fueled by social impact, informed by scholarship on decision science, behavioural economics and neuroscience. Working at @TheDecision_Lab, tweets = my own.",1,0,0,0,1,176
270678758,MarkMJames,"PhD candidate @UCDdublin Philosophy of Cognitive Science, Habits, Self-organising Interactions, and Ecobehavioural Design @Irishresearch funded",0,0,1,0,1,300
937350706964631552,msrodkova,,1,0,0,0,1,261
214212539,caleb_scharf,"Director of Astrobiology at Columbia University.  Blog at Sci Am (#sciamblogs). Author of The Zoomable Universe, The Copernicus Complex, Gravity's Engines...",0,0,1,0,1,300
859269154116972545,martin_piskoric,#21CE podcast host; #sme #leadership #socialmedia #entrepreneurship #coaching #innovation Why only those who wants to know succeed? Let's engage! 🚀,1,0,0,0,1,300
350218320,arnabbarua10,A layman and a seeker in Mathematical and Theoretical Biology. PhD student @M3sBiomath @simmgroup @Helmholtz_HZI,0,0,1,0,1,58
816019730456641536,SilmarillionJW,"Economics student (UNAM) interested in complex systems in the mathematical, economic, financial and human areas.",0,0,1,0,1,167
3069200897,Cam39Porter,📚 learning to found + fund companies in nyc @alley_corp 🖥️ nerd from @princeton ⚽️ former @mls player,0,0,1,0,1,300
993042987650236417,Treywang483,Forex Trader,1,0,0,0,1,168
473423839,whitliciousness,"Rink Rat Turned Lab Rat. Motor control, gait, biomechanics, and complex systems. No man was ever wise by chance. #Impeach",0,0,1,0,1,300
776369829100064769,felix_macht,"Economics, Decentralization, Global Cooperation, DAO Governance, Strategy&Innovation; VC@Greenfield One",1,0,0,0,1,300
393109441,davidjrbrill,Partner @ Dune Ventures; Ex: VC @ Galaxy Interactive. Investing in interactive content and technology.,1,0,0,0,1,50
853727387435110402,roxdanila,"CTO @NexusMutual. Alum @join_ef, @facebook, @BankOfAmerica, @imperialcollege.",0,1,1,0,2,300
48220960,shirabfrank,Aiming to keep paradise on the map and justice before our eyes.,1,0,0,0,1,300
89514111,luna1999,"·
product~service design
🌰 · 🌱 · 🌳
–
Crypto is the infrastructure of the next markets.
All of them.
·",0,0,1,0,1,300
948311428343119872,susiesmith9200,,1,0,0,0,1,70
2510050405,AdvaithDoosa,"incoming swe intern @coinbase // https://t.co/VdaTyFP9Wm
always curious, mostly crypto.",1,0,0,0,1,300
760853748,panekkkk,Co-founder @coinmetrics. Crypto data. Former clinical epidemiologist and health economist. Forbes Bottom 30 Over 30. Searching for signal.,0,0,1,0,1,300
53893181,bmalaus,,0,0,1,0,1,300
391064914,jpazour,"Associate Professor of Industrial and Systems Engineering, Rensselaer Polytechnic Institute",0,0,0,1,1,287
249985450,LeRainDance,"Data Scientist, Writer, and Entrepreneur. Book of Aphorisms incoming. 🤠",0,0,1,0,1,91
69254928,CurtisRumanyika,"Wannabe polymath. 
Wit. 
Erudition.
Empiricism.
Flaneur.


Mantra: Less is more.",0,0,1,0,1,300
3235745774,ncguilbeault,"Graduate student in Thiele Lab @ University of Toronto. Focus on zebrafish neurobiology. Also science, technology, philosophy, politics, and art.",0,0,0,1,1,216
141648003,anughoshh,Outreach Coordinator @ictstifr,0,0,1,0,1,217
874522035187101696,S_J_Foelsing,Curious.,0,0,1,0,1,300
962001562808799233,SeanMackieSM,Interested in the latest science and technology shaping the world of tomorrow… and the odd dabble into politics. https://t.co/ShDTqRhQxP,1,0,0,0,1,300
901368949052518401,pasarilacom,senior programmer at Ubisoft. Doing my PHD in deep neural networks,0,0,0,1,1,149
789121893290958848,RigResearch,We focus on understanding how computers may imitate processes occurring successfully in nature to automatically solve complex computational problems.,0,0,1,0,1,293
504697825,n1alloc,,1,0,0,0,1,300
1027490519885250565,kronholmlab,Kronholm lab: we study to role of epigenetics in evolution and phenotypic plasticity. Currently at the University of Jyväskylä. Tweets by Ilkka Kronholm.,1,0,0,0,1,206
749338271725998080,oecodynamics,Quantitative ecologist • food webs/demography • postdoc @Princeton EEB • fieldwork @RMBLGothic | @UMBS |  #UCNRS • he/him • stoops for charismatic microflora,0,1,0,0,1,300
1031998788217389056,kenth56,"professional weeb, anime lover, and Yognaut.",0,0,1,0,1,198
872425991523758081,AppSysBio,Research Group Applied Systems Biology headed by Prof. Dr. Marc Thilo Figge at the Leibniz Institute for Natural Product Research and Infection Biology in Jena,0,0,1,0,1,298
3452877914,jeanmarcalkazzi,Helping our machines learn at BMW Innovation Lab,0,0,1,0,1,300
1030841138083553280,SLHatcherr,"Machine Learning, Data Science, Math, Logic, Women in STEM Advocacy, Cats, & Running.

She/Her.",1,0,0,0,1,130
993564068463161345,HemachanderTBio,,0,0,1,0,1,40
68100417,ajiiaiti,Единственный смываемый тулку,0,0,1,0,1,300
1025035484353974272,xbt256,"Bitcoin | Open Hardware | EE, CS | FPGA | OpenPOWER | Free software | C/C++, Haskell, Scala, Python | Math",1,0,0,0,1,133
978303627117948928,bjcaie,"Decision-making, addiction, free choice, brains

Neuroscience PhD student with @GunnarBlohm and @aarlennek",0,0,2,0,2,300
2534161843,NilayShri,"Software Engineer at @Adobe | | Research Intern @midasIIITD | |
I love Mathematics, Physics and Computers",0,0,0,1,1,300
26771961,pnazemi,"Science Journalist
Journalism MA Candidate - Concordia University",1,0,0,0,1,300
29940678,suhelmomin,,1,0,0,0,1,170
206740363,breckinloggins,"Engineering Manager, TDG @  - my opinions are my own",0,0,0,1,1,300
1439707538,m8a8r8k,"Misera eorum conditio, quibus non ratio sed fortuna opitulabatur.",1,0,0,0,1,300
1014022182194704384,robynaraujo,Mathematician.  Thinker.  Dreamer.  Avid Reader.,0,1,0,0,1,26
17576961,Just1nn,,1,0,0,0,1,154
839934611283038208,HeatherMAitken,PhD student in Chemistry 👩‍🔬👩‍💻@scienceANU @connalgroup | #compchem of polymers and complex systems | #T1D | All views my own,0,0,1,0,1,300
180272695,AlAlmani,"Mathematician, married to the most beautiful woman on earth, having a wonderful daughter and two wonderful sons, al-hamduliLLAH",1,0,0,0,1,300
14943648,andreisavu,Products & Technology at https://t.co/JjoZM5JB34. Seeking exponential improvements.,0,0,1,0,1,300
973549915174572033,ijaganjac09,"former Senior Software Development Engineer at BPU Holdings, now: Machine Learning Expert at Kaggle",0,0,1,0,1,197
21011520,kcuck,"Retweets are no endorsements, sometimes i want to keep a record of what the crazies are saying",0,0,1,0,1,300
2185,buster,"Author of Why Are We Yelling? The Art of Productive Disagreement. Co-runs @750words with @kellianne. Past: @SlackHQ, @Twitter, @Amazon, @Patreon.",0,0,1,0,1,300
791339323861983233,ThomasGurry,computational biology researcher @ UniGe | human gut #microbiome | #metabolism | #synbiotics | #machinelearning | blockchain enthusiast,0,0,0,1,1,300
2740276434,RagoVago,"Biology researcher. 
Mostly harmless. 
He/his",0,0,0,1,1,300
387956686,VictorKristof,"Ph.D. Student in Machine Learning at @EPFL
Former President of @CHYouth4Climate",1,0,0,0,1,300
3968760681,harish_josev,"I am still learning. Check out my blog on Lean, Cybernetics, Quality & Data Science - https://t.co/Uq1rt6ceDW",0,0,1,0,1,300
42311051,dornhaus,Collective behavior in social insects; adaptive organization in complex systems; Prof in Ecology & Evol Bio at University of Arizona; science for public / kids,0,0,1,0,1,300
851250980897169408,mr_corcorana,free energy minimiser | pretend philosopher | caffeine abuser | rabbit herder | PhD candidate | RTs = lazy archiving | thoughts almost certainly not his own,0,1,0,0,1,300
3221978391,Iaeliyen,"Interesting in shell programming, Artificial Intelligence, and flavours of Coffee.",0,0,1,0,1,300
184960205,haroldmoma,"Un nuevo tweet, todos los días.",0,0,1,0,1,300
135472362,AthulSudheesh,"Cognitive Scientist (Causal Theories & Computational Models of Learning) @coins_lab, @BBSutdallas. #EducationalPsychology #ComputationalPsychometrics #EdTech.",1,1,0,0,2,300
768218268897206272,TheScottLove,Incredibly curious about everything.,0,0,1,0,1,300
107523710,5foldSymmetry,Decoder of structure-producing mechanisms within the price action of freely traded financial instruments.,0,0,1,0,1,299
12090952,igorsavin,,0,0,1,0,1,171
794924004977025025,emoshouris,Engineer and entertainment design enthusiast.,0,0,0,1,1,73
273014559,verma_apurv5,"Applied Scientist working on Amazon Alexa. MS from Georgia Tech. I enjoy photography, cooking and reading books in my free time",1,0,0,0,1,300
871286048894013441,ShGupta_,"PhD Student at Indian Institute of Science, Bangalore, India",0,0,0,1,1,101
25321083,refollow,"Refollow helps growth marketers, influencers, and intelligent people build networks of likeminded friends and followers.",1,0,0,0,1,300
753820601106563072,milesphd,data engineer and environmental scientist/consultant with expertise in nonlinear dynamics  🦋 💧📊 #Rstats,0,0,2,0,2,300
721043451782000640,jgtzanudo,"Postdoctoral researcher @ Broad Institute, Dana-Farber with @nikhilwagle. Research: Cancer Systems Bio, Networks, Mathematical Models.
Mexican. Views are my own",0,0,1,0,1,300
992292893980217346,comandingo,"Haskell enthusiast, viable, armchair-constructivist, fünfte Position, he/him",0,0,1,0,1,300
68552069,NomdeB,Insatiably curious. Lover of language. A trifle geeky. Horrified by what GOP and Trump enablers have done to America and the world.,1,0,0,0,1,300
964625068264390656,_Basel_Barakat,"PhD in communication networks interested in wireless, #IoT and ML.  Applying first principle thinking on complex systems.",0,0,1,0,1,5
375801620,ChristosArgyrop,"Division Chief, Nephrology @UNMHSC
Tweets: med, pharma, stats, econ, policy, HPC https://t.co/WEY8ByNShc 
Rapidly changing views that reflect my own opinions",0,0,1,0,1,300
153891974,erikturk,"Bell NMO team -mostly network stuff, containers, linux. Wannabe in k8s and ONAP. Georgia Tech MSCS 2018. Go Jackets.",0,0,1,0,1,300
116818612,SamuelBaltz,Forces computers to think about elections at UMich & works to make politics-related Wikipedia articles better and more fair. Normal person without any problems.,0,0,1,0,1,300
42208568,Drabiv,"Having fun in search of petrichor. 
#SmallCoolIdeas, #BigHairyIdeas, #Python, #Django, #DataAnalysis, #TheUnitedHumans, #DigitalSovereignty, #SSI",1,0,0,0,1,300
71011099,beausievers,"Postdoctoral researcher in Psychology @Harvard with Josh Greene, affiliate @BKCHarvard and composer @anindexofmusic",0,0,1,0,1,300
2653271440,chris_upsilon,"Interests in engineering a safer world, science, policy, data, uncertainty, decision making and infrastructure 
Work @LR_Foundation (personal account) ⛴ ✈️🏗",0,0,0,1,1,300
2532017986,acoutoal,"Lecturer Bioinformatics @UniOfSurrey Formerly, research fellow at @imperialcollege",1,0,0,0,1,106
1716930044,andriizakharov,"Stats, psych, data, research. Much curiosity.",0,0,1,0,1,180
1018066946,LeadNotLose,Shared imagination,1,0,1,0,2,300
42073654,catalin357,"Romanian 🇷🇴.  Munger & Buffett enthusiast. Working on getting 1% better every day (body, mind, wealth) . Sharing some thoughts on the way.",1,0,0,0,1,300
1142605063,ZacYapJQ,"Software engineer keen to create value, but learning how to truly love others first. @NUSingapore Law & Mathematics",1,0,0,0,1,300
3929431048,tonyidell,ecologist @ NGRREC. views my own.,0,0,1,0,1,300
3670032441,_ese_lopez,"Genetics, code and open science",0,1,0,0,1,300
200835834,carljonas,Startup founder. Product Manager. Building a global scale app. Stay tuned friends! :),1,0,0,0,1,300
316543472,miqno,"Physicist, doing research on gravitational wave astronomy || Faig recerca en astronomia d’ones gravitacionals || @iSpaceSci & @IEEC_SPACE",0,0,1,0,1,300
275461512,jothe3inv,,0,0,0,1,1,300
921952045661392897,Charlietxan,"#CloversForAssange


It’s the tragedy of our times that lunatics must lead the blind.

- King Lear, W. Shakespeare",1,0,0,0,1,300
958473465383804928,algebrasnotwar,PHD Candidate in Mathematics at UofSC || Algebraic Geometer || Blogger || Teaching Enthusiast (He/Him),0,0,1,0,1,300
1576577940,_jakobhansen,"I study applied topology, or at least try to.",0,0,0,1,1,279
3283359319,darraghmw,"Data analytics researcher at Dublin City University. Formerly at Uni Melbourne, ESRI, Max Planck - AEI. Deep respect for Gen Iroh.",0,0,0,1,1,300
27238310,axiomsofchoice,CompSci and Maths nerd. Isomorphicist. Hacking on devices for the Internet of Things. Lead dev @protocab.,0,0,1,0,1,300
2158009029,patmcgillivray,"IM Intern @HopkinsMedicine. @YaleMed, @McGillU alum. Interested in technology, medicine, and their intersection. Opinions my own.",0,0,0,1,1,300
174316961,marwan_aljubeh,,1,0,0,0,1,300
3017932241,HochTwit,CNRS & Santa Fe Institute - Interested in why things help or harm - Epidemiological modelling - Founding Editor of Ecology Letters - #NOW,0,0,1,0,1,300
728821668039172096,YakBurritos,,1,0,0,0,1,184
2262771391,GauravSHegde,-,1,0,0,0,1,300
3588519143,TTWhitfieldLab,"Welcome to the Whitfield Lab Twitter page.  We study the development and function of the vertebrate inner ear, using the zebrafish as a model system.",0,0,1,0,1,300
227301294,zain_yousuf,"I nap, Professionally.",1,0,0,0,1,300
1190041,herdrick,'Data engineering' programmer. I make software.,1,0,0,0,1,300
634400123,m0hitsharma,PhD student at CMU. Robotics and Machine Learning.,0,0,1,0,1,300
805937038109396992,rishu_mohanka,"UPenn '23 VIPER: Physics, Math, and EE+CS
I like to build things, learn, and experiment.",1,0,0,0,1,300
947202939554357250,satwani_,,0,0,1,0,1,102
533163915,DerekWhitley1,"AI, robots, complex systems, cognitive science, Indiana University, Rose-Hulman Institute of Technology, NASA",0,0,1,0,1,141
794308721463562240,0x0ddc0ffee,"I like cats, books, plants, and languages with S-expressions. I don't like the 💩🤡. OpenBSD fan. ⚧ she/her",1,0,0,0,1,300
408135698,IlyaOrson,Wandering physicist! 🏕️🚀☀️,0,0,1,0,1,230
85108450,rakeshksaraf,,1,0,0,0,1,300
15520706,itsManav,"Director, Software Development",1,0,0,0,1,300
943611281717809152,managetheory,"Official acct for NEW https://t.co/40Yr1iQJNC. Using business principles, organizational insight, and management theory to improve everyday life. @aaronwclopton",0,0,0,1,1,300
340387261,GavinSBaker,"Husband, Becky Painter. CIO, Atreides Management. Former PM, Fidelity OTC fund. No investment advice, views all my own.      https://t.co/1unPpRrZ2L",1,0,0,0,1,300
56547811,arledia,Webdesign and photography,1,0,0,0,1,167
2815263980,rivrevaK,#SocialMedia @UNICEF. Hot drink fiend & one-time short #film-maker. Feel free to follow me but I have no idea where I'm going🤷🏽‍♀️. Views my own. #ENDviolence,1,0,0,0,1,300
964941,egd,"I find things fascinating. Born in the water, thought I was a fish. ex-@twitter. He/Him.",0,0,1,0,1,300
876802442268213252,Compressa1,,1,0,0,0,1,198
941096186466918400,jessemkreger,"Mathematics PhD student at the University of California, Irvine. Interested in virus dynamics and cancer evolution.",0,0,1,0,1,121
199748066,IngridvdL,"Theoretical ecologist. I'm interested in developing simple models that can pinpoint universalities in complex systems, ranging from corals to mood disorders.",0,0,2,0,2,26
146359463,markwfoden,"Banging on about complexity, public sector change and digital stuff. Working locally to organise support for the vulnerable https://t.co/JK6XrA3pbr",1,0,2,0,3,300
15087039,somdatta,"Shurero shahoshe aponi chokito binaro tar (loosely translated as ""the lute string galvanized by the resolute boldness of its own notes"")-Tagore",0,0,2,0,2,300
925070501386604545,mathemovie,Transforming your favorite movie scenes into maths crazy problems.  Subscribe to my YouTube channel !,1,0,0,0,1,241
1924526166,christophkirst,,0,2,0,0,2,16
909424116,guruprasad_r94,"Graduate Student @ Caltech. Regular Half marathon'er. Mathematical modeling of biological systems, always curious to know more about the brain, ML enthusiast.",0,0,1,0,1,99
18041296,MarnieLandon,"CEO C 2 Infinity - Curious, Creative, Clever; Emerging Technology R&D; Math & Comp Sci; 2 daughters -MD/PhD Biomedical Engineering + Engineering Applied Math",1,0,0,1,2,300
791612485992222721,sandeep6291998,"Here I stand, atoms with consciousness, matter with curiosity.
A universe of atoms, an atom in the universe",1,0,0,0,1,300
878554527879901184,frdhlr,Software engineer. Interested in #AI & #creativecoding. Also play golf.,0,0,1,0,1,300
246259846,erin_snider,"Assistant Professor, Texas A&M; IR, Political Econ of Aid & Development in the Middle East, especially Egypt | Fellow @NewAmerica  RT≠ endorsement",1,0,0,0,1,300
829701,dancres,Software Dynamicist - Tech is the servant of humanity. Dabbler in martial arts. Petrolhead and audiophile.,0,0,1,0,1,300
426201743,dgreen8789,"UT 19
OSU '25",1,0,0,0,1,97
5736252,glenux,"CoFounder of @dt_privacy and @boldcode_io . Loving distributed systems, poetry &amp; chaos. Supporter of #education #basicIncome &amp; #resilientSociety",1,0,0,0,1,300
129723561,med_merchise,"🇨🇺🏳️‍🌈 Computer programmer, interested in many languages, mostly Python, Lisp, Haskell, ... Free Software enthusiast: GNU/Linux and Emacs, ...",0,0,1,0,1,300
914280367951171584,mgschiavon,Passionate about dynamical gene regulatory systems & their emergent properties | Systems biology | Postdoc @ El-Samad lab (UCSF) [she/her/hers],1,1,3,0,5,266
3059729152,IC_mitochondria,Biomathematicians at Imperial College London with an interest in mitochondria and bioenergetics in general.,0,1,0,0,1,124
2330887435,QuantumRogue,"Student/Wannabe Physicist. 
FCTUC University of Coimbra.   
Time is my Nemesis.",0,0,1,0,1,300
809066923669520384,puzzled_nl,"Contagiously curious. Easily combustible in enthusiasm. Zzp-er, Maker, Artist, Math PhD, Researcher, trainer. Ankaŭ en E-o.",1,0,0,0,1,300
748515169446166529,soumen4189,"PhD student, Computation Systems Biologist, Mathematical Modeler and Biophysicist.",0,0,1,0,1,180
806596039687798784,SvetlanaAmirov2,PhD in applied mathematics,0,0,1,0,1,300
44914061,szymon_lipinski,🖖 Looking For An Interesting Job ⛭ Learning For OSCP ⛭ Databases ⛭ A Professional Chaos Manager ⛭ Good With Computers ⛭ I like Types ⛭,0,0,1,0,1,300
53026251,DroidzRule,Tandem Felix!,0,0,1,0,1,294
235883434,mcsteann,"Am a Digital Consultant & Entrepreneur, Passionate about Social Innovation. Busy influencing a paradigm shift.",0,0,1,0,1,300
895284247908548608,darthvogler,,0,0,1,0,1,300
901176732899790848,ac11235,Applied mathematics student @cimatoficial. Interest: mathematical biology/oncology (+coffee). Aspiring billingual in biology and math (English too difficult).,0,1,0,0,1,300
1171334983,MartynDeBull,"Interested in data science, science, infosec and how technology can shape the world. And in seeing that world as I go.",2,0,0,0,2,246
17152983,Stiivi,"Mentor, software engineer and data warehouse architect by day; simulations, DSLs and complex systems by night. Author of @DataBrewery Cubes #Python OLAP. 🏳️‍🌈",0,0,2,0,2,300
18432282,_julianlevy,"Random person on twitter.

Listen to doctors. Listen to scientists. Avoid groups. Stay home if you can. Check in on your loved ones. Take care of each other.",0,0,1,0,1,300
836401920759721984,JoeAusterweil,"Prof scientist/Aspiring e-athlete. Disclaimer: This is my opinion for at least 5 secs as a private citizen and not any organization I am affiliated with.
He/His",0,0,1,0,1,300
123261527,trivedipriyanka,lifelong learner,1,0,0,0,1,183
891138970146545664,Brisketdog,"Engineer, scientist, twitter lurker",0,0,1,0,1,300
27427813,vik007,"Dad of 2, Husband, Prof. #ISAE-SUPAERO #DD #Aerodynamics #CFD #Biomimetism #Design #Thinking #Creativity #Optimization. #Energy & #Mobility. Sailor.",0,0,1,0,1,300
890863214690480129,manuel__pita,AI and Complex Networks. I study collective information processing in bio and social systems. Retweets ≠ endorsement. I’m also known as @sejkko 👨🏻‍💻☄️👨🏻‍🎨,0,0,3,0,3,300
1305522032,JamieCChang,"UCSF MS2. Fresno State #Bulldog. Think, Create, and Innovate for a better world.",0,0,1,0,1,300
206431052,Alyssaeinman,"Tech-Startups-Soccer-Environment-Science-Nerd ....#ILLINI grad, MSci predictive analytics @NorthwesternU, data science & machine learning",1,0,0,0,1,300
67469911,AlbertoMizrahi,,0,1,0,0,1,236
885136689747853316,SATBQ,Discover research that matters.,1,0,0,0,1,300
3016611452,gankeyalb,,0,0,1,0,1,137
4531695494,terracotta_girl,ack,1,0,0,0,1,300
3325202231,t_spiller,"Data science/stats, social science, public health, #rstats. Looking for answers...",0,0,1,0,1,190
17519956,vabarger,"Professor of marketing. Lover of incongruity. Greyhound dad. Ph.D., M.B.A., B.A. @UWMadison. Tweets reflect my own views and interests.",2,0,0,0,2,300
82692107,pickupsimon,"Co-Founder & CEO at Hydra Energy. Draper University Alumni. Also @ GridGear Solutions, Youth Hydrogen. #startups, #hydrogen, #cleantech",0,0,1,0,1,278
798560230888112129,NativeMath,Mathematician and Educator,0,0,1,0,1,238
783714864699215872,DrKivinen,"Economist, academic, occasional musician.",0,0,0,1,1,127
1536654752,theduggal07,,2,0,0,0,2,300
3059191964,Narges_Jeddi,,1,0,0,0,1,44
237991467,resonancebush,"Agitator for resilience, cyclist, sustainabilist, educator @ USF's Honor's College, facilitator, loving disruptor.",0,0,1,0,1,183
1367879647,blarglet,Fresh axioms daily.,0,0,1,0,1,113
38474934,curiouswavefn,"History of science and technology, especially math, physics etc. Drug discovery and chemistry. Columnist for 3 Quarks Daily. Books. Music. All views my own.",0,0,1,0,1,300
312609959,absotillo,Venezuelan Floridian in Seattle.,1,0,0,0,1,300
70156539,sucoder,"Techie at  ██████████  Scale... Java...Tech....! ▓▓▓▓▓▓▓▓  🍺....code... e-commerce🍕! ███████ 
Comes with High sensitivity bullshit sensor !",1,0,0,0,1,300
46084824,sathugol,"Indian, Sports",0,0,1,0,1,300
2887426564,bpgrehan,Neuroscience researcher with interest in #dementia | Taught @CTYI | Co-organiser of Dublin's Café Scientifique @alchemist_cafe | @WITSIreland Exec Committee,1,0,0,0,1,300
871588700945121280,levetrage,mixed strategies,0,0,1,0,1,300
870427994350907394,ProfFilizGarip,"Professor of Sociology @Cornell, Author of ""On the Move"" @PrincetonUPress, scholar of immigration, social networks and inequality",1,0,0,0,1,7
242484363,KrishnRamesh,"Eclectically curious systems thinker and product builder. 🇨🇦, PM @Microsoft 📱, avid reader 📚, alum @WaterlooEng 🤖",0,0,1,0,1,300
4020498861,cogconfluence,"Computational cognitive neuroscientist at @MIT. 
Affecting presence in pursuit of delicious experiences. Building structures that bring us home.",0,0,1,0,1,300
867431054059155456,a_torcini,#ComplexSystems #ComputationalNeuroscience #Neuroscience #NonLinearDynamics #UCP @UniversiteCergy @univ_parisseine,0,0,1,0,1,275
14464195,antlerboy,service and systems evolutionary | https://t.co/GySBqaeWli | https://t.co/GuNOQoPVvF | https://t.co/Apgk9vkYI7 | https://t.co/gjjl0P5cI8 | connect: https://t.co/evMDCJFf83 | #girlyswot,0,0,1,0,1,300
1851761070,NancyStano,"higher ed instructor & coach, teaching & facilitation explorer, annoyed by use of the word ""training"" in lieu of 'learning,' & lover of 24-hr long car rides",1,0,0,0,1,268
859689560372072449,MED_EEBuildings,A network of projects within the Interreg MED framework focusing on energy efficiency in public buildings in Mediterranean Europe,1,0,0,0,1,260
7050012,juanbarahona,Management of Innovation and Technology in the Networked Society,0,0,0,1,1,300
821962,eranshir,Founder of Nexar Inc. (@getnexar),0,0,1,0,1,300
2241668706,amccalljr,Applied Math and Geography - GIS Engineer at Fatmap - likes long walks on the beach and satellite imagery of that beach,0,0,0,2,2,300
731165617353457664,derekrayki,Level 4. Connecting the dots in a complex space and cultivating the Aha moments . Dunning & Kruger can kiss my @#*#! Free the Dweeb.,0,0,1,0,1,300
20325908,RandyLaMonda,"I enjoy reading, writing and running.",0,0,1,0,1,300
1875628603,biswaprakash14,"UnderGrad Physics student, Hahahaha",0,0,1,0,1,300
36975685,vidunarayanan,"Interested in building tools using AI to provide better access to food, health and education, for communities across the globe",1,0,0,0,1,300
2823091427,fjguerrerob,"PhD in Forest Engineering & Water Resources Science. Interests: Resilience, Sustainability, & Science Storytelling.",1,0,0,0,1,111
1879846117,turiyaaa,i think about dots a lot,0,0,1,0,1,300
1379365554,marcinstalij,Digital Transformation & eCommerce Director at Saatchi & Saatchi IS. Mathematician. Opinions expressed are my own.,0,0,1,0,1,212
822509265864814594,suqbar,,0,1,0,0,1,300
898794788,m_battaglini,Papa' di Matteo. Edward H. Meyer Professor of Economics at Cornell University.,2,0,0,0,2,300
247633574,Nishi_Akihiro,Assistant Professor at UCLA Epidemiology. カリフォルニア大学の研究者。医師（社会医学）。コロナ前は、人と人のつながりの中で社会行動が広がっていくのを複雑系の視点から研究していました。https://t.co/IgVG7YbTf4,3,0,0,0,3,25
2288693468,AntonBernatskiy,,0,0,1,0,1,88
1024803468,lffrrnt,,0,0,1,0,1,300
108536169,conorleblanc531,"@BCHigh, @Georgetown, @BUQuestrom, @sparkboston, & @CityOfBoston alum",1,0,0,0,1,300
838752120551649280,ShaunAultMath,Associate Professor and Deparment Head (interim) of Mathematics at Valdosta State University.  Go Blazers!!!,1,0,0,0,1,245
824417632619261952,mathmodeling,"High school math teacher. focus: mathematical modeling & providing PD through hands-on problems.
she/her/hers",0,0,2,0,2,300
775534,lisah2u,Tinkerer. Trail runner. Human Computer Interaction researcher.,1,0,0,0,1,300
49551182,Adahadotcom,co-founder of @webelongery,1,0,0,0,1,300
3308594285,eoghanturley,"software, investing, economics. previously @polarisvc growth",1,0,0,0,1,300
790419595,KelpieBower,,0,0,1,0,1,300
14419685,udivaks,"Father of 3 rascals, trying to make a small dent while eating well. Borrowed my opinions from various places around the internet.",1,0,0,0,1,300
284226629,saurabhsharan,"""Any book not worth rereading isn't worth reading.""",0,0,1,0,1,300
305376357,NateBraniff,"PhD candidate in applied mathematics at uwaterloo, working on math/comp methods for synthetic biology and bioengineering",0,0,1,0,1,300
452439911,FullcntctFghter,"PhD complex systems, Professor-scientific researcher, complex coevolutionary systems engineering, a martial artists since 1976...",0,0,1,0,1,300
25079712,micdillon,SDE @ Amazon Go / Math Nerd,0,0,1,0,1,250
42274193,dizzymiracle,,0,0,1,0,1,148
300172606,IgorZub,"Makes robots and programs for them. Assistant professor at Lodz University of Technology. 

Interested in Human-Robot interfaces, AI and Soft Robotics",0,0,1,0,1,300
467719135,misbahspeaks,Building @marsplayapp 💻 | Previously Product Growth @pulseqa @movewithpursuit @Toymailco | Build @thecibola,1,0,0,0,1,300
263631417,eranmeir,"Talk, I am listening",1,0,0,0,1,300
127856593,surt91,I add up random numbers.,0,0,0,1,1,108
774620870635581445,TheConceptF,Promoting research on Frontiers Sciences beyond the (perceived) boundaries of human knowlegde,2,0,0,0,2,300
1039784328,larinum,CMO @Sievo | past: @Google / @Twitter. Tweet mostly about marketing and technology. Help me understand procurement. 😂,1,0,0,0,1,300
2590840506,anaganath,"Student at @StanfordGSB. Previously: @Google, @PalantirTech @twitter, @KPCBFellows, @columbia.",1,0,0,0,1,300
208800119,hectororomero,Neoliberal reduccionista: creo en el avance imparable de México a pesar de su terrible clase política.,0,0,1,0,1,300
95397613,nachoenblanco,Psychologist wandering through Neuroscience and Complex Networks Science - Curiosity-propelled head - 👽,0,1,0,2,3,131
16588740,meparashar,all tweets are notes to self or links to read later.,1,0,0,0,1,226
3006856726,alzimamia,,0,0,1,0,1,144
224965117,BertaGDeVega,Cómo me enfrento a las circunstancias. Hija de Torremolinos. Asesora de Cultura del Ayuntamiento de Málaga. Abeja reina. Bertagdv@gmail.com.,1,0,0,0,1,300
48982401,yatharthmanuja,,0,0,1,0,1,300
114640283,yanisurbis,clojure/cljs @functionalworks,0,0,1,0,1,300
805544297156280320,vanbettauer,Inquiring into the continuity between mind and life. Enactivist. Single cell functional genomics and machine learning.,0,0,2,1,3,300
103288931,sockcymbal,"Nonlinear dynamics, volatility, markets, music.",0,0,1,0,1,300
2802521697,Isty_Rsquared,"Quantitative ecologist, complex systems enthusiast and data detective. Passionate about lichens, oceans, hoofs & Russian literature. Rabies! #ClimateJustice",0,0,1,0,1,212
784125894436777984,charodelgenio,"Graphs, complexity, dynamical systems, simulations. But mostly computational plant biology.
Hardline frequentist.
Your statutory rights are not affected.
He/him",0,0,1,0,1,300
2343961974,khelwegen,"Deep Learning Scientist @PlumeraiHQ, working on Binarized Neural Networks (BNNs).",0,0,1,0,1,113
107723949,LarsSudmann,Author and speaker on Leadership and Innovation. Advisor and Council Director on Strategy & Transformation. University lecturer.,0,0,1,0,1,300
295371536,JamesDavies010,,1,0,0,0,1,300
17396153,talesfc,,1,0,0,0,1,300
800539783260880896,marvel_parsons,,0,0,1,0,1,64
797278068092059648,caioauv,"caioau is passionate for: 
 ['math','FreeSoftware','cryptography']
@casahacker member",1,0,0,0,1,300
3241237895,JmBirk,,1,0,0,0,1,230
775788855794528256,KumorKh,,0,0,1,0,1,93
936377724,bondi_izzy,"Those are my principles, and if you don't like them...well, I have others - Groucho Marx 〰️",0,0,1,0,1,300
29724419,yarashaban,"Learning scientist. Interested in conceptual change, complex systems, culture, and technology.",0,0,1,0,1,300
277789736,jagephart,Asst Prof at @AmericanU studying the globalization of seafood in relation to the environment and food security outcomes| Podcast enthusiast,1,0,0,0,1,300
14835756,AuerbachKeller,BITWISE: A LIFE IN CODE now available from @PantheonBooks. https://t.co/dSAN7dhfxs,0,0,1,0,1,300
3248029984,COHMathOnc,Twitter account of the Division of Mathematical Oncology at the City of Hope. Math Onc: the science of oncology using math as the means of discovery.,0,0,1,0,1,171
767980590536593408,_tejasgm,"Faculty @ Indian Institute of Science INDIA. I work on severe plastic deformation in granular materials and porous solids. Runner, reader and cinemafan",0,0,1,0,1,300
242088914,perfectionatic,A seeker of perfection and true wisdom. A pursuer of optimization and a student of complexity.,0,0,2,0,2,300
263345211,_PelumiT,I build thoughtful software with stacks that let the team sleep well at night..,0,0,1,0,1,191
835567518,robintux,,1,0,0,0,1,295
323651034,reverselogic_in,"Making Ends Meet // Java Status:: stick to 8, plan for 11. 😎|| I ask direct and rooted questions, don’t get perturbed 😤 AI is for retards! #MindIt",0,0,1,0,1,300
429045885,Natasha_Malpani,Making stories for a new India. Former builder @dicemediaindia + @bigsocietycap. Stanford MBA. Poet. Author + podcast host of Boundless 🇬🇧 🇺🇸 🇮🇳,1,0,0,0,1,300
724519132532736000,computermike027,,0,0,0,1,1,300
3224667143,cllsyrsln,"father, husband, researcher, life-long learner",0,0,1,0,1,300
615146990,Dimon_Lers,,0,0,1,0,1,300
4187124171,EeMustafe,STUDENT||LFC,0,1,0,0,1,260
730247444244496384,cfrostey,"PhD candidate, education in human services - Social Work academic - Director, Renegade Roasters",1,0,0,0,1,300
4711624461,b_njam_n,,1,0,0,0,1,300
255689233,dr_senfoel,Austherapierter StadtAufsLand,0,0,1,0,1,300
740026896163823621,HigherMathNotes,"Professional math tutor. Uploading my math education to YouTube, one video at a time.",0,0,1,0,1,300
4149424180,_bunnech,PhD Student @ETH in Computer Science. Previously @MIT_CSAIL and @IBMResearch.,0,2,0,0,2,300
3317699819,pmplewa,Software Engineer | Astronomer,1,0,0,0,1,300
62939846,glenhocky,"@nyuchemistry | alumnus of @UChiChemistry and @ChemColumbia
Developing and using molecular simulation methods, also tweeting about it",0,0,1,0,1,220
28325253,jancey5,"UWC Maastricht Teacher & Coach; passion for authentic, transformative learning experiences for students and teachers #designthinking #problemseekers",0,0,1,0,1,300
775055360,DavidMangum3,Boulder/Denver.,0,0,1,0,1,300
14470738,ali01,"Partner at @a16z. Investing in crypto. Previously a software engineer and researcher at @GoogleBrain, Google X, and @Stanford Computer Science.",1,0,0,0,1,300
3093168692,Messed_Purpose,Potentially harmful human detected,0,0,1,0,1,300
470319069,GetFluxed,"Get FLUXed to enter the flow of opportunities, options, disruptions, and innovations",0,0,1,0,1,230
1330345849,MathMunch,"Math Munch is a weekly digest of the mathematical internet, written with middle schoolers in mind. By @j_lanier, @lostinrecursion and @AnnaWeltman. Bon appetit!",0,0,1,0,1,300
2726026130,Anders_MyBr,PhD candidate in computational chemistry,0,0,1,0,1,87
97326879,aturnali,,0,1,0,0,1,192
392539097,tinypang,"Freewheeling wayfarer. Strict diet of dumplings, whiskey and data. Formerly data @canva, all views my own.",1,0,0,0,1,300
144781294,RadicalKKLive,"i'm the No1 world ranked shadow puppetier.  Universe, your welcome.",1,0,0,0,1,300
716332750693793792,mathbeveridge,does math for fun,1,0,0,0,1,53
63654525,CornellVC,"Canaan Partners co-founder, Cornellian & hockey fan",0,0,1,0,1,222
1885138916,NotAsIPlanned,A guy doing his best to help students discover mathematics even though they tell me math is an acronym for mental abuse to humans. Clever.,0,0,1,0,1,147
2869114788,oudigischolar,I head our DigitaL Scholarship Unit at theUniversity of Oklahoma Libraries. I love learning about others' research and helping them explore new digital tools.,1,0,0,0,1,300
141297726,madhurjajoo,"Computer engineer, currently pursuing Masters in Economics at UW-Madison",1,0,0,0,1,285
37939776,dcunit3d,⎲∇²æ∆alianGold 〷 ⎳∃a∂ Metaphysicist‽ ⫸⸨@Plato's Closet⸩⫷ ༺ℙeripatetic∯ophist༻ 【M⊗nadic∋Logic∈Artificer】 【ᚦᛟᚦ⊕ᚺᛝ⊕ᛞᛋᗤᗧ〠ↂ₵】⸩⸨ 【夢】〈㌿⁍⁌⁂日⁗|㌨て㋵〉【笑Liminal々SaikouPomp笑】,1,0,0,0,1,300
222768324,lettisdotnet,"physicist, programmer, happy dad",0,0,1,0,1,300
412498674,KDekemele,,0,0,1,0,1,24
1331233394,MartinezLab,"Neuroscience lab studying how brains “see” the world, why different brains do it so differently and trying to show people why all this really matters.",0,0,0,1,1,300
3467184629,valizadeh7,,0,0,1,0,1,49
2432455716,dheineck5,Director of Technology & STEM at La Salle Prep,0,0,1,0,1,83
304669884,jfrossier,"Born in '71, PhD Physics '99 (@UAM_Madrid),  Professor at  @FaplicadaUA,  working for @INLnano (Braga).  Married, 2 children.  Proud member of @GEFES_RSEF",0,0,1,0,1,300
2480532030,gomezdanp,"Functional MRI, exoteric text editors, arthouse cinema. Ph.D candidate @ Donders Institute",0,0,1,0,1,109
2477561,dhaya,,0,0,1,0,1,30
14611986,scopatz,,0,0,1,0,1,300
1052956692,hugonbag,,0,0,1,0,1,300
126664186,Society4Science,"Publisher of @ScienceNews & @SNStudents. Hosts STEM competitions: #RegeneronISEF, #RegeneronSTS, #brcmMASTERS",1,0,0,0,1,300
210936639,marcusjenal,Exploring the use of complexity thinking for social change. Partner @Mesopartner. FRSA. Tweets my own.,0,0,2,0,2,300
2601930188,smellyblueberry,"Book hoarder, bedroom guitarist, mountain biker, craft beer drinker",0,0,1,0,1,49
4053430877,CologneDigital,Digital Transformation and Value Creation. A research initiative at the University of Cologne. Tweeting about the digital transformation of business and society,1,0,0,1,2,217
609713289,lucasalanmiller,"I co-teach ""Becoming Superhuman"" @BerkeleyHaas. Productivity/cognitive performance researcher and author. Always looking at incentives. Twitter = notes to self.",0,0,1,0,1,300
4502151556,kemo_sewing,,1,0,0,0,1,155
14962437,shyduroff,co-fndr/dir inst-wide @mit e-club; fac @mitedgerton; fndr cannery iron works; docent-tinker https://t.co/siTjjEUSfi; brooks ambo c/s 432; KC1MJT at https://t.co/C3gB7pVr8Y,1,0,0,0,1,300
148481733,jajensen681,"Mathematician, mathematics educator, MAA FOCUS editor, mom, runner",1,0,0,0,1,300
1712978990,vedWINNNNNN,twitter names are not my forte,1,0,0,0,1,300
66862912,RCanogar,"Associate Professor of Mathematics.
Universidad Nacional de Educación a Distancia (UNED)",0,0,0,1,1,300
219039138,adamimos,I eat neurons like you for breakfast!,0,0,1,0,1,223
1267527457,BenTaylor_EY,EY UK Financial Accounting Advisory Services Leader. #innovation #culture and #digital. Long term ambition to figure out how world really works,1,0,0,0,1,300
3761911634,EvoCancer,"International Society for Evolution, Ecology and Cancer",1,0,0,0,1,300
18404965,martylesser,"Retired Professor of Theoretical Mechanics, like photography, SF, science, calligraphy, history and philosophy. INTJ  radio amateur SA0BUD",1,0,0,0,1,300
3973181413,GodsoeWilliam,Evolutionary ecologist with math/nature geeky tendencies,1,0,0,0,1,300
86766927,fashkekman,#AltRight #Nationalist #NRx #identitarian #nativist,1,0,0,0,1,300
192623891,advkinematics,"Just my thoughts on healthcare, tech, & other stuff:) Medium: https://t.co/FHTVKUVsyC Facebook: https://t.co/tGe2MO6QAB Instagram: https://t.co/xNhZ9uRBzV",0,0,1,0,1,300
1477833530,dngman,"Researcher at INRIA, MNE-Python contributor, cert. psychologist. Rhythmically oscillating betw. cognitive/neuro/data science and M/EEG methods & applications.",0,1,0,0,1,300
46048965,nirsd,quantum || AI || sci-fi || soon to be in a band || procrast-a-blog at https://t.co/kL84M4BWe8,1,0,0,0,1,300
24518173,JerryTwitR,,1,0,0,0,1,170
4126329618,cocoltrane,,0,0,1,0,1,300
3186320168,jimmie_lenz,"Student, teacher, and practitioner of FinTech as a solution. https://t.co/w5DcbcSpsg",0,1,0,0,1,300
17459705,ecophronesis,Building the future,0,0,2,0,2,300
24606441,_esin_yavuz,"Sensory processing and learning in brains and machines, bio-inspired computing & tech. Neuroscientist & engineer. Co-founder @cyanapse.",0,0,1,0,1,300
3910370294,DrBarons,"Mathematician. Interested in mathematical & statistical modelling of complex systems that impact on human health and wellbeing, like food security, pollinators.",0,0,1,0,1,300
3151748894,dallthethingsdt,"University of Vermont Graduate Course on Ordinary Differential Equations, MATH330",1,0,1,1,3,300
3715765152,drkimpanda,"Theoretical physicist & Network scientist. Assistant research professor @Beyond_ASU Looking for universal intelligence.

I think about thinking, therefore I am.",0,0,2,2,4,300
199575990,CEsquivelLozada,"Psicólogo de la Salud Ocupacional. Creo en la justicia social y la transformación de la realidad a través de la ciencia.
Académico @UNAM_MX @unam_fesz",0,2,2,0,4,300
777321260,reisanar,Data Science @FLPolyU Colombiano. #Rstats #DataScience #AppliedMath #Optimization #MachineLearning CLO-ELP-BOS-MIA-LAL,1,0,0,0,1,300
508642072,JuliaEberlen,"PhD Student, mother of two, former nurse. Interests: Networks, Stereotypes, ABMs, (implicit) Learning, anything fiber",1,0,0,0,1,300
17156385,mark_mounts,"Business, Engineering & CS Librarian",1,0,0,0,1,300
3148755486,dibsbiotech,Discovery through Visualization.    (https://t.co/QgQzWSKrnc)  tech startup | data visualization | AI | health | fitness,1,0,0,0,1,300
3433616105,aurko_joshi,,1,0,0,0,1,154
3263510609,pjdmatts,,0,0,1,0,1,300
3393563176,gbarone77,Engineer and Programmer,0,0,1,0,1,70
5252591,bgurley,"VC @benchmark, Investor: @grubhub, @zillow, @uber, @stitchfix, @nextdoor, @glassdoor, @hacker0x01, @solvhealth, @roverdotcom, @goodeggs, @instawork",0,0,1,0,1,300
374509424,ImAmanChowdhury,Entrepreneur. Investor.,0,0,1,0,1,300
473240687,simplennoteasy,simple but not easy. There are 10 types of people those who know binary and those who do not.,0,0,1,0,1,300
3337633121,toptechticker,We curate the tech channel at @thingscyber reporting on #cloudcomputing #AI #mobility #bigdata #robotics #IoT #cybersecurity,1,0,0,0,1,300
189416211,functiontelechy,Assistant Professor of Music Technology and Data Science at @nyusteinhardt and @nyudatascience - he/him,1,0,0,0,1,300
3260707340,VKaratayev,"Love to study+teach theoretical/community/aquatic/social ecology, applied math, and their intersection @ucdavis @uofg",0,0,1,0,1,300
138098380,jvanegue,CTO Office / Head of Software Security Architecture @Bloomberg. Interested in distributed systems verification tools and techniques to secure design & implem.,1,0,0,0,1,300
1325462208,JustinMHelms,Interested in games with language and language as a game.,0,0,1,0,1,300
3305432427,EnricoDegiuli,Theoretical physicist. Science blogger. Amateur chess and go player. Professional chocolate eater.,0,0,1,0,1,300
2824745474,outrageouscoder,discussing computers and math - the more social of my Twitter accounts,1,0,0,0,1,300
3051529003,SNTrismegistus,The Center For #Decentralization and the capital of #SocialCapitalism.  #intrustwetrust #lossy,2,0,0,0,2,300
398246421,thy_white,"Optimist Pragmatist Humanist, UK",0,0,1,0,1,300
3097030567,UCNZMaths,"Mathematics and Statistics at Te Whare Wānanga o Waitaha, University of Canterbury",0,1,1,1,3,300
1577668716,mr_motus,Movement | Human Performance | Complex Systems Science | Watch me fail gloriously.,0,0,1,0,1,300
2371143134,ChandiCampbell,,1,0,0,0,1,177
254201384,mattyhoff14,"Applied mathematician, Associate Professor at RIT",0,0,0,1,1,300
5877272,cbouyio,"Assist. Prof. Université de Paris
Computational Systems Biologist.
Free/Open Science/Software.",1,0,0,0,1,300
286119283,AitorMarston,Cinéfalo empedernido,0,0,1,0,1,116
3239677683,dan_rockmore,"Dan Rockmore is Associate Dean for the Sciences, Director of the Neukom Institute for Computational Science,  Professor of Math and CS at Dartmouth College.",0,0,0,1,1,300
307394735,LetsGoCard,Engineering manager at @PandoraMusic. Tweets/opinions are my own.,1,0,0,0,1,231
2549207570,3amScience,"chemical sciences & engineering | Tech & Eng Editor @ScienceBorealis | space, innovation, data, atmos chem, enviro health, #scicomm, RTs & follows ≠endorsements",1,0,0,0,1,300
278240583,patrickmineault,"computational neuroscience, vision research, R, Python, machine learning. Updates from https://t.co/vrWK88K0mi",0,0,1,1,2,300
35189149,alexn_o,semi-democrat semi technocrat radio protector on high alert.,1,0,0,0,1,300
21318607,FiftyCAN,"We're a team of local leaders and advocates working toward a high-quality education for all kids, regardless of their address.",3,0,0,0,3,300
15380726,jasonroy0,,1,0,0,0,1,300
3033158075,sccs2015,The Student Conference on Complexity Science 2015. 9th-11th September. Keep up to date with all the latest updates and complexity related news.,0,0,1,0,1,126
58365157,erickidc,"Erick Izquierdo De la Cruz, IDC (por Ideas De Ciencia) IPN/UACM-Mx. #Science topics unveiling #BlackHole #DarkMatter & #DarkEnergy facts & theories",0,0,0,1,1,300
17667237,s_hammarlund,"PhD student in the #HarcombeLab at UMN studying the ecology and evolution of cross-feeding microbes. Låtsatssvensk. 💙 birds, #MNUFC, Pseudotsuga. She/her.",0,1,0,0,1,300
14477458,ajinkyakulkarni,"भोगा न भुक्ता वयमेव भुक्ताः
तपो न तप्तं वयमेव तप्ताः।
कालो न यातो वयमेव याताः
तृष्णा न जीर्णा वयमेव जीर्णाः॥",0,0,1,0,1,300
22385548,janexwang,"Research scientist at DeepMind,

Thinking about thinking.",1,0,0,0,1,300
2910172803,ConnorFlexman,,0,0,1,0,1,300
829811,hcecci,Gartner analyst covering IT Infrastructure Strategies and Futures at the intersection of curiosity and skepticism.,1,0,0,0,1,300
14432970,frafuzio,"Mediterranean Sea, Mare Nostrum, Μεσόγειος Θάλασσα or הַיָּם הַגָּדוֹל: for me is just Home.Planting carob trees and caring bees while devising algorithms.",1,0,1,0,2,300
17442434,mitsy007,The future is now,0,0,1,0,1,300
2905257436,projecteuclid,"Project Euclid is a non-profit community-driven partnership of libraries, publishers and scholars in theoretical and applied mathematics and statistics.",1,0,0,0,1,300
327002487,JTT329,"Philosophy, math, and music get me going.",1,0,0,0,1,300
18679701,susancosier,"Independent journalist focused on science and the environment. Writing in @NewsfromScience, @sciam, @NRDC, and more.",1,0,0,0,1,300
2919334454,pie0ria,"I study myself more than any other subject. That is my metaphysics, that is my physics.

-Michel de Montaigne, ""On Experience""",1,0,0,0,1,239
9690522,rithwik,"Data, Math, Code, Mgmt, Words",0,0,1,0,1,300
479757192,stochtastic,Climatologist and data wrangler. @JSMF postdoc @ UW.,0,0,1,0,1,147
277547318,DGMC90,Brighton - Data science - Data visualisation - Don't panic.,0,0,1,0,1,300
1336477628,uvmmathstats,University of Vermont,0,1,0,0,1,300
251985209,takamitsu_w,Associate Professor in @IRCN_UTokyo. Hon Researcher in UCL ICN.,0,1,0,0,1,254
1123268539,Peter_Ashcroft,PhD in Theoretical Physics. Now PostDoc in Biology @ ETH Zürich,0,0,1,0,1,300
2219355895,controliannelli,Docente e ricercatore di controlli automatici,0,0,1,0,1,300
21439437,geowu,Decision researcher; just enough of a psychologist and economist to be dangerous,0,0,1,0,1,300
110823121,badboyboyce,partner @gcvp | founder @roughdraftvc | board @theshedny @newinc @itscodenation alum @harvard @stuyny @skillshare,1,0,0,0,1,300
536277126,incomebytrading,Trading with a statistical edge,0,0,1,0,1,300
383321960,natxopago,Professor of Physics. University of Barcelona 🌹,0,0,2,0,2,300
46193266,johanneskoponen,"Author ”Platform Economy and New Business Models” (2019). Systems dynamics, foresight and disruptive change.",1,0,1,0,2,300
88613724,ILjubic,"Professor of Operations Research (#orms, #networkoptimization)",1,0,0,0,1,300
2917984715,libreof,,0,0,1,0,1,300
2344678188,duynwin,"Statistics PhD at University of Wisconsin-Madison; interested in statistical genomics, machine learning, and computing; pianist",1,0,0,0,1,21
45648375,AdoNNeN,"Engineer, Programmer, Physicist, Fitness Enthusiast",0,0,1,0,1,300
103559820,jacksheridan,"Mathematician, Irish, student of life!",0,0,1,0,1,83
2321039649,alephthought,"husband, father, mathematician, teacher, genealogist, cuttlefish enthusiast",0,0,1,0,1,291
2888838965,aaronwflee,Data science x systems economics @locusanalytics. Studied brains and behavior @cornell. Curious.,1,0,0,0,1,300
55194556,JimmyDubuisson,"Entrepreneur, Researcher, Guitarist",1,0,0,0,1,284
2220550136,nicholasgatto,,1,0,0,0,1,300
372240718,tarathia,"Complex Systems, Neuroscience, Physics, History...anything that helps make sense of it all.  Scientist and entrepreneur turning science and data into products.",0,0,1,0,1,249
2855379797,sojourner_mark,,1,0,0,0,1,91
102378661,MarcoCastel,"Guitarist, husband, father, fixed income fund manager. Always learning.",0,0,1,0,1,300
236349449,systemspeter,"Data Scientist now working in retail and logistics. Usually found doing maths on complex systems, making things simple and helping machines think.",0,0,1,0,1,300
189955464,theipv6guy,YOUR car is causing climate change,0,0,1,0,1,300
51132574,breitwoman,Working on decentralized governance with @tezos. Pushing towards https://t.co/tYpYAUdlM1. Wife of @arthurb. Francophile by marriage.,1,0,0,0,1,300
562831363,ZPedro10,"Performance Analyst at @selecaoportugal. Passionate by probability, decision-making, complex systems and the role of chance. Views are my own",0,0,1,0,1,300
18371162,sashidar,Marketing Professional; Hardware hobbyist; Likes to travel;,1,0,0,0,1,264
219178084,orderwithchaos,"Software Engineer+Researcher. Interests: #SoftwareEngineering #Systems #Performance #Scale #Security, #Data, #ML.",0,0,1,0,1,300
2439024298,Curriculum75,"Assistant Superintendent of Teaching & Learning (D75), Dad of 2 girls, IALAS Board Member, Hubby, Music Teacher, Math Geek, #d75learns #d75aprende #ialasfamilia",1,0,0,0,1,300
2840976607,ArfanSahib,,1,0,0,0,1,24
1666341594,MissyOsgood,Teller of tales (and tails) for @CornellVet. Need experts for a story? Contact me: mmo59 at https://t.co/6ORbsEHQe9. #Animals #Agriculture #Pets #Health,0,0,1,0,1,300
337914037,SarasChung,Advocating for young people in the edspace. PhD. researcher/systems thinker/dynamicist. ED of @skipdesigned.,0,0,1,0,1,300
1575727592,ChiGuyNumber3,"Quantum engineer @rigetti.

~There will bee puns.~ Actually that claim has not held up at all.",1,0,0,0,1,300
804948578,FHIOxford,Multidisciplinary research institute at the University of Oxford.  We bring careful thinking to bear on big-picture questions about humanity and its prospects.,0,0,1,0,1,300
512195743,ScienceSites,Dedicated to helping scientists reach a wider audience and engage the public via the Web. Our goal: to make science more accessible.,0,0,0,1,1,300
24775576,sabinehauert,Engineering swarms across scales - senior lecturer in robotics at @BristolUni - president of @Robohub - previously at @EPFL_en and @MIT.,0,0,2,0,2,300
12927662,jhalcrow,,1,0,0,0,1,300
398220382,craigie_justin,,1,0,0,0,1,300
20488447,bkdidact,#SwDMathChat founder | #SpecialEducation #Math teacher | @CityCollegeNY teacher educator | @mathinthecity | #MTBoS | he/him/his,1,0,0,0,1,300
28243851,vivsinym,"Building something that serves brick and mortars. Previously: @UChicago, @UWC_io, @CodeandCanvas, @LinkedIn.",1,0,0,0,1,300
149182719,vasiloglou,Ismion MLTrain,0,0,1,0,1,300
2729316944,SilverMath1,"Silver Math is a website where people can ask math questions, solve math problems, meet new friends and participate in many contests.",1,0,0,0,1,47
566159214,M_R_Institute,"■表題部
身分 会社員
名目 経理がんばる
地目 大阪→京都
法律 民法、国年法、行訴法
関与 まちづくり塾
■趣味部
1 絵画 クレー、ブリューゲル
2 音楽 カーペンターズ、ショパン
3 学術 教育学、クイズ番組
　3番付記1号 債権額 金450万円 債権者 国
4 その他 ネクタイ、車
　特約 浅学につき質問不可",1,0,0,0,1,300
2412929970,OgAdMath,"Mathematician, trying to make sense of what goes around in social networks and advertising.",1,0,0,0,1,6
42955173,CornellEng,Come break the rules. Follow us and help make great things happen. #CornellEng,1,0,0,0,1,300
326667022,profpaulharper,"Professor of Operational Research, Director of the Data Innovation Research Institute, Deputy Head of the School of Mathematics, Cardiff University",1,0,0,0,1,300
241259050,TitusAnderson,"I tweet about my illegal entrapment and my personal interests: mensa-level people; solutions; ability increases
https://t.co/oivXSTXoqS

#1000xH8, https://t.co/r3ZnYpZDTr",1,0,0,0,1,300
557702592,pysamples,"Python and R programming languages | teaching of mathematics and sciences | ICT for education | Secondary Education.
website: http://t.co/THzEmLjMLc",1,0,0,0,1,300
517819944,HollandBrianD,,0,0,1,0,1,152
1932203233,ConservationDec,The conservation decisions team (CSIRO) - Providing informed decisions to best conserve biodiversity,1,0,0,0,1,262
1039327705,TheLuckyFools,Boetish...,1,0,0,0,1,300
6515122,fuelcut,"I speak only for myself. 
@GoogleAI. previously founder at @SidewalkLabs / @CoordCity",1,0,0,0,1,300
2493940844,skescher,"Computational Chemistry graduate, Scientific Computing grad student, putting the math in polymath. Occasionally bad at arithmetic.",0,0,1,0,1,272
541967844,martinklinge,nothing interesting here,1,0,0,0,1,300
1189629145,ocneba2,,0,0,1,0,1,300
944479844,jungleslant,,1,0,0,0,1,77
89622118,IAmWilbur,,1,0,0,0,1,300
195921210,ruts30,Todos los dias intentando descifrar la #matrix. Asiduo #lector. Disfrutando el viaje. Empresario. Ingeniero Industrial.,0,0,1,0,1,300
911449802,therealbarreto,"Computer science dropout, amateur musician, creative and bearing a strong will to live.",0,0,2,0,2,300
294229541,armand_ga,,1,0,0,0,1,85
130743317,alexleeee,two-time costume contest champion. design enthusiast. data scientist. day dreamist.,1,0,0,0,1,300
15376206,trsudarshan,"now @IBMWatson; prev @Stanford; from Chennai, India.",1,0,0,0,1,300
932199786,ntmntr,"peace, mathematics, morality, culture, sport, family life and opinions you may or may not like to hear --- tweets in English and sometimes German",1,0,0,0,1,300
15937756,akarve,"Data & visualization. Secondarily: machine learning, abstract algebra, design. Co-founder, CTO @QuiltData.",0,0,1,0,1,300
290371330,ThaRobfather,,0,0,1,0,1,300
2479855824,bartekploc,"Oh, thank you, just watching.
I'm interested in ants and primates and rather old music, study consumerism, stats and trade futures. My views are my own, I hope.",1,0,0,0,1,93
328379563,mathsbrett,"Maths teacher, lecturer in maths education and maths nerd. Frequents Tasmania most of the time.",0,0,1,0,1,300
16556122,hgavert,#AIEvangelist #AI #MachineLearning and financial intelligence at OP Financial Group #fintech #finanssiäly #tekoäly #tekoälyevankelista 😊,1,0,0,0,1,300
10378,Ellis,"Founder / Design Director @swaydesign Launched products for @USGBC, @zocdoc, @starbucks. Probably designing or surfing in NYC.",0,1,0,0,1,300
19692356,CarolineBME,"Biomedical Engineer ☆ SciComm ☆ Leading MarComm, Content, and Curation @Addgene ☆ Mom Boss ☆ 90% Iced Coffee by Volume",1,0,0,0,1,300
2353000057,SotirisProk,Business and Technology Consultant @PwC. Passionate about #ComplexSystemsModeling #consulting #decisionmaking #strategy. https://t.co/BupewoJoor,0,0,1,0,1,300
205569142,amt_shrma,"Curiously curious, amusingly mechanic. Researcher at Microsoft Research.  Work on causal inference, machine learning and experimentation.",0,0,0,1,1,300
2391803420,TPointMath,"Grinnell College math professor, creator of youtube channel Tipping Point Math.",1,0,0,0,1,300
2381111228,ParmenterMath,"Math Specialists for Parmenter School in Franklin, MA.",1,0,0,0,1,215
15983057,jdanowski,"Do network analysis of words, people, organizations, nations over time testing hypotheses about structural features and other variables.",1,0,0,0,1,238
24102720,wittjeff,"a11y, color vision, accessible charts & #datavis",1,0,0,0,1,298
186324227,timgushue,,0,0,1,0,1,300
2350333891,andimscience,Lewis-Sigler theory fellow @Princeton interested in theoretical biophysics and quantitative immunology.,0,0,1,0,1,293
157251422,madhu_gopinath,Data Science @ MakeMyTrip,0,0,1,0,1,300
2254180430,Sports_Rolfing,"Advanced Sports Rolfing for Professional & Elite Athletes | Fascial Fitness, Alignment + Balance | Prehab | Training Workshops",0,0,1,0,1,300
671653,IanYorston,"Geek. Teach. Lecture. Write. Read a lot. Smile a lot. @RadleyPhysics #DigitalStrategy #CompSci #AI - also, sometime: #RAFOfficer #ElectronicWarfare @UniOfOxford",0,0,1,0,1,300
2343869647,epstein_n,"Quant, data scientist, software engineer. Interested in history, complex systems, and philosophy. Studied applied math and code @Columbia and @recursecenter",0,0,2,0,2,300
15780942,NiharDalal,Trader/Philosopher,1,0,0,0,1,78
255594580,littleboy300,Senior Research Fellow at Indian Statistical Institute | Founder of @math_nomad | Multimedia editor at @BhavanaMagazine,1,0,0,0,1,249
15875930,syncad,"BiM Architect, Virtual #iT systems; #Generative Comprehensive Anticipatory Design Science #CADS #Design #Researh Lecturer @CCAEarch @CIT_ie by @CIT_TLU PhD cand",0,0,1,0,1,300
199758880,johanhoffman,"Professor at #KTH Royal Institute of Technology and co-founder of the #fenics project: #mathematics, #computerscience, #hpc, #cfd, #fsi, #simulation",1,0,0,0,1,184
9800672,wulfrano,International Man of Mystery. Mexbalia. Se habla español.,1,0,0,0,1,300
30047029,twitskeptic,Professional data wrangler and Twitter’s official fact checker. Older and crankier than you are.,0,0,1,0,1,300
18427094,pantelispa,Interdisciplinary being of migratory tendencies that found harbor at @DanishIAS at @SyddanskUniv,1,0,0,0,1,247
17620172,jmcclunn,"CFO/CPA, lead guitar, sailor, aikidoist, underwater and astrophotographer.",1,0,0,0,1,54
431142024,sometimesabird,I come from a hooligan country.,0,0,0,1,1,300
86312038,StuNattrass,"learning analytics researcher @uniofhull, nee behavioural/evolutionary ecologist. talk to me about whale menopause. dumb thoughts all mine. he/him",1,0,0,0,1,300
2190434178,carmofon,"Personal account. If you want to hear about science, follow my Lab account (@carmofonlab). Here, I (not so often) tweet about politics, Chile, and other stuff.",0,0,1,0,1,300
41520652,brylinski,"Scientist. I find things out, but really .. I wonder. Obsessive. Up at night. Quantum Stuff, AI & Brains,  Math & Physics, Sci-Fi. @BryRes @DevisedMind",2,0,0,0,2,97
1618691779,JamesGDyke,Academic|Writer|Public Speaker. Assistant Director @GSI_Exeter. Columnist @theipaper & Contributor @independent. Co-Producer & Presenter of Race is On.,0,0,1,0,1,300
307978761,AboveVacant,"embedded/distributed/computer vision systems. currently stereo visual-inertial odometry on zynq. interests in org patterns, sw-eng history and stats.",0,0,1,0,1,300
267425929,wontfix,tweep,0,0,1,0,1,300
242955648,rmoreno_ayala,,0,0,1,0,1,248
344866783,murararvid,Putslustig.,0,0,1,0,1,153
14774111,Vidanto,"PhD #RPI, MEd, BA; Your friend. Communication theorist; cog/soc/com sci; writer; designer; techie. Photographer. Conversationalist. Instagram: matrolph",1,0,0,0,1,300
439359840,luddyka,"I obsess over immunology & cancer. Supporter of open access. Wildly annoyed by unquestioned dogma. Enjoying being a mom working in STEM.
Logo by @simonfayauthor",0,0,1,0,1,300
442227081,JHuichihuayan,Sin timón y a la deriva...,0,0,1,0,1,289
915272149,bhpascal,I think about complexity and complex systems a lot. But I work on using those systems to help as many people as possible. @StanfordCIS and elsewhere.,0,0,1,0,1,300
819039356,ExtremeImpacts,"Exercising the unexpected. Impacts, challenges, perception, risk, complexity, organic systems, adaptation, emergence and growth. Life. Amazing.",0,0,1,0,1,300
585458742,AquiGerd,"Physicist:  complex systems and networks, systems biology, applied maths. Improviser",0,0,2,0,2,42
1050749700,Stevia_Badger,,0,0,1,0,1,300
9410032,marcarlson,"Math teacher, interested in tech ed, politics, interesting facts, and the downfall of cable tv.",1,0,0,0,1,300
198389338,dennisfeehan,"I'm an assistant prof at UC Berkeley, where I study demography, social networks, and quantitative methodology.",2,0,0,0,2,217
35684509,augmeyer,ai. complex systems sci. mathematics. music.,0,0,1,0,1,300
138928251,differentiable,,1,0,0,0,1,300
50296278,ivdlina,"Communicates social science research, Bridge enthusiast, parent, lazy cyclist",1,0,0,0,1,196
512023639,UVMPSS,"Studying ecological and sustainable processes  for agriculture, soil health, landscape & conservation.",0,0,1,0,1,300
305635596,ajerneck,"PhD Candidate in Sociology at Penn. Interested in economic, fiscal, and historical-comparative sociology and institutional development.",1,0,0,0,1,300
85659232,jaroncollis,"Co-founder @PluralAI. 
Think deeply. Invent ingeniously. Tweet sparingly.",0,0,1,0,1,300
38607229,WolfandRhys,Tar Heel.,1,0,0,0,1,300
1466861354,FundamentalPhys,The Fundamental Physics News Feed ▶ Covering everything from quantum particles to multiverses ▪ Managed by @AndrewGKing ▪ Also on Flipboard:,0,0,1,0,1,300
48368726,JenniferFistere,"❤ = Science, art, cooking, grapefruit, cameras, and a cat named Jack.  Pending: Bridge, skeet shooting, plumbing, French, reupholstering...",0,0,0,1,1,300
17473349,dmarthal,"Applied Mathematician (@stitchfix_algo) I have two amazing labradoodles, and an even more amazing human family! I don’t live in Germany (I just hate Nazis).",0,0,2,0,2,300
1741751,cloois,"janitors against entropy, ltd.",0,0,1,0,1,300
902947423,ckrfriedman,"CEO at Charity Science Health, getting as many kids vaccinated as cheaply as we can. Views my own.",1,0,0,0,1,300
340408325,SynthesisIPS,"Synthesis is a think-tank making use of the new study of complex networks, headed by Greg Fisher and Paul Ormerod.",0,1,5,0,6,93
255070294,A_Gadfly,"I was a strategy consultant 'in the big league'.  Before, I researched chemistry for 10 years. Now, I try to change my world by immersing myself in it...",0,0,1,0,1,300
64698978,brigan_raman,"World citizen, scientist, rugbier, poet, happy!",0,0,1,0,1,300
237766121,maximusandme,"I have a little 75 lb chocolate colored guy named Max, the catalyst for my metamorphosis.
I am I because my little dog knows me.",0,0,1,0,1,300
345430713,IIISinfo,IIIS is an organization for inter-disciplinary communication in the context of different epistemological values.,1,0,0,0,1,300
20547633,lindauruchurtu,"Data Science, ML, maths & science. Also 1/2 @theballetbag.",1,0,0,0,1,300
54414015,davidpoulshock,"David is a filmmaker. His passion for storytelling – which for him is all about, “Then what happens?!” – most probably began at birth.",1,0,0,0,1,214
304248242,Simtable,,0,0,1,0,1,300
1355477970,tempestmath,"Dedicated to meeting the growing needs of companies by providing mathematical and statistical modeling, data analysis, and technical consulting services.",0,0,1,0,1,300
967260482,disunzab,,1,0,0,0,1,300
21062386,HarlanBrothers,"Data Scientist, Mathematician, Inventor, Composer, & Educator",0,0,1,0,1,184
35371987,mufffyblue,The Blue Law Firm,1,0,0,0,1,270
506217137,zperkov,Building a new national securities exchange @ltse. My thoughts and opinions are controlled  by random outcomes of a complex system.,0,0,1,0,1,300
39062967,govindk,Mestri aka solution provider - who creates/fixes software solutions using words like Cloud and Data. Ask me for Azure Cosmos DB help.  I speak for myself,0,0,1,0,1,300
21364021,tombrughmans,Archaeologist; GIS-enthousiast; Network fanatic,3,0,0,5,8,300
1234650324,chemstateric,#Chemistry & #Mathematics at @SFU | #Statistics at @UofT | Monte Carlo Simulations | Career Development | Working in measurement analytics at @AcostaSales,1,0,0,0,1,300
19301221,aschampion,"neuroscience, connectomics, machine learning, high performance computing, scientific programming",1,0,0,0,1,295
98556308,cmuravi,Professor,1,0,0,0,1,15
41467086,DoctorNarine,"#DataScientist #doc Passionate about data crunching, artificial intelligence and #datadrivenstories.",0,0,1,0,1,300
549177691,mazeez2,"من قال ان طائر البوم  نذير شؤم لا تصدقه ...
انها رمز للجمال والهدوء والحكمة",0,0,1,0,1,300
14614834,saeed_siam,Asst. Prof @ISTatPENNSTATE | mHealth | Sensing & Intervention | Circadian Computing | Sleep | Mental Health. Reads Vogon Poetry to make weekends interesting,1,0,0,0,1,300
83102064,SunnyTakeda,macroeconomist,0,0,1,0,1,300
301509870,ssrraabbtt,"Chemical Engineer, Science Communicator... Working on a novel....",1,0,0,0,1,274
257115283,Jonathan_Foo,"Collaboration, enterprise social, mobile and whatever other thoughts come to mind... Tweets are my own and not that of my employer...",2,0,0,0,2,117
933500851,GJDury,"Ph.D. candidate @IUBloomington. Was a fellow @STRI_Panama. https://t.co/TRFPL9TdEz. from @McGillU and STRI. Insect researcher & photographer, world traveler. Opinions are my own.",1,0,0,0,1,300
312593011,JMattCollins,"Chief Marketing Officer, Calix",1,0,0,0,1,238
380414259,DaisyYuhas,"Loves science curiosities from birds and bosons to brains, also adores alliteration; Columnist for @hechingerreport and editor for @SAPIENS_org",1,0,0,0,1,300
138109688,CLEANCATCHES,"interested in mathematics,medicine,biology,physiology.",0,0,1,0,1,18
442908479,CUAlumniMag,The official Twitter home of the Cornell Alumni Magazine. Editorially independent of Cornell University.,1,0,0,0,1,300
232172673,DrEdmundHunt,"Researcher @bristoluni thinking about collective behaviour / 'swarms':
in robots, animals, and us! 🤖🐜🌳🤔",1,0,0,0,1,300
18913968,joshin4colours,"Software developer who's into software, automation, quality, and big ideas. Python developer in a JavaScript world. Solution Architect at @saucelabs. Him/he",0,0,2,0,2,300
40464203,krijohan,,1,0,0,0,1,300
1003601394,miguelcsoriano,,0,1,2,1,4,107
29710492,istavrak,Coding at KAYAK,1,0,0,0,1,300
59270502,arthur_nielsen,,1,0,0,0,1,300
361878649,FeltonChris,"Dad, husband, and during the day an Electrical Engineer working with signal processing and FPGAs.  MyHDL user and developer.",1,0,0,0,1,300
232195834,ccc1685,"Applied mathematics, biology, computational neuroscience",0,0,0,1,1,300
17707192,egillmas,Things will change!,1,0,0,0,1,300
908314698,kw_swenson,"beekeeper, pacemaker designer, emergence",0,0,1,0,1,158
951703932,GokhaleCS,Group Leader - Max Planck for Evol Bio. Evolutionary theorist or armchair biologist - but mostly found hiking somewhere in the mountains.,1,0,0,0,1,300
458573983,Martin_Dudziak,"Human-focused STEM incl. physics (quantum relativity), biophysics, psychosociodynamics; http://t.co/oCqdD6m8, http://t.co/QgQXLOVb  + more 4 our kids & world",2,0,0,0,2,300
30100208,knowledgeprob,"Policy-oriented regulatory & institutional economics. Economist @CMU_EPP & @CMUenergy. Blog at KP since 2002, posts by Lynne or Mike Giberson @MichaelGiberso3",2,0,1,0,3,300
244835973,uwilensk,,0,0,0,1,1,9
19312658,antbarros,Biostatistics & Bioinformatics @ FMUP. Special interest in cardiovascular diseases.,0,0,1,0,1,300
217428899,Bricoleuric,"Research, Feelmore Labs; Create non-invasive brain stim for the human condition. Running a Foucaultian critique of same simultaneously. Anthrpologist, lunatic.",0,0,1,0,1,300
15816794,sundarb,"Dad; Wharton, Chicago, ISB, IIT, UW; kids @Stanford, @MtHolyoke @Harvard. AI & Marketing Pioneer, Negotiations, Distinguished Teaching Medal, Keynotes",1,0,0,0,1,300
245516140,jslorentzen,Design Lead @IDEO,1,0,0,0,1,86
45114806,spikhykaran,internet dummy,1,0,0,0,1,300
853631226,kh_oliver,Ph.D. Scientist | Artist | Communication of Science and Technology | Pharmacology | Science Outreach | ArtLab : @ArtLab_Vandy,1,0,0,0,1,300
567069974,pyblog,"My interests include numerical PDEs, optimization, and Python.",0,0,1,0,1,245
218596404,austindimmer,Founder of Effective Computing. Maker of voice control systems. Former Polar Explorer. Lover of languages. All in on Tech.,0,0,1,0,1,300
248080561,picked,"MS3 with a background in health technology moving towards an MD to work at the intersection of chronic disease, SDoH, and the carceral state.",1,0,0,0,1,300
817880978,k_ellingsen,"Developer, geek, master of science, cynic, father. My software never has bugs. It just develops random features.",1,0,0,0,1,300
105221403,mashfiqui,"Postdoc, Harvard University",0,0,0,1,1,113
27160506,eredien,I write fiction. I do art. Pronouns: he/they.,1,0,0,0,1,300
18578680,owenbarritt,PHP web developer with particular interest in e-learning. Folk dancer outside office hours.  All views expressed my own.,1,0,0,0,1,300
325950695,msvicsadventure,"Finally frolicking on the East Coast via Northwestern, ASU, and a 4 year teaching stint in Phoenix",1,0,0,0,1,300
17775080,RebGrLa,Searching outside the given terms to solve for X.,1,0,0,0,1,300
601049039,JeremyKendal,Research interests - social transmission and population dynamics.,1,0,0,0,1,300
39043152,eleansa,Machine Learning 👾 gaming 🎮 scala 👩‍💻 swimming 🏊‍♀️ music 🎧 recordings: https://t.co/kOyXUfHwkl,1,0,0,0,1,297
16902120,gankit,CS grad from IIT Bombay + Stanford. Pulse co founder/cto. Led products at LinkedIn after the acquisition. Currently working on new ideas in healthcare.,1,0,0,0,1,300
14795902,ciphr,,0,0,0,1,1,300
14129167,cryptochaos,"Technologist, Musician and Gadfly",0,0,1,0,1,300
398500188,WittedNote,I work @google My tweets represent my own views. WittedNote is an anagram.,1,0,0,0,1,300
367358802,RogerDavis89,Curiosita- An insatiably curious approach to life and an unrelenting quest for continuous learning Sounds about right-learning to  trade draw cook parent  etc,1,0,1,0,2,300
353123574,DeanMannUK,"Biologist by training; proj manager, complex systems, SW/HW eng. by experience, photog. by inclination. Job: Chaos Rider. Daughters @JoMannPhoto @JocastaMannArt",0,0,1,0,1,300
495104674,ebraday_egehay,,0,0,1,0,1,300
14110428,oldak,"Interested in science, philosophy, language (ancient), programming (C), mathematics, literature, complex systems",0,0,1,0,1,300
68072914,FractalMan,"Director, Fractal Foundation, IT @ProjectECHO, Creator & pilot of flying fractal art balloons. Transforming education. Creator-Adventurer (ig:FlyingFractals)",1,0,0,0,1,300
14368227,paudirac,"The more people I tweet, the more I like my dog.

ex falso sequitur quodlibet",1,0,0,0,1,300
15425627,RichardGilles,Business Consultant & Designer facilitating discovery of new ways to thrive #complexity #art #entrepreneur #architecture #startup #finance #government #science,0,0,2,0,2,244
93295809,JamesGRickards,"NY Times bestselling author of Aftermath, The Road to Ruin, The Death of Money, Currency Wars & The New Case for Gold. Have pen, will travel.",0,0,1,0,1,300
14506596,afallingbomb,"Research scientist in theoretical and computational mechanics, thermodynamics and multiscale methods",1,0,0,0,1,287
84477434,nootool,reciprocal influences bring forth emergent world,1,0,0,0,1,300
288958192,GuyBirkin,art : complexity : music : nature : science,0,1,0,0,1,300
20465828,batessa,Science communicator. @genome_gov comms chief. Tweets are my own. she/her,1,0,0,0,1,300
330329958,AnnaLiisaAU,,1,0,0,0,1,300
359892278,KParsopoulos,"Associate Professor, Department of Computer Science & Engineering, University of Ioannina, Greece.",0,0,1,0,1,300
145081111,JHerbertread,"Biologist interested in behavioural ecology, animal behaviour, and marine biology",2,0,0,0,2,300
173857641,aridgupta,,1,0,0,0,1,122
80375104,tedwelser,"Sociologist, researcher, and teacher about networks, online community, social change.",1,0,0,0,1,51
93527777,pauloglesby,,0,0,1,0,1,247
402994618,FRenz_y,computational ecology and phytoplankton population dynamics. I mess about with machine learning and differential equations.,0,0,1,0,1,300
408668834,lodish,mathematics fan,0,0,1,1,2,300
227164480,mathsfeedback,"Maths teacher, head of maths & computing, in Singapore; always learning about education. Feedback is the breakfast of champions (K Blanchard). Tweets my own.",0,1,1,0,2,300
131905047,Patrickwalshe,Mobile Media Specialist,1,0,0,0,1,229
135316691,JadAbumrad,"Radiolab, More Perfect, Dolly Parton's America, music, other stuff. When I tweet it's just me.",1,0,0,0,1,300
15417731,rahul_ananth,"Researcher with a focus on PSE, Energy and CCS at SINTEF Energy Research. All views are personal",1,0,0,0,1,300
20516052,aykuterdem,,1,0,0,0,1,300
38235357,stevenflinn,"Inventor, author of The Learning Layer & Optimizing Data-to-Learning-to-Action, CEO of ManyWorlds, Inc.",0,0,1,0,1,300
6073472,jsomers,"read, write, code",0,0,1,0,1,300
798947866135953409,MarcTimme,"First principles research on systemic dynamics in computation, energy, mobility and sustainability.",0,0,1,0,1,91
7398912,carolune,"Assoc. Prof. @UWConline Physics & Astronomy. Assoc. Dir. Development & Outreach @Big_IDIA. @EPFL, @Cambridge_Uni Alum. ❤️ my family. On a cancer journey",1,0,0,0,1,300
578641879,NBerggruen,Founder of @berggruenInst. Co-author of #RenovatingDemocracy (https://t.co/nXmSt2O8Ui) A believer that ideas can make a better world. #IdeasMatter,1,0,0,0,1,300
58037161,sucramoow,"Freelance science journalist. Read me at @quantamagazine, @InsideScience, @BBCEarth, @newscientist, @SmithsonianMag, @WIREDScience, @novapbs, and more.",1,0,0,0,1,300
3091349915,explorables,"Explorable Explanations https://t.co/SXqczH6bVb, curated by @maartenzam",0,0,1,0,1,216
2307474271,dubitareaude,"GeeDee ≡ Gaia Donati. Former physics editor @nature, now surrounded by lock-in amplifiers and arbitrary waveform generators @Zhinst.",0,0,0,2,2,300
811255817039126529,FlatironCCB,"The Center for Computational Biology (CCB) is part of the @FlatironInst, a multidisciplinary institute focused on computation. Based in NYC.",0,0,0,1,1,250
3839,davewiner,"On the net since mid-70s. Started two Silicon Valley companies. Wrote for Wired. Fellow at Harvard, NYU. Founder of podcasting, blogging, RSS. Open web.",1,0,0,0,1,300
16170860,mashagessen,"Columnist, The New Yorker",1,0,0,0,1,300
83221061,MitchWaldrop,PhD physicist turned science writer; features editor for Nature,0,0,1,0,1,300
951425773,ChristianeGrill,"Enthusiast for #OpenInnovation and #PrioritySetting in #Research, @OIS_Center #LBG",1,0,0,0,1,259
1101768992585326592,VickyFieldsG,Trying to understand the complexity of Evolution|PhD student UNAM|Domestic sheep 🐑 conservation|Molecular 🧬 Evolution|Ethnobiology 🌵,1,0,0,0,1,300
1150750162366730240,InCIAM_amu,"Institut Créativité et Innovations Aix-Marseille Université
#créativité #creativity #innovation #recherche #formation #éducation #santé #travail #designthinking",1,0,0,0,1,300
1179862742225817600,zeno_diane,Doctoral candidate in Public Health at the University of Louisville. Focused on the training & supervision of substance use disorder treatment providers.,1,0,0,0,1,300
1230914575186395137,weird_neuron,PhD Student in Neuroscience @EdinburghUni 👩‍🔬 studying ASD/ID. Let's share our passion for the most mysterious system 🧠👀,1,0,0,0,1,300
41559643,ClimateLisa,Modelling climate migration 📍@ecioxford & @chch_oxford 👩‍💻 RA @ClimateMetrics & @INETOxford 🌍 Formerly @earthinstitute & @WorldBank. Scrabble-maniac 🧩,0,0,1,0,1,300
30496141,Abhay6,,1,0,0,0,1,300
895773623570636800,JulianBurger,PhD student @UvA_Amsterdam @UMCG. Complex Systems - Computational Modeling - Theory development - Time-Series Networks - Psychopathology,0,0,0,1,1,165
